"";"pid";"max.age";"seq.id";"seq.revlevel";"seq.start";"seq.end";"seq.length";"seq.start.rel";"seq.end.rel"
"1";589515;19;221;4;1;7;6;0,1;0,4
"2";587571;22;683;4;1;7;6;0,0909090909090909;0,363636363636364
"3";587571;22;684;4;1;9;8;0,0909090909090909;0,454545454545455
"4";475;129;828;5;32;56;24;0,25;0,4375
"5";475;129;829;5;40;64;24;0,3125;0,5
"6";475;129;830;6;40;52;12;0,3125;0,40625
"7";475;129;831;6;101;113;12;0,78125;0,875
"8";475;129;832;6;64;76;12;0,5;0,59375
"9";475;129;833;6;68;80;12;0,53125;0,625
"10";475;129;834;6;32;44;12;0,25;0,34375
"11";475;129;835;6;32;48;16;0,25;0,375
"12";475;129;836;6;36;48;12;0,28125;0,375
"13";475;129;837;6;60;72;12;0,46875;0,5625
"14";475;129;838;6;72;84;12;0,5625;0,65625
"15";475;129;839;6;27;40;13;0,21875;0,3125
"16";475;129;840;6;96;109;13;0,75;0,84375
"17";475;129;841;6;23;36;13;0,1875;0,28125
"18";475;129;842;6;44;56;12;0,34375;0,4375
"19";475;129;843;6;56;68;12;0,4375;0,53125
"20";475;129;844;6;27;44;17;0,21875;0,34375
"21";475;129;845;6;52;64;12;0,40625;0,5
"22";475;129;846;6;23;40;17;0,1875;0,3125
"23";475;129;847;6;40;56;16;0,3125;0,4375
"24";475;129;5435;5;48;72;24;0,375;0,5625
"25";475;129;5436;5;56;80;24;0,4375;0,625
"26";475;129;5437;6;23;36;13;0,1875;0,28125
"27";475;129;5438;6;76;88;12;0,59375;0,6875
"28";475;129;5439;6;36;48;12;0,28125;0,375
"29";475;129;5440;6;27;40;13;0,21875;0,3125
"30";475;129;5441;6;72;84;12;0,5625;0,65625
"31";475;129;5442;6;96;109;13;0,75;0,84375
"32";475;129;5443;6;32;44;12;0,25;0,34375
"33";475;129;5444;6;52;64;12;0,40625;0,5
"34";475;129;5445;6;56;68;12;0,4375;0,53125
"35";475;129;5446;6;60;72;12;0,46875;0,5625
"36";475;129;5447;6;32;48;16;0,25;0,375
"37";475;129;5448;6;36;52;16;0,28125;0,40625
"38";475;129;5449;6;101;113;12;0,78125;0,875
"39";475;129;5450;6;88;101;13;0,6875;0,78125
"40";3927;113;1041;4;72;97;25;0,642857142857143;0,857142857142857
"41";3927;113;1042;5;19;32;13;0,178571428571429;0,285714285714286
"42";3927;113;1043;5;76;89;13;0,678571428571429;0,785714285714286
"43";3927;113;1044;5;80;93;13;0,714285714285714;0,821428571428571
"44";3927;113;1045;5;11;23;12;0,107142857142857;0,214285714285714
"45";3927;113;1046;5;23;36;13;0,214285714285714;0,321428571428571
"46";3927;113;1047;5;3;15;12;0,0357142857142857;0,142857142857143
"47";3927;113;1048;5;68;80;12;0,607142857142857;0,714285714285714
"48";3927;113;1049;5;7;19;12;0,0714285714285714;0,178571428571429
"49";3927;113;1050;6;3;9;6;0,0350877192982456;0,087719298245614
"50";3927;113;1051;6;7;13;6;0,0701754385964912;0,12280701754386
"51";3927;113;1052;6;31;37;6;0,280701754385965;0,333333333333333
"52";3927;113;1053;6;5;11;6;0,0526315789473684;0,105263157894737
"53";3927;113;1054;6;5;13;8;0,0526315789473684;0,12280701754386
"54";3927;113;1055;6;13;19;6;0,12280701754386;0,175438596491228
"55";3927;113;1056;6;13;21;8;0,12280701754386;0,192982456140351
"56";3927;113;1057;6;13;23;10;0,12280701754386;0,210526315789474
"57";3927;113;1058;6;85;91;6;0,754385964912281;0,807017543859649
"58";3927;113;1059;6;37;43;6;0,333333333333333;0,385964912280702
"59";3927;113;1060;6;35;41;6;0,315789473684211;0,368421052631579
"60";3927;113;1061;6;7;15;8;0,0701754385964912;0,140350877192982
"61";3927;113;1062;6;11;17;6;0,105263157894737;0,157894736842105
"62";3927;113;1063;6;83;89;6;0,736842105263158;0,789473684210526
"63";3927;113;1064;6;69;75;6;0,614035087719298;0,666666666666667
"64";3927;113;1065;6;27;33;6;0,245614035087719;0,298245614035088
"65";3927;113;1066;6;23;29;6;0,210526315789474;0,263157894736842
"66";3927;113;1067;6;29;35;6;0,263157894736842;0,315789473684211
"67";3927;113;1068;6;3;11;8;0,0350877192982456;0,105263157894737
"68";3927;113;1069;6;83;91;8;0,736842105263158;0,807017543859649
"69";3927;113;1070;6;13;25;12;0,12280701754386;0,228070175438596
"70";3927;113;1071;6;11;19;8;0,105263157894737;0,175438596491228
"71";3927;113;1072;6;11;21;10;0,105263157894737;0,192982456140351
"72";3927;113;1073;6;85;93;8;0,754385964912281;0,824561403508772
"73";3927;113;1074;6;39;45;6;0,350877192982456;0,403508771929825
"74";3927;113;5531;4;72;97;25;0,642857142857143;0,857142857142857
"75";3927;113;5532;5;56;68;12;0,5;0,607142857142857
"76";3927;113;5533;5;48;60;12;0,428571428571429;0,535714285714286
"77";3927;113;5534;5;52;64;12;0,464285714285714;0,571428571428571
"78";3927;113;5535;5;19;32;13;0,178571428571429;0,285714285714286
"79";3927;113;5536;6;77;83;6;0,684210526315789;0,736842105263158
"80";3927;113;5537;6;5;11;6;0,0526315789473684;0,105263157894737
"81";3927;113;5538;6;65;71;6;0,578947368421053;0,631578947368421
"82";3927;113;5539;6;45;51;6;0,403508771929825;0,456140350877193
"83";3927;113;5540;6;59;65;6;0,526315789473684;0,578947368421053
"84";3927;113;5541;6;39;45;6;0,350877192982456;0,403508771929825
"85";3927;113;5542;6;83;89;6;0,736842105263158;0,789473684210526
"86";3927;113;5543;6;75;81;6;0,666666666666667;0,719298245614035
"87";3085;85;1172;5;15;28;13;0,19047619047619;0,333333333333333
"88";3085;85;1173;5;11;24;13;0,142857142857143;0,285714285714286
"89";3085;85;1174;5;24;36;12;0,285714285714286;0,428571428571429
"90";3085;85;1175;5;48;60;12;0,571428571428571;0,714285714285714
"91";3085;85;1176;5;40;52;12;0,476190476190476;0,619047619047619
"92";3085;85;1177;5;36;48;12;0,428571428571429;0,571428571428571
"93";3085;85;1178;6;1;7;6;0,0232558139534884;0,0930232558139535
"94";3085;85;1179;6;39;45;6;0,465116279069767;0,534883720930233
"95";3085;85;1180;6;39;47;8;0,465116279069767;0,558139534883721
"96";3085;85;1181;6;41;47;6;0,488372093023256;0,558139534883721
"97";3085;85;1182;6;7;13;6;0,0930232558139535;0,162790697674419
"98";3085;85;1183;6;23;29;6;0,27906976744186;0,348837209302326
"99";3085;85;1184;6;19;25;6;0,232558139534884;0,302325581395349
"100";3085;85;1185;6;19;27;8;0,232558139534884;0,325581395348837
"101";3085;85;1186;6;65;71;6;0,767441860465116;0,837209302325581
"102";3085;85;1187;6;49;55;6;0,581395348837209;0,651162790697674
"103";3085;85;1188;6;47;53;6;0,558139534883721;0,627906976744186
"104";3085;85;1189;6;27;33;6;0,325581395348837;0,395348837209302
"105";3085;85;1190;6;41;49;8;0,488372093023256;0,581395348837209
"106";3085;85;1191;6;37;43;6;0,441860465116279;0,511627906976744
"107";3085;85;1192;6;13;19;6;0,162790697674419;0,232558139534884
"108";3085;85;1193;6;17;23;6;0,209302325581395;0,27906976744186
"109";3085;85;1194;6;29;35;6;0,348837209302326;0,418604651162791
"110";3085;85;1195;6;33;39;6;0,395348837209302;0,465116279069767
"111";3085;85;1196;6;33;41;8;0,395348837209302;0,488372093023256
"112";3085;85;1197;6;37;45;8;0,441860465116279;0,534883720930233
"113";3085;85;1198;6;25;31;6;0,302325581395349;0,372093023255814
"114";3085;85;1199;6;23;31;8;0,27906976744186;0,372093023255814
"115";3085;85;1200;6;29;37;8;0,348837209302326;0,441860465116279
"116";3085;85;5579;4;25;51;26;0,3;0,6
"117";3085;85;5580;5;48;60;12;0,571428571428571;0,714285714285714
"118";3085;85;5581;5;15;28;13;0,19047619047619;0,333333333333333
"119";3085;85;5582;5;44;56;12;0,523809523809524;0,666666666666667
"120";3085;85;5583;5;40;52;12;0,476190476190476;0,619047619047619
"121";3085;85;5584;5;60;73;13;0,714285714285714;0,857142857142857
"122";3085;85;5585;6;1;7;6;0,0232558139534884;0,0930232558139535
"123";3085;85;5586;6;65;71;6;0,767441860465116;0,837209302325581
"124";3085;85;5587;6;49;55;6;0,581395348837209;0,651162790697674
"125";3085;85;5588;6;41;47;6;0,488372093023256;0,558139534883721
"126";3085;85;5589;6;33;39;6;0,395348837209302;0,465116279069767
"127";3085;85;5590;6;39;45;6;0,465116279069767;0,534883720930233
"128";3085;85;5591;6;39;47;8;0,465116279069767;0,558139534883721
"129";3085;85;5592;6;41;49;8;0,488372093023256;0,581395348837209
"130";3584;140;1384;5;74;99;25;0,529411764705882;0,705882352941177
"131";3584;140;1385;5;32;57;25;0,235294117647059;0,411764705882353
"132";3584;140;1386;5;107;132;25;0,764705882352941;0,941176470588235
"133";3584;140;1387;5;90;115;25;0,647058823529412;0,823529411764706
"134";3584;140;1388;5;40;65;25;0,294117647058824;0,470588235294118
"135";3584;140;1389;5;57;82;25;0,411764705882353;0,588235294117647
"136";3584;140;1390;5;99;123;24;0,705882352941177;0,882352941176471
"137";3584;140;1391;5;82;107;25;0,588235294117647;0,764705882352941
"138";3584;140;1392;6;15;27;12;0,114285714285714;0,2
"139";3584;140;1393;6;80;92;12;0,571428571428571;0,657142857142857
"140";3584;140;1394;6;43;55;12;0,314285714285714;0,4
"141";3584;140;1395;6;47;59;12;0,342857142857143;0,428571428571429
"142";3584;140;1396;6;76;88;12;0,542857142857143;0,628571428571429
"143";3584;140;1397;6;108;120;12;0,771428571428571;0,857142857142857
"144";3584;140;1398;6;63;76;13;0,457142857142857;0,542857142857143
"145";3584;140;1399;6;100;112;12;0,714285714285714;0,8
"146";3584;140;1400;6;31;43;12;0,228571428571429;0,314285714285714
"147";3584;140;1401;6;72;84;12;0,514285714285714;0,6
"148";3584;140;1402;6;80;96;16;0,571428571428571;0,685714285714286
"149";3584;140;1403;6;96;108;12;0,685714285714286;0,771428571428571
"150";3584;140;1404;6;104;116;12;0,742857142857143;0,828571428571429
"151";3584;140;1405;6;35;47;12;0,257142857142857;0,342857142857143
"152";3584;140;1406;6;92;104;12;0,657142857142857;0,742857142857143
"153";3584;140;1407;6;76;92;16;0,542857142857143;0,657142857142857
"154";3584;140;1408;6;72;88;16;0,514285714285714;0,628571428571429
"155";3584;140;1409;6;92;108;16;0,657142857142857;0,771428571428571
"156";3584;140;1410;6;112;124;12;0,8;0,885714285714286
"157";3584;140;1411;6;19;31;12;0,142857142857143;0,228571428571429
"158";3584;140;5638;4;70;122;52;0,5;0,875
"159";3584;140;5639;5;32;57;25;0,235294117647059;0,411764705882353
"160";3584;140;5640;5;82;107;25;0,588235294117647;0,764705882352941
"161";3584;140;5641;5;107;132;25;0,764705882352941;0,941176470588235
"162";3584;140;5642;6;11;23;12;0,0857142857142857;0,171428571428571
"163";3584;140;5643;6;108;120;12;0,771428571428571;0,857142857142857
"164";3584;140;5644;6;116;128;12;0,828571428571429;0,914285714285714
"165";3584;140;5645;6;35;47;12;0,257142857142857;0,342857142857143
"166";3584;140;5646;6;100;112;12;0,714285714285714;0,8
"167";3584;140;5647;6;100;116;16;0,714285714285714;0,828571428571429
"168";3584;140;5648;6;104;116;12;0,742857142857143;0,828571428571429
"169";3584;140;5649;6;3;15;12;0,0285714285714286;0,114285714285714
"170";3584;140;5650;6;72;84;12;0,514285714285714;0,6
"171";4007;132;1512;6;92;104;12;0,696969696969697;0,787878787878788
"172";4007;132;1513;6;68;80;12;0,515151515151515;0,606060606060606
"173";4007;132;1514;6;88;100;12;0,666666666666667;0,757575757575758
"174";4007;132;1515;6;76;88;12;0,575757575757576;0,666666666666667
"175";4007;132;1516;6;39;51;12;0,303030303030303;0,393939393939394
"176";4007;132;1517;6;84;96;12;0,636363636363636;0,727272727272727
"177";4007;132;1518;6;55;68;13;0,424242424242424;0,515151515151515
"178";4007;132;1519;6;35;47;12;0,272727272727273;0,363636363636364
"179";4007;132;5690;5;74;99;25;0,5625;0,75
"180";4007;132;5691;6;96;108;12;0,727272727272727;0,818181818181818
"181";4007;132;5692;6;84;96;12;0,636363636363636;0,727272727272727
"182";4007;132;5693;6;31;43;12;0,242424242424242;0,333333333333333
"183";4445;110;1774;4;59;84;25;0,538461538461538;0,769230769230769
"184";4445;110;1775;5;3;15;12;0,037037037037037;0,148148148148148
"185";4445;110;1776;5;20;32;12;0,185185185185185;0,296296296296296
"186";4445;110;1777;5;24;36;12;0,222222222222222;0,333333333333333
"187";4445;110;1778;5;28;40;12;0,259259259259259;0,37037037037037
"188";4445;110;1779;5;36;48;12;0,333333333333333;0,444444444444444
"189";4445;110;1780;5;7;20;13;0,0740740740740741;0,185185185185185
"190";4445;110;1781;5;32;44;12;0,296296296296296;0,407407407407407
"191";4445;110;1782;5;44;57;13;0,407407407407407;0,518518518518518
"192";4445;110;1783;5;40;52;12;0,37037037037037;0,481481481481481
"193";4445;110;1784;6;21;27;6;0,2;0,254545454545455
"194";4445;110;1785;6;31;37;6;0,290909090909091;0,345454545454545
"195";4445;110;1786;6;35;41;6;0,327272727272727;0,381818181818182
"196";4445;110;1787;6;82;88;6;0,745454545454545;0,8
"197";4445;110;1788;6;43;49;6;0,4;0,454545454545455
"198";4445;110;1789;6;27;33;6;0,254545454545455;0,309090909090909
"199";4445;110;1790;6;27;35;8;0,254545454545455;0,327272727272727
"200";4445;110;1791;6;29;35;6;0,272727272727273;0,327272727272727
"201";4445;110;1792;6;35;43;8;0,327272727272727;0,4
"202";4445;110;1793;6;62;68;6;0,563636363636364;0,618181818181818
"203";4445;110;1794;6;13;19;6;0,127272727272727;0,181818181818182
"204";4445;110;1795;6;80;86;6;0,727272727272727;0,781818181818182
"205";4445;110;1796;6;31;39;8;0,290909090909091;0,363636363636364
"206";4445;110;1797;6;31;41;10;0,290909090909091;0,381818181818182
"207";4445;110;1798;6;76;82;6;0,690909090909091;0,745454545454545
"208";4445;110;1799;6;47;53;6;0,436363636363636;0,490909090909091
"209";4445;110;1800;6;49;56;7;0,454545454545455;0,509090909090909
"210";4445;110;1801;6;11;17;6;0,109090909090909;0,163636363636364
"211";4445;110;1802;6;56;62;6;0,509090909090909;0,563636363636364
"212";4445;110;1803;6;29;37;8;0,272727272727273;0,345454545454545
"213";4445;110;1804;6;35;45;10;0,327272727272727;0,418181818181818
"214";4445;110;1805;6;35;47;12;0,327272727272727;0,436363636363636
"215";4445;110;1806;6;51;58;7;0,472727272727273;0,527272727272727
"216";4445;110;1807;6;25;31;6;0,236363636363636;0,290909090909091
"217";4445;110;1808;6;23;29;6;0,218181818181818;0,272727272727273
"218";4445;110;1809;6;3;9;6;0,0363636363636364;0,0909090909090909
"219";4445;110;1810;6;60;66;6;0,545454545454545;0,6
"220";4445;110;1811;6;47;56;9;0,436363636363636;0,509090909090909
"221";4445;110;1812;6;15;21;6;0,145454545454545;0,2
"222";4445;110;1813;6;43;51;8;0,4;0,472727272727273
"223";4445;110;1814;6;58;64;6;0,527272727272727;0,581818181818182
"224";4445;110;1815;6;5;11;6;0,0545454545454545;0,109090909090909
"225";4445;110;1816;6;80;88;8;0,727272727272727;0,8
"226";4445;110;5785;4;25;50;25;0,230769230769231;0,461538461538462
"227";4445;110;5786;5;36;48;12;0,333333333333333;0,444444444444444
"228";4445;110;5787;5;20;32;12;0,185185185185185;0,296296296296296
"229";4445;110;5788;5;11;24;13;0,111111111111111;0,222222222222222
"230";4445;110;5789;5;40;52;12;0,37037037037037;0,481481481481481
"231";4445;110;5790;5;52;65;13;0,481481481481481;0,592592592592593
"232";4445;110;5791;5;24;36;12;0,222222222222222;0,333333333333333
"233";4445;110;5792;5;20;36;16;0,185185185185185;0,333333333333333
"234";4445;110;5793;6;23;29;6;0,218181818181818;0,272727272727273
"235";4445;110;5794;6;29;35;6;0,272727272727273;0,327272727272727
"236";4445;110;5795;6;76;82;6;0,690909090909091;0,745454545454545
"237";4445;110;5796;6;82;88;6;0,745454545454545;0,8
"238";4445;110;5797;6;74;80;6;0,672727272727273;0,727272727272727
"239";4445;110;5798;6;43;49;6;0,4;0,454545454545455
"240";4445;110;5799;6;68;74;6;0,618181818181818;0,672727272727273
"241";4445;110;5800;6;3;9;6;0,0363636363636364;0,0909090909090909
"242";4445;110;5801;6;5;11;6;0,0545454545454545;0,109090909090909
"243";4445;110;5802;6;15;21;6;0,145454545454545;0,2
"244";4445;110;5803;6;7;13;6;0,0727272727272727;0,127272727272727
"245";4445;110;5804;6;80;86;6;0,727272727272727;0,781818181818182
"246";4445;110;5805;6;66;72;6;0,6;0,654545454545455
"247";4614;77;1842;4;34;60;26;0,444444444444444;0,777777777777778
"248";4614;77;5814;4;34;60;26;0,444444444444444;0,777777777777778
"249";4614;77;5815;5;36;48;12;0,473684210526316;0,631578947368421
"250";4867;97;1880;5;64;77;13;0,666666666666667;0,791666666666667
"251";4867;97;1881;5;48;60;12;0,5;0,625
"252";4867;97;1882;5;56;68;12;0,583333333333333;0,708333333333333
"253";4867;97;1883;5;60;72;12;0,625;0,75
"254";4867;97;1884;5;28;40;12;0,291666666666667;0,416666666666667
"255";4867;97;1885;5;52;64;12;0,541666666666667;0,666666666666667
"256";4867;97;1886;6;31;37;6;0,326530612244898;0,387755102040816
"257";4867;97;1887;6;53;59;6;0,551020408163265;0,612244897959184
"258";4867;97;1888;6;53;61;8;0,551020408163265;0,63265306122449
"259";4867;97;1889;6;55;61;6;0,571428571428571;0,63265306122449
"260";4867;97;1890;6;59;65;6;0,612244897959184;0,673469387755102
"261";4867;97;1891;6;71;77;6;0,73469387755102;0,795918367346939
"262";4867;97;1892;6;51;57;6;0,530612244897959;0,591836734693878
"263";4867;97;1893;6;37;43;6;0,387755102040816;0,448979591836735
"264";4867;97;1894;6;59;67;8;0,612244897959184;0,693877551020408
"265";4867;97;1895;6;55;63;8;0,571428571428571;0,653061224489796
"266";4867;97;1896;6;35;41;6;0,36734693877551;0,428571428571429
"267";4867;97;1897;6;49;55;6;0,510204081632653;0,571428571428571
"268";4867;97;1898;6;17;23;6;0,183673469387755;0,244897959183673
"269";4867;97;1899;6;39;45;6;0,408163265306122;0,469387755102041
"270";4867;97;1900;6;31;39;8;0,326530612244898;0,408163265306122
"271";4867;97;1901;6;41;47;6;0,428571428571429;0,489795918367347
"272";4867;97;1902;6;55;65;10;0,571428571428571;0,673469387755102
"273";4867;97;1903;6;15;21;6;0,163265306122449;0,224489795918367
"274";4867;97;1904;6;11;17;6;0,122448979591837;0,183673469387755
"275";4867;97;5819;4;40;64;24;0,416666666666667;0,666666666666667
"276";4867;97;5820;5;60;72;12;0,625;0,75
"277";4867;97;5821;5;64;77;13;0,666666666666667;0,791666666666667
"278";4867;97;5822;5;28;40;12;0,291666666666667;0,416666666666667
"279";4867;97;5823;5;48;60;12;0,5;0,625
"280";4867;97;5824;5;60;77;17;0,625;0,791666666666667
"281";4867;97;5825;5;3;15;12;0,0416666666666667;0,166666666666667
"282";4867;97;5826;6;39;45;6;0,408163265306122;0,469387755102041
"283";4867;97;5827;6;41;47;6;0,428571428571429;0,489795918367347
"284";4867;97;5828;6;59;65;6;0,612244897959184;0,673469387755102
"285";4867;97;5829;6;31;37;6;0,326530612244898;0,387755102040816
"286";4867;97;5830;6;71;77;6;0,73469387755102;0,795918367346939
"287";4867;97;5831;6;59;67;8;0,612244897959184;0,693877551020408
"288";4867;97;5832;6;13;19;6;0,142857142857143;0,204081632653061
"289";4936;90;1963;4;57;82;25;0,636363636363636;0,909090909090909
"290";4936;90;1964;4;24;49;25;0,272727272727273;0,545454545454545
"291";4936;90;1965;5;28;40;12;0,318181818181818;0,454545454545455
"292";4936;90;1966;5;3;16;13;0,0454545454545455;0,181818181818182
"293";4936;90;1967;5;24;36;12;0,272727272727273;0,409090909090909
"294";4936;90;1968;5;65;78;13;0,727272727272727;0,863636363636364
"295";4936;90;1969;6;23;29;6;0,266666666666667;0,333333333333333
"296";4936;90;1970;6;23;31;8;0,266666666666667;0,355555555555556
"297";4936;90;1971;6;25;31;6;0,288888888888889;0,355555555555556
"298";4936;90;1972;6;5;11;6;0,0666666666666667;0,133333333333333
"299";4936;90;1973;6;39;46;7;0,444444444444444;0,511111111111111
"300";4936;90;1974;6;27;33;6;0,311111111111111;0,377777777777778
"301";4936;90;1975;6;27;35;8;0,311111111111111;0,4
"302";4936;90;1976;6;68;74;6;0,755555555555556;0,822222222222222
"303";4936;90;1977;6;68;76;8;0,755555555555556;0,844444444444444
"304";4936;90;1978;6;70;76;6;0,777777777777778;0,844444444444444
"305";4936;90;1979;6;11;17;6;0,133333333333333;0,2
"306";4936;90;1980;6;37;43;6;0,422222222222222;0,488888888888889
"307";4936;90;1981;6;66;72;6;0,733333333333333;0,8
"308";4936;90;1982;6;70;78;8;0,777777777777778;0,866666666666667
"309";4936;90;1983;6;41;48;7;0,466666666666667;0,533333333333333
"310";4936;90;1984;6;17;23;6;0,2;0,266666666666667
"311";4936;90;1985;6;17;25;8;0,2;0,288888888888889
"312";4936;90;1986;6;25;33;8;0,288888888888889;0,377777777777778
"313";4936;90;1987;6;25;35;10;0,288888888888889;0,4
"314";4936;90;1988;6;35;41;6;0,4;0,466666666666667
"315";4936;90;1989;6;66;74;8;0,733333333333333;0,822222222222222
"316";4936;90;1990;6;21;27;6;0,244444444444444;0,311111111111111
"317";4936;90;1991;6;5;13;8;0,0666666666666667;0,155555555555556
"318";4936;90;5856;4;57;82;25;0,636363636363636;0,909090909090909
"319";4936;90;5857;5;16;28;12;0,181818181818182;0,318181818181818
"320";4936;90;5858;5;40;53;13;0,454545454545455;0,590909090909091
"321";4936;90;5859;5;28;40;12;0,318181818181818;0,454545454545455
"322";4936;90;5860;6;33;39;6;0,377777777777778;0,444444444444444
"323";4936;90;5861;6;25;31;6;0,288888888888889;0,355555555555556
"324";4936;90;5862;6;31;37;6;0,355555555555556;0,422222222222222
"325";4936;90;5863;6;39;46;7;0,444444444444444;0,511111111111111
"326";4936;90;5864;6;41;48;7;0,466666666666667;0,533333333333333
"327";4936;90;5865;6;13;19;6;0,155555555555556;0,222222222222222
"328";4936;90;5866;6;25;33;8;0,288888888888889;0,377777777777778
"329";4936;90;5867;6;27;33;6;0,311111111111111;0,377777777777778
"330";4936;90;5868;6;27;35;8;0,311111111111111;0,4
"331";7858;133;2522;5;24;49;25;0,1875;0,375
"332";7858;133;2523;5;83;108;25;0,625;0,8125
"333";7858;133;2524;6;52;64;12;0,393939393939394;0,484848484848485
"334";7858;133;2525;6;72;84;12;0,545454545454545;0,636363636363636
"335";7858;133;2526;6;96;109;13;0,727272727272727;0,818181818181818
"336";7858;133;2527;6;19;31;12;0,151515151515152;0,242424242424242
"337";7858;133;2528;6;23;36;13;0,181818181818182;0,272727272727273
"338";7858;133;2529;6;84;96;12;0,636363636363636;0,727272727272727
"339";7858;133;2530;6;48;60;12;0,363636363636364;0,454545454545455
"340";7858;133;2531;6;80;92;12;0,606060606060606;0,696969696969697
"341";7858;133;2532;6;27;40;13;0,212121212121212;0,303030303030303
"342";7858;133;2533;6;44;56;12;0,333333333333333;0,424242424242424
"343";7858;133;6021;4;16;66;50;0,125;0,5
"344";7858;133;6022;6;31;44;13;0,242424242424242;0,333333333333333
"345";7858;133;6023;6;3;15;12;0,0303030303030303;0,121212121212121
"346";7858;133;6024;6;92;105;13;0,696969696969697;0,787878787878788
"347";7858;133;6025;6;27;40;13;0,212121212121212;0,303030303030303
"348";11187;75;3213;4;33;58;25;0,444444444444444;0,777777777777778
"349";11187;75;3214;4;24;50;26;0,333333333333333;0,666666666666667
"350";11187;75;3215;4;7;33;26;0,111111111111111;0,444444444444444
"351";11187;75;3216;5;11;23;12;0,157894736842105;0,315789473684211
"352";11187;75;3217;5;11;27;16;0,157894736842105;0,368421052631579
"353";11187;75;3218;5;15;27;12;0,210526315789474;0,368421052631579
"354";11187;75;3219;5;27;39;12;0,368421052631579;0,526315789473684
"355";11187;75;3220;5;3;15;12;0,0526315789473684;0,210526315789474
"356";11187;75;3221;5;47;59;12;0,631578947368421;0,789473684210526
"357";11187;75;3222;5;31;43;12;0,421052631578947;0,578947368421053
"358";11187;75;3223;6;3;9;6;0,0526315789473684;0,131578947368421
"359";11187;75;3224;6;3;11;8;0,0526315789473684;0,157894736842105
"360";11187;75;3225;6;5;11;6;0,0789473684210526;0,157894736842105
"361";11187;75;3226;6;9;15;6;0,131578947368421;0,210526315789474
"362";11187;75;3227;6;9;17;8;0,131578947368421;0,236842105263158
"363";11187;75;3228;6;9;19;10;0,131578947368421;0,263157894736842
"364";11187;75;3229;6;23;29;6;0,315789473684211;0,394736842105263
"365";11187;75;3230;6;23;31;8;0,315789473684211;0,421052631578947
"366";11187;75;3231;6;17;23;6;0,236842105263158;0,315789473684211
"367";11187;75;3232;6;17;25;8;0,236842105263158;0,342105263157895
"368";11187;75;3233;6;19;25;6;0,263157894736842;0,342105263157895
"369";11187;75;3234;6;1;7;6;0,0263157894736842;0,105263157894737
"370";11187;75;3235;6;19;27;8;0,263157894736842;0,368421052631579
"371";11187;75;3236;6;5;13;8;0,0789473684210526;0,184210526315789
"372";11187;75;3237;6;17;27;10;0,236842105263158;0,368421052631579
"373";11187;75;3238;6;17;29;12;0,236842105263158;0,394736842105263
"374";11187;75;3239;6;19;29;10;0,263157894736842;0,394736842105263
"375";11187;75;3240;6;5;15;10;0,0789473684210526;0,210526315789474
"376";11187;75;3241;6;35;41;6;0,473684210526316;0,552631578947368
"377";11187;75;3242;6;1;9;8;0,0263157894736842;0,131578947368421
"378";11187;75;6243;4;7;33;26;0,111111111111111;0,444444444444444
"379";11187;75;6244;5;31;43;12;0,421052631578947;0,578947368421053
"380";11187;75;6245;5;27;39;12;0,368421052631579;0,526315789473684
"381";11187;75;6246;6;39;45;6;0,526315789473684;0,605263157894737
"382";11389;65;3276;4;24;48;24;0,375;0,75
"383";11389;65;3277;6;7;13;6;0,121212121212121;0,212121212121212
"384";11389;65;3278;6;39;45;6;0,606060606060606;0,696969696969697
"385";11389;65;6256;6;39;45;6;0,606060606060606;0,696969696969697
"386";12053;87;3349;4;23;47;24;0,272727272727273;0,545454545454545
"387";12053;87;3350;4;31;55;24;0,363636363636364;0,636363636363636
"388";12053;87;3351;4;39;63;24;0,454545454545455;0,727272727272727
"389";12053;87;3352;5;3;15;12;0,0454545454545455;0,181818181818182
"390";12053;87;3353;5;55;67;12;0,636363636363636;0,772727272727273
"391";12053;87;3354;5;11;23;12;0,136363636363636;0,272727272727273
"392";12053;87;3355;5;7;19;12;0,0909090909090909;0,227272727272727
"393";12053;87;3356;5;27;39;12;0,318181818181818;0,454545454545455
"394";12053;87;3357;6;21;27;6;0,25;0,318181818181818
"395";12053;87;3358;6;37;43;6;0,431818181818182;0,5
"396";12053;87;3359;6;11;17;6;0,136363636363636;0,204545454545455
"397";12053;87;3360;6;23;29;6;0,272727272727273;0,340909090909091
"398";12053;87;3361;6;25;31;6;0,295454545454545;0,363636363636364
"399";12053;87;3362;6;3;9;6;0,0454545454545455;0,113636363636364
"400";12053;87;3363;6;1;7;6;0,0227272727272727;0,0909090909090909
"401";12053;87;3364;6;13;19;6;0,159090909090909;0,227272727272727
"402";12053;87;3365;6;49;55;6;0,568181818181818;0,636363636363636
"403";12053;87;3366;6;15;21;6;0,181818181818182;0,25
"404";12053;87;3367;6;17;23;6;0,204545454545455;0,272727272727273
"405";12053;87;6272;4;47;71;24;0,545454545454545;0,818181818181818
"406";12053;87;6273;4;23;47;24;0,272727272727273;0,545454545454545
"407";12053;87;6274;4;15;39;24;0,181818181818182;0,454545454545455
"408";12053;87;6275;5;3;15;12;0,0454545454545455;0,181818181818182
"409";12053;87;6276;5;19;31;12;0,227272727272727;0,363636363636364
"410";12053;87;6277;6;33;39;6;0,386363636363636;0,454545454545455
"411";12053;87;6278;6;5;11;6;0,0681818181818182;0,136363636363636
"412";12053;87;6279;6;19;25;6;0,227272727272727;0,295454545454545
"413";12053;87;6280;6;17;23;6;0,204545454545455;0,272727272727273
"414";12053;87;6281;6;59;65;6;0,681818181818182;0,75
"415";12053;87;6282;6;21;27;6;0,25;0,318181818181818
"416";12053;87;6283;6;21;29;8;0,25;0,340909090909091
"417";12053;87;6284;6;35;41;6;0,409090909090909;0,477272727272727
"418";12053;87;6285;6;37;43;6;0,431818181818182;0,5
"419";12053;87;6286;6;3;9;6;0,0454545454545455;0,113636363636364
"420";12053;87;6287;6;51;57;6;0,590909090909091;0,659090909090909
"421";12053;87;6288;6;53;59;6;0,613636363636364;0,681818181818182
"422";12547;157;3409;4;69;122;53;0,444444444444444;0,777777777777778
"423";12547;157;3410;5;90;115;25;0,578947368421053;0,736842105263158
"424";12547;157;3411;5;99;124;25;0,631578947368421;0,789473684210526
"425";12547;157;3412;5;82;107;25;0,526315789473684;0,684210526315789
"426";12547;157;3413;6;19;31;12;0,128205128205128;0,205128205128205
"427";12547;157;3414;6;35;48;13;0,230769230769231;0,307692307692308
"428";12547;157;3415;6;52;64;12;0,333333333333333;0,41025641025641
"429";12547;157;3416;6;31;44;13;0,205128205128205;0,282051282051282
"430";12547;157;3417;6;116;129;13;0,743589743589744;0,82051282051282
"431";12547;157;3418;6;23;35;12;0,153846153846154;0,230769230769231
"432";12547;157;3419;6;35;52;17;0,230769230769231;0,333333333333333
"433";12547;157;3420;6;19;35;16;0,128205128205128;0,230769230769231
"434";12547;157;3421;6;64;76;12;0,41025641025641;0,487179487179487
"435";12547;157;3422;6;15;27;12;0,102564102564103;0,179487179487179
"436";12547;157;3423;6;31;48;17;0,205128205128205;0,307692307692308
"437";12547;157;6305;4;34;87;53;0,222222222222222;0,555555555555556
"438";12547;157;6306;5;7;32;25;0,0526315789473684;0,210526315789474
"439";12547;157;6307;5;99;124;25;0,631578947368421;0,789473684210526
"440";12547;157;6308;6;3;15;12;0,0256410256410256;0,102564102564103
"441";12547;157;6309;6;48;60;12;0,307692307692308;0,384615384615385
"442";12547;157;6310;6;31;44;13;0,205128205128205;0,282051282051282
"443";12547;157;6311;6;23;35;12;0,153846153846154;0,230769230769231
"444";13079;96;3524;5;27;39;12;0,291666666666667;0,416666666666667
"445";13079;96;3525;5;27;43;16;0,291666666666667;0,458333333333333
"446";13079;96;3526;5;52;64;12;0,541666666666667;0,666666666666667
"447";13079;96;3527;5;64;76;12;0,666666666666667;0,791666666666667
"448";13079;96;3528;6;37;43;6;0,395833333333333;0,458333333333333
"449";13079;96;3529;6;7;13;6;0,0833333333333333;0,145833333333333
"450";13079;96;3530;6;23;29;6;0,25;0,3125
"451";13079;96;3531;6;43;50;7;0,458333333333333;0,520833333333333
"452";13079;96;3532;6;19;25;6;0,208333333333333;0,270833333333333
"453";13079;96;3533;6;33;39;6;0,354166666666667;0,416666666666667
"454";13079;96;3534;6;52;58;6;0,541666666666667;0,604166666666667
"455";13079;96;3535;6;52;60;8;0,541666666666667;0,625
"456";13079;96;3536;6;54;60;6;0,5625;0,625
"457";13079;96;3537;6;31;37;6;0,333333333333333;0,395833333333333
"458";13079;96;3538;6;62;68;6;0,645833333333333;0,708333333333333
"459";13079;96;3539;6;27;33;6;0,291666666666667;0,354166666666667
"460";13079;96;3540;6;50;56;6;0,520833333333333;0,583333333333333
"461";13079;96;3541;6;56;62;6;0,583333333333333;0,645833333333333
"462";13079;96;3542;6;19;27;8;0,208333333333333;0,291666666666667
"463";13079;96;3543;6;21;27;6;0,229166666666667;0,291666666666667
"464";13079;96;3544;6;70;76;6;0,729166666666667;0,791666666666667
"465";13079;96;3545;6;9;15;6;0,104166666666667;0,166666666666667
"466";13079;96;3546;6;60;66;6;0,625;0,6875
"467";13079;96;3547;6;64;70;6;0,666666666666667;0,729166666666667
"468";13079;96;3548;6;54;62;8;0,5625;0,645833333333333
"469";13079;96;3549;6;58;64;6;0,604166666666667;0,666666666666667
"470";13079;96;3550;6;58;66;8;0,604166666666667;0,6875
"471";13079;96;3551;6;68;74;6;0,708333333333333;0,770833333333333
"472";13079;96;3552;6;29;35;6;0,3125;0,375
"473";13079;96;3553;6;5;11;6;0,0625;0,125
"474";13079;96;3554;6;21;29;8;0,229166666666667;0,3125
"475";13079;96;3555;6;33;41;8;0,354166666666667;0,4375
"476";13079;96;3556;6;33;43;10;0,354166666666667;0,458333333333333
"477";13079;96;3557;6;3;9;6;0,0416666666666667;0,104166666666667
"478";13079;96;3558;6;56;64;8;0,583333333333333;0,666666666666667
"479";13079;96;6331;5;48;60;12;0,5;0,625
"480";13079;96;6332;5;3;15;12;0,0416666666666667;0,166666666666667
"481";13079;96;6333;5;23;35;12;0,25;0,375
"482";13079;96;6334;6;39;45;6;0,416666666666667;0,479166666666667
"483";13079;96;6335;6;37;43;6;0,395833333333333;0,458333333333333
"484";13079;96;6336;6;64;70;6;0,666666666666667;0,729166666666667
"485";13079;96;6337;6;62;68;6;0,645833333333333;0,708333333333333
"486";15700;136;3751;4;33;85;52;0,25;0,625
"487";15700;136;3752;4;50;102;52;0,375;0,75
"488";15700;136;3753;4;50;119;69;0,375;0,875
"489";15700;136;3754;4;68;119;51;0,5;0,875
"490";15700;136;3755;5;7;31;24;0,0588235294117647;0,235294117647059
"491";15700;136;3756;5;63;88;25;0,470588235294118;0,647058823529412
"492";15700;136;3757;5;15;39;24;0,117647058823529;0,294117647058824
"493";15700;136;3758;5;7;39;32;0,0588235294117647;0,294117647058824
"494";15700;136;3759;5;47;72;25;0,352941176470588;0,529411764705882
"495";15700;136;3760;6;7;19;12;0,0588235294117647;0,147058823529412
"496";15700;136;3761;6;35;47;12;0,264705882352941;0,352941176470588
"497";15700;136;3762;6;63;76;13;0,470588235294118;0,558823529411765
"498";15700;136;3763;6;11;23;12;0,0882352941176471;0,176470588235294
"499";15700;136;3764;6;11;27;16;0,0882352941176471;0,205882352941176
"500";15700;136;3765;6;31;43;12;0,235294117647059;0,323529411764706
"501";15700;136;3766;6;7;23;16;0,0588235294117647;0,176470588235294
"502";15700;136;3767;6;47;59;12;0,352941176470588;0,441176470588235
"503";15700;136;3768;6;7;27;20;0,0588235294117647;0,205882352941176
"504";15700;136;3769;6;47;63;16;0,352941176470588;0,470588235294118
"505";15700;136;3770;6;11;31;20;0,0882352941176471;0,235294117647059
"506";15700;136;3771;6;63;80;17;0,470588235294118;0,588235294117647
"507";15700;136;3772;6;63;84;21;0,470588235294118;0,617647058823529
"508";15700;136;3773;6;63;88;25;0,470588235294118;0,647058823529412
"509";15700;136;3774;6;63;92;29;0,470588235294118;0,676470588235294
"510";15700;136;3775;6;7;31;24;0,0588235294117647;0,235294117647059
"511";15700;136;6393;6;43;55;12;0,323529411764706;0,411764705882353
"512";15700;136;6394;6;47;59;12;0,352941176470588;0,441176470588235
"513";15700;136;6395;6;35;47;12;0,264705882352941;0,352941176470588
"514";15700;136;6396;6;39;51;12;0,294117647058824;0,382352941176471
"515";15700;136;6397;6;47;63;16;0,352941176470588;0,470588235294118
"516";16025;92;3798;5;56;68;12;0,608695652173913;0,739130434782609
"517";16025;92;3799;5;43;56;13;0,478260869565217;0,608695652173913
"518";16025;92;3800;6;11;17;6;0,130434782608696;0,195652173913043
"519";16025;92;3801;6;15;21;6;0,173913043478261;0,239130434782609
"520";16025;92;3802;6;23;29;6;0,260869565217391;0,326086956521739
"521";16025;92;3803;6;58;64;6;0,630434782608696;0,695652173913043
"522";16025;92;3804;6;29;35;6;0,326086956521739;0,391304347826087
"523";16025;92;3805;6;25;31;6;0,282608695652174;0,347826086956522
"524";16025;92;3806;6;62;68;6;0,673913043478261;0,739130434782609
"525";16025;92;3807;6;70;76;6;0,760869565217391;0,826086956521739
"526";16025;92;3808;6;27;33;6;0,304347826086957;0,369565217391304
"527";16025;92;3809;6;13;19;6;0,152173913043478;0,217391304347826
"528";16025;92;3810;6;54;60;6;0,58695652173913;0,652173913043478
"529";16025;92;3811;6;66;72;6;0,717391304347826;0,782608695652174
"530";16025;92;3812;6;68;74;6;0,739130434782609;0,804347826086957
"531";16025;92;3813;6;72;78;6;0,782608695652174;0,847826086956522
"532";16025;92;3814;6;25;33;8;0,282608695652174;0,369565217391304
"533";16025;92;3815;6;17;23;6;0,195652173913043;0,260869565217391
"534";16025;92;3816;6;1;7;6;0,0217391304347826;0,0869565217391304
"535";16025;92;3817;6;43;50;7;0,478260869565217;0,543478260869565
"536";16025;92;6412;4;41;67;26;0,454545454545455;0,727272727272727
"537";16025;92;6413;5;52;64;12;0,565217391304348;0,695652173913043
"538";16025;92;6414;6;68;74;6;0,739130434782609;0,804347826086957
"539";16025;92;6415;6;66;72;6;0,717391304347826;0,782608695652174
"540";16025;92;6416;6;46;52;6;0,5;0,565217391304348
"541";19596;62;4034;4;3;16;13;0,0666666666666667;0,266666666666667
"542";19596;62;4035;4;16;28;12;0,266666666666667;0,466666666666667
"543";19596;62;4036;4;3;20;17;0,0666666666666667;0,333333333333333
"544";19596;62;4037;5;15;21;6;0,258064516129032;0,354838709677419
"545";19596;62;4038;5;34;40;6;0,548387096774194;0,645161290322581
"546";19596;62;4039;5;34;42;8;0,548387096774194;0,67741935483871
"547";19596;62;4040;5;32;38;6;0,516129032258065;0,612903225806452
"548";19596;62;4041;5;32;40;8;0,516129032258065;0,645161290322581
"549";19596;62;4042;5;17;23;6;0,290322580645161;0,387096774193548
"550";19596;62;4043;5;17;25;8;0,290322580645161;0,419354838709677
"551";19596;62;4044;5;17;27;10;0,290322580645161;0,451612903225806
"552";19596;62;4045;5;27;34;7;0,451612903225806;0,548387096774194
"553";19596;62;4046;5;13;19;6;0,225806451612903;0,32258064516129
"554";19596;62;4047;5;15;23;8;0,258064516129032;0,387096774193548
"555";19596;62;4048;5;25;32;7;0,419354838709677;0,516129032258065
"556";19596;62;4049;5;29;36;7;0,483870967741935;0,580645161290323
"557";19596;62;6485;3;8;35;27;0,142857142857143;0,571428571428571
"558";19596;62;6486;4;3;16;13;0,0666666666666667;0,266666666666667
"559";19596;62;6487;5;29;36;7;0,483870967741935;0,580645161290323
"560";19596;62;6488;5;27;34;7;0,451612903225806;0,548387096774194
"561";21585;79;4134;4;39;63;24;0,5;0,8
"562";21585;79;4135;5;39;51;12;0,5;0,65
"563";21585;79;4136;6;57;63;6;0,725;0,8
"564";21585;79;4137;6;29;35;6;0,375;0,45
"565";21585;79;4138;6;45;51;6;0,575;0,65
"566";21585;79;4139;6;31;37;6;0,4;0,475
"567";21585;79;4140;6;33;39;6;0,425;0,5
"568";21585;79;4141;6;25;31;6;0,325;0,4
"569";21585;79;6505;5;23;35;12;0,3;0,45
"570";21585;79;6506;6;45;51;6;0,575;0,65
"571";21585;79;6507;6;57;63;6;0,725;0,8
"572";25037;59;4173;4;27;39;12;0,466666666666667;0,666666666666667
"573";25037;59;4174;4;23;35;12;0,4;0,6
"574";25037;59;4175;4;3;15;12;0,0666666666666667;0,266666666666667
"575";25037;59;4176;5;9;15;6;0,166666666666667;0,266666666666667
"576";25037;59;4177;5;1;7;6;0,0333333333333333;0,133333333333333
"577";25037;59;4178;5;19;25;6;0,333333333333333;0,433333333333333
"578";25037;59;4179;5;27;33;6;0,466666666666667;0,566666666666667
"579";25037;59;4180;5;25;31;6;0,433333333333333;0,533333333333333
"580";25037;59;4181;5;33;39;6;0,566666666666667;0,666666666666667
"581";25037;59;4182;5;7;13;6;0,133333333333333;0,233333333333333
"582";25037;59;4183;5;31;37;6;0,533333333333333;0,633333333333333
"583";25037;59;4184;5;1;9;8;0,0333333333333333;0,166666666666667
"584";25037;59;4185;5;37;43;6;0,633333333333333;0,733333333333333
"585";25037;59;4186;5;21;27;6;0,366666666666667;0,466666666666667
"586";25037;59;4187;5;17;23;6;0,3;0,4
"587";25037;59;6523;4;15;27;12;0,266666666666667;0,466666666666667
"588";25037;59;6524;4;11;23;12;0,2;0,4
"589";25037;59;6525;4;27;39;12;0,466666666666667;0,666666666666667
"590";25037;59;6526;4;31;43;12;0,533333333333333;0,733333333333333
"591";25037;59;6527;5;9;15;6;0,166666666666667;0,266666666666667
"592";25037;59;6528;5;11;17;6;0,2;0,3
"593";31992;46;4498;4;3;16;13;0,0909090909090909;0,363636363636364
"594";31992;46;4499;5;5;11;6;0,130434782608696;0,260869565217391
"595";31992;46;4500;5;19;26;7;0,434782608695652;0,565217391304348
"596";31992;46;6609;5;19;26;7;0,434782608695652;0,565217391304348
"597";41745;100;4647;5;31;43;12;0,32;0,44
"598";41745;100;4648;5;19;31;12;0,2;0,32
"599";41745;100;4649;5;15;27;12;0,16;0,28
"600";41745;100;4650;5;23;35;12;0,24;0,36
"601";41745;100;4651;6;33;39;6;0,34;0,4
"602";41745;100;4652;6;35;41;6;0,36;0,42
"603";41745;100;4653;6;21;27;6;0,22;0,28
"604";41745;100;4654;6;27;33;6;0,28;0,34
"605";41745;100;4655;6;35;43;8;0,36;0,44
"606";41745;100;4656;6;9;15;6;0,1;0,16
"607";41745;100;4657;6;1;7;6;0,02;0,08
"608";41745;100;4658;6;33;41;8;0,34;0,42
"609";41745;100;4659;6;33;43;10;0,34;0,44
"610";41745;100;6636;5;23;35;12;0,24;0,36
"611";41745;100;6637;5;3;15;12;0,04;0,16
"612";41745;100;6638;6;33;39;6;0,34;0,4
"613";41745;100;6639;6;35;41;6;0,36;0,42
"614";41745;100;6640;6;35;43;8;0,36;0,44
"615";41745;100;6641;6;37;43;6;0,38;0,44
"616";41745;100;6642;6;19;25;6;0,2;0,26
"617";41745;100;6643;6;19;27;8;0,2;0,28
"618";82358;79;4764;4;23;47;24;0,3;0,6
"619";82358;79;4765;6;17;23;6;0,225;0,3
"620";82358;79;4766;6;23;29;6;0,3;0,375
"621";82358;79;4767;6;11;17;6;0,15;0,225
"622";82358;79;4768;6;21;27;6;0,275;0,35
"623";82358;79;4769;6;33;39;6;0,425;0,5
"624";82358;79;4770;6;25;31;6;0,325;0,4
"625";82358;79;6676;6;11;17;6;0,15;0,225
"626";132068;59;4880;4;3;15;12;0,0666666666666667;0,266666666666667
"627";132068;59;4881;4;31;43;12;0,533333333333333;0,733333333333333
"628";132068;59;4882;4;15;27;12;0,266666666666667;0,466666666666667
"629";132068;59;4883;5;5;11;6;0,1;0,2
"630";132068;59;4884;5;7;13;6;0,133333333333333;0,233333333333333
"631";132068;59;4885;5;21;27;6;0,366666666666667;0,466666666666667
"632";132068;59;4886;5;17;23;6;0,3;0,4
"633";132068;59;4887;5;5;13;8;0,1;0,233333333333333
"634";132068;59;4888;5;7;15;8;0,133333333333333;0,266666666666667
"635";132068;59;4889;5;23;29;6;0,4;0,5
"636";132068;59;4890;5;43;49;6;0,733333333333333;0,833333333333333
"637";132068;59;4891;5;41;47;6;0,7;0,8
"638";132068;59;6696;4;35;47;12;0,6;0,8
"639";132068;59;6697;5;21;27;6;0,366666666666667;0,466666666666667
"640";155830;95;4919;3;47;95;48;0,5;1
"641";155830;95;4920;5;7;19;12;0,0833333333333333;0,208333333333333
"642";155830;95;4921;6;13;19;6;0,145833333333333;0,208333333333333
"643";155830;95;4922;6;15;21;6;0,166666666666667;0,229166666666667
"644";155830;95;4923;6;5;11;6;0,0625;0,125
"645";155830;95;4924;6;11;17;6;0,125;0,1875
"646";155830;95;4925;6;39;45;6;0,416666666666667;0,479166666666667
"647";155830;95;4926;6;41;47;6;0,4375;0,5
"648";155830;95;4927;6;77;83;6;0,8125;0,875
"649";155830;95;4928;6;71;77;6;0,75;0,8125
"650";155830;95;6702;4;23;47;24;0,25;0,5
"651";308924;90;4979;5;57;69;12;0,636363636363636;0,772727272727273
"652";308924;90;4980;5;69;82;13;0,772727272727273;0,909090909090909
"653";308924;90;4981;6;1;7;6;0,0222222222222222;0,0888888888888889
"654";308924;90;4982;6;9;15;6;0,111111111111111;0,177777777777778
"655";308924;90;4983;6;48;54;6;0,533333333333333;0,6
"656";308924;90;4984;6;66;72;6;0,733333333333333;0,8
"657";308924;90;4985;6;27;33;6;0,311111111111111;0,377777777777778
"658";308924;90;4986;6;46;52;6;0,511111111111111;0,577777777777778
"659";308924;90;4987;6;74;80;6;0,822222222222222;0,888888888888889
"660";308924;90;4988;6;68;74;6;0,755555555555556;0,822222222222222
"661";308924;90;4989;6;56;62;6;0,622222222222222;0,688888888888889
"662";308924;90;4990;6;66;74;8;0,733333333333333;0,822222222222222
"663";308924;90;6715;5;49;61;12;0,545454545454545;0,681818181818182
"664";308924;90;6716;5;69;82;13;0,772727272727273;0,909090909090909
"665";308924;90;6717;5;53;65;12;0,590909090909091;0,727272727272727
"666";308924;90;6718;6;9;15;6;0,111111111111111;0,177777777777778
"667";308924;90;6719;6;66;72;6;0,733333333333333;0,8
"668";308924;90;6720;6;48;54;6;0,533333333333333;0,6
"669";308924;90;6721;6;68;74;6;0,755555555555556;0,822222222222222
"670";308924;90;6722;6;46;52;6;0,511111111111111;0,577777777777778
"671";308924;90;6723;6;74;80;6;0,822222222222222;0,888888888888889
"672";308924;90;6724;6;39;46;7;0,444444444444444;0,511111111111111
"673";318015;52;5006;4;23;36;13;0,461538461538462;0,692307692307692
"674";318015;52;5007;5;3;9;6;0,0769230769230769;0,192307692307692
"675";318015;52;5008;5;5;11;6;0,115384615384615;0,230769230769231
"676";318015;52;6728;4;23;36;13;0,461538461538462;0,692307692307692
"677";322065;51;5009;5;21;27;6;0,423076923076923;0,538461538461538
"678";322065;51;5010;5;3;9;6;0,0769230769230769;0,192307692307692
"679";322065;51;5011;5;15;21;6;0,307692307692308;0,423076923076923
"680";322065;51;5012;5;25;31;6;0,5;0,615384615384615
"681";322065;51;5013;5;19;25;6;0,384615384615385;0,5
"682";322065;51;5014;5;23;29;6;0,461538461538462;0,576923076923077
"683";322065;51;6729;4;19;31;12;0,384615384615385;0,615384615384615
"684";307140;115;5015;4;49;74;25;0,428571428571429;0,642857142857143
"685";307140;115;5016;5;43;55;12;0,379310344827586;0,482758620689655
"686";307140;115;5017;5;59;71;12;0,517241379310345;0,620689655172414
"687";307140;115;5018;6;61;67;6;0,53448275862069;0,586206896551724
"688";307140;115;6730;4;40;65;25;0,357142857142857;0,571428571428571
"689";307140;115;6731;5;43;55;12;0,379310344827586;0,482758620689655
"690";325178;110;5019;4;59;84;25;0,538461538461538;0,769230769230769
"691";325178;110;5020;4;8;33;25;0,0769230769230769;0,307692307692308
"692";325178;110;5021;4;50;76;26;0,461538461538462;0,692307692307692
"693";325178;110;5022;5;7;20;13;0,0740740740740741;0,185185185185185
"694";325178;110;5023;5;69;81;12;0,62962962962963;0,740740740740741
"695";325178;110;5024;5;7;24;17;0,0740740740740741;0,222222222222222
"696";325178;110;5025;5;7;28;21;0,0740740740740741;0,259259259259259
"697";325178;110;5026;6;15;21;6;0,145454545454545;0,2
"698";325178;110;5027;6;19;25;6;0,181818181818182;0,236363636363636
"699";325178;110;5028;6;82;88;6;0,745454545454545;0,8
"700";325178;110;5029;6;27;33;6;0,254545454545455;0,309090909090909
"701";325178;110;5030;6;43;49;6;0,4;0,454545454545455
"702";325178;110;5031;6;17;23;6;0,163636363636364;0,218181818181818
"703";325178;110;5032;6;23;29;6;0,218181818181818;0,272727272727273
"704";325178;110;5033;6;76;82;6;0,690909090909091;0,745454545454545
"705";325178;110;5034;6;21;27;6;0,2;0,254545454545455
"706";325178;110;5035;6;72;78;6;0,654545454545455;0,709090909090909
"707";325178;110;5036;6;41;47;6;0,381818181818182;0,436363636363636
"708";325178;110;5037;6;11;17;6;0,109090909090909;0,163636363636364
"709";325178;110;5038;6;70;76;6;0,636363636363636;0,690909090909091
"710";325178;110;5039;6;23;31;8;0,218181818181818;0,290909090909091
"711";325178;110;5040;6;9;15;6;0,0909090909090909;0,145454545454545
"712";325178;110;5041;6;68;74;6;0,618181818181818;0,672727272727273
"713";325178;110;5042;6;84;90;6;0,763636363636364;0,818181818181818
"714";325178;110;6732;5;7;20;13;0,0740740740740741;0,185185185185185
"715";325178;110;6733;5;11;24;13;0,111111111111111;0,222222222222222
"716";325178;110;6734;6;58;64;6;0,527272727272727;0,581818181818182
"717";325178;110;6735;6;43;49;6;0,4;0,454545454545455
"718";348235;88;5091;6;41;48;7;0,477272727272727;0,545454545454545
"719";348235;88;5092;6;7;13;6;0,0909090909090909;0,159090909090909
"720";350148;217;5103;5;7;31;24;0,037037037037037;0,148148148148148
"721";350148;217;5104;6;88;100;12;0,407407407407407;0,462962962962963
"722";350148;217;5105;6;156;169;13;0,722222222222222;0,777777777777778
"723";350148;217;5106;6;56;68;12;0,259259259259259;0,314814814814815
