"";"pid";"max.age";"seq.id";"seq.revlevel";"seq.start";"seq.end";"seq.length";"seq.start.rel";"seq.end.rel"
"1";585077;24;49;3;7;20;13;0,333333333333333;0,833333333333333
"2";585077;24;50;3;7;24;17;0,333333333333333;1
"3";585077;24;51;4;7;14;7;0,333333333333333;0,583333333333333
"4";585077;24;52;4;7;16;9;0,333333333333333;0,666666666666667
"5";585077;24;53;4;7;18;11;0,333333333333333;0,75
"6";585077;24;54;4;7;20;13;0,333333333333333;0,833333333333333
"7";585077;24;55;4;7;22;15;0,333333333333333;0,916666666666667
"8";585077;24;56;4;7;24;17;0,333333333333333;1
"9";589515;19;662;3;7;19;12;0,4;1
"10";589515;19;663;3;3;15;12;0,2;0,8
"11";589515;19;664;3;3;19;16;0,2;1
"12";589515;19;665;4;5;11;6;0,3;0,6
"13";589515;19;666;4;3;9;6;0,2;0,5
"14";589515;19;667;4;5;13;8;0,3;0,7
"15";589515;19;668;4;5;15;10;0,3;0,8
"16";589515;19;669;4;5;17;12;0,3;0,9
"17";589515;19;670;4;5;19;14;0,3;1
"18";589515;19;671;4;1;7;6;0,1;0,4
"19";589515;19;672;4;3;11;8;0,2;0,6
"20";589515;19;673;4;3;13;10;0,2;0,7
"21";589515;19;674;4;3;15;12;0,2;0,8
"22";586805;26;1711;3;12;26;14;0,5;1
"23";586805;26;1712;4;11;18;7;0,461538461538462;0,692307692307692
"24";586805;26;1713;4;11;20;9;0,461538461538462;0,769230769230769
"25";586805;26;1714;4;11;22;11;0,461538461538462;0,846153846153846
"26";586805;26;1715;4;11;24;13;0,461538461538462;0,923076923076923
"27";586805;26;1716;4;11;26;15;0,461538461538462;1
"28";586805;26;1717;4;3;9;6;0,153846153846154;0,384615384615385
"29";587198;20;1718;3;3;16;13;0,2;0,8
"30";587198;20;1719;3;3;20;17;0,2;1
"31";587198;20;1720;4;1;7;6;0,1;0,4
"32";587198;20;1721;4;1;10;9;0,1;0,5
"33";587198;20;1722;4;1;12;11;0,1;0,6
"34";587198;20;1723;4;1;14;13;0,1;0,7
"35";587198;20;1724;4;1;16;15;0,1;0,8
"36";587198;20;1725;4;1;18;17;0,1;0,9
"37";587198;20;1726;4;1;20;19;0,1;1
"38";587204;19;1727;3;3;15;12;0,2;0,8
"39";587204;19;1728;3;3;19;16;0,2;1
"40";587204;19;1729;3;7;19;12;0,4;1
"41";587204;19;1730;4;1;7;6;0,1;0,4
"42";587204;19;1731;4;1;9;8;0,1;0,5
"43";587204;19;1732;4;5;11;6;0,3;0,6
"44";587204;19;1733;4;7;13;6;0,4;0,7
"45";587204;19;1734;4;7;15;8;0,4;0,8
"46";587204;19;1735;4;1;11;10;0,1;0,6
"47";587204;19;1736;4;1;13;12;0,1;0,7
"48";587204;19;1737;4;5;13;8;0,3;0,7
"49";587204;19;1738;4;5;15;10;0,3;0,8
"50";587204;19;1739;4;5;17;12;0,3;0,9
"51";587204;19;1740;4;7;17;10;0,4;0,9
"52";587204;19;1741;4;7;19;12;0,4;1
"53";587204;19;1742;4;5;19;14;0,3;1
"54";587204;19;1743;4;1;15;14;0,1;0,8
"55";587204;19;1744;4;1;17;16;0,1;0,9
"56";587204;19;1745;4;1;19;18;0,1;1
"57";587571;22;1746;3;4;17;13;0,2;0,8
"58";587571;22;1747;3;4;22;18;0,2;1
"59";587571;22;1748;3;8;22;14;0,4;1
"60";587571;22;1749;4;5;12;7;0,272727272727273;0,545454545454545
"61";587571;22;1750;4;5;14;9;0,272727272727273;0,636363636363636
"62";587571;22;1751;4;7;14;7;0,363636363636364;0,636363636363636
"63";587571;22;1752;4;9;16;7;0,454545454545455;0,727272727272727
"64";587571;22;1753;4;9;18;9;0,454545454545455;0,818181818181818
"65";587571;22;1754;4;3;9;6;0,181818181818182;0,454545454545455
"66";587571;22;1755;4;3;12;9;0,181818181818182;0,545454545454545
"67";587571;22;1756;4;3;14;11;0,181818181818182;0,636363636363636
"68";587571;22;1757;4;3;16;13;0,181818181818182;0,727272727272727
"69";587571;22;1758;4;5;16;11;0,272727272727273;0,727272727272727
"70";587571;22;1759;4;5;18;13;0,272727272727273;0,818181818181818
"71";587571;22;1760;4;7;16;9;0,363636363636364;0,727272727272727
"72";587571;22;1761;4;7;18;11;0,363636363636364;0,818181818181818
"73";587571;22;1762;4;7;20;13;0,363636363636364;0,909090909090909
"74";587571;22;1763;4;5;20;15;0,272727272727273;0,909090909090909
"75";587571;22;1764;4;5;22;17;0,272727272727273;1
"76";587571;22;1765;4;7;22;15;0,363636363636364;1
"77";587571;22;1766;4;9;20;11;0,454545454545455;0,909090909090909
"78";587571;22;1767;4;9;22;13;0,454545454545455;1
"79";587571;22;1768;4;1;7;6;0,0909090909090909;0,363636363636364
"80";588411;17;1774;3;4;17;13;0,25;1
"81";588411;17;1775;4;1;7;6;0,111111111111111;0,444444444444444
"82";588411;17;1776;4;3;9;6;0,222222222222222;0,555555555555556
"83";588411;17;1777;4;1;9;8;0,111111111111111;0,555555555555556
"84";588411;17;1778;4;1;11;10;0,111111111111111;0,666666666666667
"85";588411;17;1779;4;1;13;12;0,111111111111111;0,777777777777778
"86";588411;17;1780;4;1;15;14;0,111111111111111;0,888888888888889
"87";588411;17;1781;4;3;11;8;0,222222222222222;0,666666666666667
"88";588411;17;1782;4;3;13;10;0,222222222222222;0,777777777777778
"89";588411;17;1783;4;3;15;12;0,222222222222222;0,888888888888889
"90";588411;17;1784;4;1;17;16;0,111111111111111;1
"91";588411;17;1785;4;3;17;14;0,222222222222222;1
"92";589091;13;1792;3;1;7;6;0,142857142857143;0,571428571428571
"93";589091;13;1793;3;1;9;8;0,142857142857143;0,714285714285714
"94";589091;13;1794;3;1;11;10;0,142857142857143;0,857142857142857
"95";589091;13;1795;3;1;13;12;0,142857142857143;1
"96";475;129;2101;3;32;129;97;0,25;1
"97";475;129;2102;4;15;64;49;0,125;0,5
"98";475;129;2103;4;80;129;49;0,625;1
"99";475;129;2104;4;64;113;49;0,5;0,875
"100";475;129;2105;4;48;96;48;0,375;0,75
"101";475;129;2106;4;32;80;48;0,25;0,625
"102";475;129;2107;4;64;129;65;0,5;1
"103";475;129;2108;5;64;88;24;0,5;0,6875
"104";475;129;2109;5;72;96;24;0,5625;0,75
"105";475;129;2110;5;72;105;33;0,5625;0,8125
"106";475;129;2111;5;96;121;25;0,75;0,9375
"107";475;129;2112;5;96;129;33;0,75;1
"108";475;129;2113;5;105;129;24;0,8125;1
"109";475;129;2114;5;23;48;25;0,1875;0,375
"110";475;129;2115;5;80;105;25;0,625;0,8125
"111";475;129;2116;5;80;113;33;0,625;0,875
"112";475;129;2117;5;40;64;24;0,3125;0,5
"113";475;129;2118;5;88;113;25;0,6875;0,875
"114";475;129;2119;5;32;56;24;0,25;0,4375
"115";475;129;2120;5;15;40;25;0,125;0,3125
"116";475;129;2121;5;88;121;33;0,6875;0,9375
"117";475;129;2122;5;48;72;24;0,375;0,5625
"118";475;129;2123;5;88;129;41;0,6875;1
"119";475;129;2124;5;64;96;32;0,5;0,75
"120";475;129;2125;5;64;105;41;0,5;0,8125
"121";475;129;2126;5;7;32;25;0,0625;0,25
"122";475;129;2127;5;56;80;24;0,4375;0,625
"123";475;129;2128;5;80;121;41;0,625;0,9375
"124";475;129;2129;5;80;129;49;0,625;1
"125";475;129;2130;6;44;56;12;0,34375;0,4375
"126";475;129;2131;6;72;84;12;0,5625;0,65625
"127";475;129;2132;6;80;92;12;0,625;0,71875
"128";475;129;2133;6;80;96;16;0,625;0,75
"129";475;129;2134;6;84;96;12;0,65625;0,75
"130";475;129;2135;6;84;101;17;0,65625;0,78125
"131";475;129;2136;6;105;117;12;0,8125;0,90625
"132";475;129;2137;6;109;121;12;0,84375;0,9375
"133";475;129;2138;6;48;60;12;0,375;0,46875
"134";475;129;2139;6;56;68;12;0,4375;0,53125
"135";475;129;2140;6;72;88;16;0,5625;0,6875
"136";475;129;2141;6;88;101;13;0,6875;0,78125
"137";475;129;2142;6;105;121;16;0,8125;0,9375
"138";475;129;2143;6;105;125;20;0,8125;0,96875
"139";475;129;2144;6;52;64;12;0,40625;0,5
"140";475;129;2145;6;11;23;12;0,09375;0,1875
"141";475;129;2146;6;7;19;12;0,0625;0,15625
"142";475;129;2147;6;60;72;12;0,46875;0,5625
"143";475;129;2148;6;88;105;17;0,6875;0,8125
"144";475;129;2149;6;92;105;13;0,71875;0,8125
"145";475;129;2150;6;109;125;16;0,84375;0,96875
"146";475;129;2151;6;109;129;20;0,84375;1
"147";475;129;2152;6;52;68;16;0,40625;0,53125
"148";475;129;2153;6;68;80;12;0,53125;0,625
"149";475;129;2154;6;23;36;13;0,1875;0,28125
"150";475;129;2155;6;36;48;12;0,28125;0,375
"151";475;129;2156;6;113;125;12;0,875;0,96875
"152";475;129;2157;6;44;60;16;0,34375;0,46875
"153";475;129;2158;6;84;105;21;0,65625;0,8125
"154";475;129;2159;6;15;27;12;0,125;0,21875
"155";475;129;2160;6;72;92;20;0,5625;0,71875
"156";475;129;2161;6;84;109;25;0,65625;0,84375
"157";475;129;2162;6;101;113;12;0,78125;0,875
"158";475;129;2163;6;101;117;16;0,78125;0,90625
"159";475;129;2164;6;101;121;20;0,78125;0,9375
"160";475;129;2165;6;101;125;24;0,78125;0,96875
"161";475;129;2166;6;113;129;16;0,875;1
"162";475;129;2167;6;40;52;12;0,3125;0,40625
"163";475;129;2168;6;76;88;12;0,59375;0,6875
"164";475;129;2169;6;80;101;21;0,625;0,78125
"165";475;129;2170;6;88;109;21;0,6875;0,84375
"166";475;129;2171;6;92;109;17;0,71875;0,84375
"167";475;129;2172;6;105;129;24;0,8125;1
"168";475;129;2173;6;27;40;13;0,21875;0,3125
"169";475;129;2174;6;32;44;12;0,25;0,34375
"170";475;129;2175;6;72;96;24;0,5625;0,75
"171";475;129;2176;6;68;84;16;0,53125;0,65625
"172";475;129;2177;6;19;32;13;0,15625;0,25
"173";475;129;2178;6;88;113;25;0,6875;0,875
"174";475;129;2179;6;11;27;16;0,09375;0,21875
"175";475;129;2180;6;3;15;12;0,03125;0,125
"176";475;129;2181;6;76;92;16;0,59375;0,71875
"177";475;129;2182;6;80;105;25;0,625;0,8125
"178";475;129;2183;6;92;113;21;0,71875;0,875
"179";475;129;2184;6;92;117;25;0,71875;0,90625
"180";475;129;2185;6;48;64;16;0,375;0,5
"181";475;129;2186;6;101;129;28;0,78125;1
"182";475;129;2187;6;68;88;20;0,53125;0,6875
"183";475;129;2188;6;96;109;13;0,75;0,84375
"184";3927;113;2694;3;48;97;49;0,428571428571429;0,857142857142857
"185";3927;113;2695;3;64;113;49;0,571428571428571;1
"186";3927;113;2696;3;32;80;48;0,285714285714286;0,714285714285714
"187";3927;113;2697;4;40;64;24;0,357142857142857;0,571428571428571
"188";3927;113;2698;4;72;97;25;0,642857142857143;0,857142857142857
"189";3927;113;2699;4;40;72;32;0,357142857142857;0,642857142857143
"190";3927;113;2700;4;48;72;24;0,428571428571429;0,642857142857143
"191";3927;113;2701;4;32;56;24;0,285714285714286;0,5
"192";3927;113;2702;4;32;64;32;0,285714285714286;0,571428571428571
"193";3927;113;2703;4;32;72;40;0,285714285714286;0,642857142857143
"194";3927;113;2704;4;48;80;32;0,428571428571429;0,714285714285714
"195";3927;113;2705;4;64;89;25;0,571428571428571;0,785714285714286
"196";3927;113;2706;4;23;48;25;0,214285714285714;0,428571428571429
"197";3927;113;2707;4;23;56;33;0,214285714285714;0,5
"198";3927;113;2708;5;28;40;12;0,25;0,357142857142857
"199";3927;113;2709;5;44;56;12;0,392857142857143;0,5
"200";3927;113;2710;5;72;84;12;0,642857142857143;0,75
"201";3927;113;2711;5;44;60;16;0,392857142857143;0,535714285714286
"202";3927;113;2712;5;44;64;20;0,392857142857143;0,571428571428571
"203";3927;113;2713;5;52;64;12;0,464285714285714;0,571428571428571
"204";3927;113;2714;5;56;68;12;0,5;0,607142857142857
"205";3927;113;2715;5;76;89;13;0,678571428571429;0,785714285714286
"206";3927;113;2716;5;84;97;13;0,75;0,857142857142857
"207";3927;113;2717;5;40;52;12;0,357142857142857;0,464285714285714
"208";3927;113;2718;5;52;68;16;0,464285714285714;0,607142857142857
"209";3927;113;2719;5;72;89;17;0,642857142857143;0,785714285714286
"210";3927;113;2720;5;72;93;21;0,642857142857143;0,821428571428571
"211";3927;113;2721;5;72;97;25;0,642857142857143;0,857142857142857
"212";3927;113;2722;5;76;93;17;0,678571428571429;0,821428571428571
"213";3927;113;2723;5;76;97;21;0,678571428571429;0,857142857142857
"214";3927;113;2724;5;80;93;13;0,714285714285714;0,821428571428571
"215";3927;113;2725;5;80;97;17;0,714285714285714;0,857142857142857
"216";3927;113;2726;5;89;101;12;0,785714285714286;0,892857142857143
"217";3927;113;2727;5;101;113;12;0,892857142857143;1
"218";3927;113;2728;5;36;48;12;0,321428571428571;0,428571428571429
"219";3927;113;2729;5;23;36;13;0,214285714285714;0,321428571428571
"220";3927;113;2730;5;28;44;16;0,25;0,392857142857143
"221";3927;113;2731;5;32;44;12;0,285714285714286;0,392857142857143
"222";3927;113;2732;5;40;56;16;0,357142857142857;0,5
"223";3927;113;2733;5;44;68;24;0,392857142857143;0,607142857142857
"224";3927;113;2734;5;68;80;12;0,607142857142857;0,714285714285714
"225";3927;113;2735;5;68;84;16;0,607142857142857;0,75
"226";3927;113;2736;5;68;89;21;0,607142857142857;0,785714285714286
"227";3927;113;2737;5;68;93;25;0,607142857142857;0,821428571428571
"228";3927;113;2738;5;68;97;29;0,607142857142857;0,857142857142857
"229";3927;113;2739;5;40;60;20;0,357142857142857;0,535714285714286
"230";3927;113;2740;5;40;64;24;0,357142857142857;0,571428571428571
"231";3927;113;2741;5;40;68;28;0,357142857142857;0,607142857142857
"232";3927;113;2742;5;36;52;16;0,321428571428571;0,464285714285714
"233";3927;113;2743;5;23;40;17;0,214285714285714;0,357142857142857
"234";3927;113;2744;5;60;72;12;0,535714285714286;0,642857142857143
"235";3927;113;2745;5;36;56;20;0,321428571428571;0,5
"236";3927;113;2746;5;36;60;24;0,321428571428571;0,535714285714286
"237";3927;113;2747;6;29;35;6;0,263157894736842;0,315789473684211
"238";3927;113;2748;6;43;49;6;0,385964912280702;0,43859649122807
"239";3927;113;2749;6;61;67;6;0,543859649122807;0,596491228070175
"240";3927;113;2750;6;71;77;6;0,631578947368421;0,684210526315789
"241";3927;113;2751;6;73;79;6;0,649122807017544;0,701754385964912
"242";3927;113;2752;6;73;81;8;0,649122807017544;0,719298245614035
"243";3927;113;2753;6;79;85;6;0,701754385964912;0,754385964912281
"244";3927;113;2754;6;29;37;8;0,263157894736842;0,333333333333333
"245";3927;113;2755;6;29;39;10;0,263157894736842;0,350877192982456
"246";3927;113;2756;6;31;37;6;0,280701754385965;0,333333333333333
"247";3927;113;2757;6;33;39;6;0,298245614035088;0,350877192982456
"248";3927;113;2758;6;35;41;6;0,315789473684211;0,368421052631579
"249";3927;113;2759;6;43;51;8;0,385964912280702;0,456140350877193
"250";3927;113;2760;6;43;53;10;0,385964912280702;0,473684210526316
"251";3927;113;2761;6;43;55;12;0,385964912280702;0,491228070175439
"252";3927;113;2762;6;45;51;6;0,403508771929825;0,456140350877193
"253";3927;113;2763;6;45;53;8;0,403508771929825;0,473684210526316
"254";3927;113;2764;6;53;59;6;0,473684210526316;0,526315789473684
"255";3927;113;2765;6;53;61;8;0,473684210526316;0,543859649122807
"256";3927;113;2766;6;55;61;6;0,491228070175439;0,543859649122807
"257";3927;113;2767;6;55;63;8;0,491228070175439;0,56140350877193
"258";3927;113;2768;6;57;63;6;0,508771929824561;0,56140350877193
"259";3927;113;2769;6;57;65;8;0,508771929824561;0,578947368421053
"260";3927;113;2770;6;57;67;10;0,508771929824561;0,596491228070175
"261";3927;113;2771;6;63;69;6;0,56140350877193;0,614035087719298
"262";3927;113;2772;6;71;79;8;0,631578947368421;0,701754385964912
"263";3927;113;2773;6;71;81;10;0,631578947368421;0,719298245614035
"264";3927;113;2774;6;79;87;8;0,701754385964912;0,771929824561403
"265";3927;113;2775;6;81;87;6;0,719298245614035;0,771929824561403
"266";3927;113;2776;6;81;89;8;0,719298245614035;0,789473684210526
"267";3927;113;2777;6;81;91;10;0,719298245614035;0,807017543859649
"268";3927;113;2778;6;81;93;12;0,719298245614035;0,824561403508772
"269";3927;113;2779;6;83;89;6;0,736842105263158;0,789473684210526
"270";3927;113;2780;6;83;91;8;0,736842105263158;0,807017543859649
"271";3927;113;2781;6;85;91;6;0,754385964912281;0,807017543859649
"272";3927;113;2782;6;85;93;8;0,754385964912281;0,824561403508772
"273";3927;113;2783;6;89;95;6;0,789473684210526;0,842105263157895
"274";3927;113;2784;6;89;97;8;0,789473684210526;0,859649122807018
"275";3927;113;2785;6;91;97;6;0,807017543859649;0,859649122807018
"276";3927;113;2786;6;91;99;8;0,807017543859649;0,87719298245614
"277";3927;113;2787;6;101;107;6;0,894736842105263;0,947368421052632
"278";3927;113;2788;6;29;41;12;0,263157894736842;0,368421052631579
"279";3927;113;2789;6;31;39;8;0,280701754385965;0,350877192982456
"280";3927;113;2790;6;31;41;10;0,280701754385965;0,368421052631579
"281";3927;113;2791;6;33;41;8;0,298245614035088;0,368421052631579
"282";3927;113;2792;6;33;43;10;0,298245614035088;0,385964912280702
"283";3927;113;2793;6;37;43;6;0,333333333333333;0,385964912280702
"284";3927;113;2794;6;39;45;6;0,350877192982456;0,403508771929825
"285";3927;113;2795;6;45;55;10;0,403508771929825;0,491228070175439
"286";3927;113;2796;6;53;63;10;0,473684210526316;0,56140350877193
"287";3927;113;2797;6;53;65;12;0,473684210526316;0,578947368421053
"288";3927;113;2798;6;53;67;14;0,473684210526316;0,596491228070175
"289";3927;113;2799;6;53;69;16;0,473684210526316;0,614035087719298
"290";3927;113;2800;6;55;65;10;0,491228070175439;0,578947368421053
"291";3927;113;2801;6;55;67;12;0,491228070175439;0,596491228070175
"292";3927;113;2802;6;55;69;14;0,491228070175439;0,614035087719298
"293";3927;113;2803;6;61;69;8;0,543859649122807;0,614035087719298
"294";3927;113;2804;6;73;83;10;0,649122807017544;0,736842105263158
"295";3927;113;2805;6;73;85;12;0,649122807017544;0,754385964912281
"296";3927;113;2806;6;73;87;14;0,649122807017544;0,771929824561403
"297";3927;113;2807;6;73;89;16;0,649122807017544;0,789473684210526
"298";3927;113;2808;6;73;91;18;0,649122807017544;0,807017543859649
"299";3927;113;2809;6;73;93;20;0,649122807017544;0,824561403508772
"300";3927;113;2810;6;79;89;10;0,701754385964912;0,789473684210526
"301";3927;113;2811;6;79;91;12;0,701754385964912;0,807017543859649
"302";3927;113;2812;6;85;95;10;0,754385964912281;0,842105263157895
"303";3927;113;2813;6;89;99;10;0,789473684210526;0,87719298245614
"304";3927;113;2814;6;23;29;6;0,210526315789474;0,263157894736842
"305";3927;113;2815;6;35;43;8;0,315789473684211;0,385964912280702
"306";3927;113;2816;6;39;47;8;0,350877192982456;0,421052631578947
"307";3927;113;2817;6;39;49;10;0,350877192982456;0,43859649122807
"308";3927;113;2818;6;41;47;6;0,368421052631579;0,421052631578947
"309";3927;113;2819;6;41;49;8;0,368421052631579;0,43859649122807
"310";3927;113;2820;6;71;83;12;0,631578947368421;0,736842105263158
"311";3927;113;2821;6;83;93;10;0,736842105263158;0,824561403508772
"312";3927;113;2822;6;43;57;14;0,385964912280702;0,508771929824561
"313";3927;113;2823;6;43;59;16;0,385964912280702;0,526315789473684
"314";3927;113;2824;6;59;65;6;0,526315789473684;0,578947368421053
"315";3927;113;2825;6;59;67;8;0,526315789473684;0,596491228070175
"316";3927;113;2826;6;43;61;18;0,385964912280702;0,543859649122807
"317";3927;113;2827;6;71;85;14;0,631578947368421;0,754385964912281
"318";3927;113;2828;6;71;87;16;0,631578947368421;0,771929824561403
"319";3927;113;2829;6;83;95;12;0,736842105263158;0,842105263157895
"320";3927;113;2830;6;83;97;14;0,736842105263158;0,859649122807018
"321";3927;113;2831;6;83;99;16;0,736842105263158;0,87719298245614
"322";3927;113;2832;6;101;109;8;0,894736842105263;0,964912280701754
"323";3927;113;2833;6;21;27;6;0,192982456140351;0,245614035087719
"324";3927;113;2834;6;43;63;20;0,385964912280702;0,56140350877193
"325";3927;113;2835;6;43;65;22;0,385964912280702;0,578947368421053
"326";3927;113;2836;6;45;57;12;0,403508771929825;0,508771929824561
"327";3927;113;2837;6;45;59;14;0,403508771929825;0,526315789473684
"328";3927;113;2838;6;45;61;16;0,403508771929825;0,543859649122807
"329";3927;113;2839;6;45;63;18;0,403508771929825;0,56140350877193
"330";3927;113;2840;6;45;65;20;0,403508771929825;0,578947368421053
"331";3927;113;2841;6;71;89;18;0,631578947368421;0,789473684210526
"332";3927;113;2842;6;71;91;20;0,631578947368421;0,807017543859649
"333";3927;113;2843;6;71;93;22;0,631578947368421;0,824561403508772
"334";3927;113;2844;6;85;97;12;0,754385964912281;0,859649122807018
"335";3927;113;2845;6;85;99;14;0,754385964912281;0,87719298245614
"336";3927;113;2846;6;99;105;6;0,87719298245614;0,929824561403509
"337";3927;113;2847;6;101;111;10;0,894736842105263;0,982456140350877
"338";3927;113;2848;6;101;113;12;0,894736842105263;1
"339";3927;113;2849;6;15;21;6;0,140350877192982;0,192982456140351
"340";3927;113;2850;6;41;51;10;0,368421052631579;0,456140350877193
"341";3927;113;2851;6;99;107;8;0,87719298245614;0,947368421052632
"342";3927;113;2852;6;99;109;10;0,87719298245614;0,964912280701754
"343";3927;113;2853;6;99;111;12;0,87719298245614;0,982456140350877
"344";3927;113;2854;6;25;31;6;0,228070175438596;0,280701754385965
"345";3927;113;2855;6;27;33;6;0,245614035087719;0,298245614035088
"346";3927;113;2856;6;39;51;12;0,350877192982456;0,456140350877193
"347";3927;113;2857;6;43;67;24;0,385964912280702;0,596491228070175
"348";3927;113;2858;6;79;93;14;0,701754385964912;0,824561403508772
"349";3927;113;2859;6;81;95;14;0,719298245614035;0,842105263157895
"350";3927;113;2860;6;71;95;24;0,631578947368421;0,842105263157895
"351";3927;113;2861;6;71;97;26;0,631578947368421;0,859649122807018
"352";3927;113;2862;6;71;99;28;0,631578947368421;0,87719298245614
"353";3927;113;2863;6;1;7;6;0,0175438596491228;0,0701754385964912
"354";3927;113;2864;6;79;95;16;0,701754385964912;0,842105263157895
"355";3927;113;2865;6;79;97;18;0,701754385964912;0,859649122807018
"356";3927;113;2866;6;73;95;22;0,649122807017544;0,842105263157895
"357";3927;113;2867;6;73;97;24;0,649122807017544;0,859649122807018
"358";3927;113;2868;6;73;99;26;0,649122807017544;0,87719298245614
"359";3927;113;2869;6;79;99;20;0,701754385964912;0,87719298245614
"360";3927;113;2870;6;81;97;16;0,719298245614035;0,859649122807018
"361";3927;113;2871;6;81;99;18;0,719298245614035;0,87719298245614
"362";3927;113;2872;6;39;53;14;0,350877192982456;0,473684210526316
"363";3927;113;2873;6;39;55;16;0,350877192982456;0,491228070175439
"364";3927;113;2874;6;27;35;8;0,245614035087719;0,315789473684211
"365";3927;113;2875;6;27;37;10;0,245614035087719;0,333333333333333
"366";3927;113;2876;6;41;53;12;0,368421052631579;0,473684210526316
"367";3927;113;2877;6;29;43;14;0,263157894736842;0,385964912280702
"368";3927;113;2878;6;23;31;8;0,210526315789474;0,280701754385965
"369";3927;113;2879;6;41;55;14;0,368421052631579;0,491228070175439
"370";3927;113;2880;6;41;57;16;0,368421052631579;0,508771929824561
"371";3927;113;2881;6;41;59;18;0,368421052631579;0,526315789473684
"372";3927;113;2882;6;99;113;14;0,87719298245614;1
"373";3085;85;3235;3;33;85;52;0,4;1
"374";3085;85;3236;4;42;68;26;0,5;0,8
"375";3085;85;3237;4;51;76;25;0,6;0,9
"376";3085;85;3238;4;51;85;34;0,6;1
"377";3085;85;3239;4;42;76;34;0,5;0,9
"378";3085;85;3240;4;42;85;43;0,5;1
"379";3085;85;3241;4;59;85;26;0,7;1
"380";3085;85;3242;4;25;51;26;0,3;0,6
"381";3085;85;3243;4;33;59;26;0,4;0,7
"382";3085;85;3244;4;33;68;35;0,4;0,8
"383";3085;85;3245;4;33;76;43;0,4;0,9
"384";3085;85;3246;5;48;60;12;0,571428571428571;0,714285714285714
"385";3085;85;3247;5;52;65;13;0,619047619047619;0,761904761904762
"386";3085;85;3248;5;52;69;17;0,619047619047619;0,80952380952381
"387";3085;85;3249;5;65;77;12;0,761904761904762;0,904761904761905
"388";3085;85;3250;5;69;81;12;0,80952380952381;0,952380952380952
"389";3085;85;3251;5;69;85;16;0,80952380952381;1
"390";3085;85;3252;5;48;65;17;0,571428571428571;0,761904761904762
"391";3085;85;3253;5;48;69;21;0,571428571428571;0,80952380952381
"392";3085;85;3254;5;56;69;13;0,666666666666667;0,80952380952381
"393";3085;85;3255;5;56;73;17;0,666666666666667;0,857142857142857
"394";3085;85;3256;5;56;77;21;0,666666666666667;0,904761904761905
"395";3085;85;3257;5;56;81;25;0,666666666666667;0,952380952380952
"396";3085;85;3258;5;65;81;16;0,761904761904762;0,952380952380952
"397";3085;85;3259;5;32;44;12;0,380952380952381;0,523809523809524
"398";3085;85;3260;5;32;48;16;0,380952380952381;0,571428571428571
"399";3085;85;3261;5;36;48;12;0,428571428571429;0,571428571428571
"400";3085;85;3262;5;36;52;16;0,428571428571429;0,619047619047619
"401";3085;85;3263;5;48;73;25;0,571428571428571;0,857142857142857
"402";3085;85;3264;5;52;73;21;0,619047619047619;0,857142857142857
"403";3085;85;3265;5;52;77;25;0,619047619047619;0,904761904761905
"404";3085;85;3266;5;52;81;29;0,619047619047619;0,952380952380952
"405";3085;85;3267;5;52;85;33;0,619047619047619;1
"406";3085;85;3268;5;65;85;20;0,761904761904762;1
"407";3085;85;3269;5;28;40;12;0,333333333333333;0,476190476190476
"408";3085;85;3270;5;40;52;12;0,476190476190476;0,619047619047619
"409";3085;85;3271;5;60;73;13;0,714285714285714;0,857142857142857
"410";3085;85;3272;5;44;56;12;0,523809523809524;0,666666666666667
"411";3085;85;3273;5;48;77;29;0,571428571428571;0,904761904761905
"412";3085;85;3274;5;48;81;33;0,571428571428571;0,952380952380952
"413";3085;85;3275;5;48;85;37;0,571428571428571;1
"414";3085;85;3276;5;56;85;29;0,666666666666667;1
"415";3085;85;3277;5;60;77;17;0,714285714285714;0,904761904761905
"416";3085;85;3278;5;60;81;21;0,714285714285714;0,952380952380952
"417";3085;85;3279;5;60;85;25;0,714285714285714;1
"418";3085;85;3280;5;24;36;12;0,285714285714286;0,428571428571429
"419";3085;85;3281;5;40;56;16;0,476190476190476;0,666666666666667
"420";3085;85;3282;5;40;60;20;0,476190476190476;0,714285714285714
"421";3085;85;3283;5;28;44;16;0,333333333333333;0,523809523809524
"422";3085;85;3284;5;32;52;20;0,380952380952381;0,619047619047619
"423";3085;85;3285;5;36;56;20;0,428571428571429;0,666666666666667
"424";3085;85;3286;5;36;60;24;0,428571428571429;0,714285714285714
"425";3085;85;3287;5;28;48;20;0,333333333333333;0,571428571428571
"426";3085;85;3288;5;44;60;16;0,523809523809524;0,714285714285714
"427";3085;85;3289;5;44;65;21;0,523809523809524;0,761904761904762
"428";3085;85;3290;5;24;40;16;0,285714285714286;0,476190476190476
"429";3085;85;3291;5;44;69;25;0,523809523809524;0,80952380952381
"430";3085;85;3292;5;44;73;29;0,523809523809524;0,857142857142857
"431";3085;85;3293;6;33;39;6;0,395348837209302;0,465116279069767
"432";3085;85;3294;6;33;41;8;0,395348837209302;0,488372093023256
"433";3085;85;3295;6;33;43;10;0,395348837209302;0,511627906976744
"434";3085;85;3296;6;35;41;6;0,418604651162791;0,488372093023256
"435";3085;85;3297;6;35;43;8;0,418604651162791;0,511627906976744
"436";3085;85;3298;6;39;45;6;0,465116279069767;0,534883720930233
"437";3085;85;3299;6;53;59;6;0,627906976744186;0,697674418604651
"438";3085;85;3300;6;53;61;8;0,627906976744186;0,720930232558139
"439";3085;85;3301;6;67;73;6;0,790697674418605;0,86046511627907
"440";3085;85;3302;6;67;75;8;0,790697674418605;0,883720930232558
"441";3085;85;3303;6;69;75;6;0,813953488372093;0,883720930232558
"442";3085;85;3304;6;69;77;8;0,813953488372093;0,906976744186046
"443";3085;85;3305;6;27;33;6;0,325581395348837;0,395348837209302
"444";3085;85;3306;6;27;35;8;0,325581395348837;0,418604651162791
"445";3085;85;3307;6;29;35;6;0,348837209302326;0,418604651162791
"446";3085;85;3308;6;29;37;8;0,348837209302326;0,441860465116279
"447";3085;85;3309;6;33;45;12;0,395348837209302;0,534883720930233
"448";3085;85;3310;6;35;45;10;0,418604651162791;0,534883720930233
"449";3085;85;3311;6;35;47;12;0,418604651162791;0,558139534883721
"450";3085;85;3312;6;43;49;6;0,511627906976744;0,581395348837209
"451";3085;85;3313;6;45;51;6;0,534883720930233;0,604651162790698
"452";3085;85;3314;6;53;63;10;0,627906976744186;0,744186046511628
"453";3085;85;3315;6;53;65;12;0,627906976744186;0,767441860465116
"454";3085;85;3316;6;53;67;14;0,627906976744186;0,790697674418605
"455";3085;85;3317;6;53;69;16;0,627906976744186;0,813953488372093
"456";3085;85;3318;6;59;65;6;0,697674418604651;0,767441860465116
"457";3085;85;3319;6;67;77;10;0,790697674418605;0,906976744186046
"458";3085;85;3320;6;67;79;12;0,790697674418605;0,930232558139535
"459";3085;85;3321;6;67;81;14;0,790697674418605;0,953488372093023
"460";3085;85;3322;6;67;83;16;0,790697674418605;0,976744186046512
"461";3085;85;3323;6;69;79;10;0,813953488372093;0,930232558139535
"462";3085;85;3324;6;69;81;12;0,813953488372093;0,953488372093023
"463";3085;85;3325;6;69;83;14;0,813953488372093;0,976744186046512
"464";3085;85;3326;6;69;85;16;0,813953488372093;1
"465";3085;85;3327;6;7;13;6;0,0930232558139535;0,162790697674419
"466";3085;85;3328;6;37;43;6;0,441860465116279;0,511627906976744
"467";3085;85;3329;6;53;71;18;0,627906976744186;0,837209302325581
"468";3085;85;3330;6;51;57;6;0,604651162790698;0,674418604651163
"469";3085;85;3331;6;47;53;6;0,558139534883721;0,627906976744186
"470";3085;85;3332;6;37;45;8;0,441860465116279;0,534883720930233
"471";3085;85;3333;6;39;47;8;0,465116279069767;0,558139534883721
"472";3085;85;3334;6;41;47;6;0,488372093023256;0,558139534883721
"473";3085;85;3335;6;41;49;8;0,488372093023256;0,581395348837209
"474";3085;85;3336;6;51;59;8;0,604651162790698;0,697674418604651
"475";3085;85;3337;6;51;61;10;0,604651162790698;0,720930232558139
"476";3085;85;3338;6;51;63;12;0,604651162790698;0,744186046511628
"477";3085;85;3339;6;65;71;6;0,767441860465116;0,837209302325581
"478";3085;85;3340;6;65;73;8;0,767441860465116;0,86046511627907
"479";3085;85;3341;6;43;51;8;0,511627906976744;0,604651162790698
"480";3085;85;3342;6;47;55;8;0,558139534883721;0,651162790697674
"481";3085;85;3343;6;59;67;8;0,697674418604651;0,790697674418605
"482";3085;85;3344;6;59;69;10;0,697674418604651;0,813953488372093
"483";3085;85;3345;6;59;71;12;0,697674418604651;0,837209302325581
"484";3085;85;3346;6;59;73;14;0,697674418604651;0,86046511627907
"485";3085;85;3347;6;59;75;16;0,697674418604651;0,883720930232558
"486";3085;85;3348;6;65;75;10;0,767441860465116;0,883720930232558
"487";3085;85;3349;6;65;77;12;0,767441860465116;0,906976744186046
"488";3085;85;3350;6;67;85;18;0,790697674418605;1
"489";3085;85;3351;6;5;11;6;0,0697674418604651;0,13953488372093
"490";3085;85;3352;6;49;55;6;0,581395348837209;0,651162790697674
"491";3085;85;3353;6;9;15;6;0,116279069767442;0,186046511627907
"492";3085;85;3354;6;35;49;14;0,418604651162791;0,581395348837209
"493";3085;85;3355;6;37;47;10;0,441860465116279;0,558139534883721
"494";3085;85;3356;6;51;65;14;0,604651162790698;0,767441860465116
"495";3085;85;3357;6;51;67;16;0,604651162790698;0,790697674418605
"496";3085;85;3358;6;47;57;10;0,558139534883721;0,674418604651163
"497";3085;85;3359;6;47;59;12;0,558139534883721;0,697674418604651
"498";3085;85;3360;6;25;31;6;0,302325581395349;0,372093023255814
"499";3085;85;3361;6;31;37;6;0,372093023255814;0,441860465116279
"500";3085;85;3362;6;45;53;8;0,534883720930233;0,627906976744186
"501";3085;85;3363;6;49;57;8;0,581395348837209;0,674418604651163
"502";3085;85;3364;6;49;59;10;0,581395348837209;0,697674418604651
"503";3085;85;3365;6;23;29;6;0,27906976744186;0,348837209302326
"504";3085;85;3366;6;39;49;10;0,465116279069767;0,581395348837209
"505";3085;85;3367;6;41;51;10;0,488372093023256;0,604651162790698
"506";3085;85;3368;6;43;53;10;0,511627906976744;0,627906976744186
"507";3085;85;3369;6;53;73;20;0,627906976744186;0,86046511627907
"508";3085;85;3370;6;53;75;22;0,627906976744186;0,883720930232558
"509";3085;85;3371;6;53;77;24;0,627906976744186;0,906976744186046
"510";3085;85;3372;6;53;79;26;0,627906976744186;0,930232558139535
"511";3085;85;3373;6;39;51;12;0,465116279069767;0,604651162790698
"512";3085;85;3374;6;31;39;8;0,372093023255814;0,465116279069767
"513";3085;85;3375;6;33;47;14;0,395348837209302;0,558139534883721
"514";3085;85;3376;6;33;49;16;0,395348837209302;0,581395348837209
"515";3085;85;3377;6;35;51;16;0,418604651162791;0,604651162790698
"516";3085;85;3378;6;37;49;12;0,441860465116279;0,581395348837209
"517";3085;85;3379;6;59;77;18;0,697674418604651;0,906976744186046
"518";3085;85;3380;6;53;81;28;0,627906976744186;0,953488372093023
"519";3085;85;3381;6;65;79;14;0,767441860465116;0,930232558139535
"520";3085;85;3382;6;65;81;16;0,767441860465116;0,953488372093023
"521";3085;85;3383;6;59;79;20;0,697674418604651;0,930232558139535
"522";3085;85;3384;6;59;81;22;0,697674418604651;0,953488372093023
"523";3085;85;3385;6;59;83;24;0,697674418604651;0,976744186046512
"524";3085;85;3386;6;45;55;10;0,534883720930233;0,651162790697674
"525";3085;85;3387;6;49;61;12;0,581395348837209;0,720930232558139
"526";3085;85;3388;6;49;63;14;0,581395348837209;0,744186046511628
"527";3085;85;3389;6;31;41;10;0,372093023255814;0,488372093023256
"528";3085;85;3390;6;65;83;18;0,767441860465116;0,976744186046512
"529";3085;85;3391;6;21;27;6;0,255813953488372;0,325581395348837
"530";3085;85;3392;6;29;39;10;0,348837209302326;0,465116279069767
"531";3085;85;3393;6;47;61;14;0,558139534883721;0,720930232558139
"532";3085;85;3394;6;47;63;16;0,558139534883721;0,744186046511628
"533";3085;85;3395;6;51;69;18;0,604651162790698;0,813953488372093
"534";3085;85;3396;6;51;71;20;0,604651162790698;0,837209302325581
"535";3085;85;3397;6;51;73;22;0,604651162790698;0,86046511627907
"536";3085;85;3398;6;51;75;24;0,604651162790698;0,883720930232558
"537";3085;85;3399;6;65;85;20;0,767441860465116;1
"538";3085;85;3400;6;45;57;12;0,534883720930233;0,674418604651163
"539";3085;85;3401;6;51;77;26;0,604651162790698;0,906976744186046
"540";3085;85;3402;6;53;83;30;0,627906976744186;0,976744186046512
"541";3085;85;3403;6;25;33;8;0,302325581395349;0,395348837209302
"542";3085;85;3404;6;53;85;32;0,627906976744186;1
"543";3085;85;3405;6;19;25;6;0,232558139534884;0,302325581395349
"544";3584;140;3851;3;34;140;106;0,25;1
"545";3584;140;3852;4;34;87;53;0,25;0,625
"546";3584;140;3853;4;70;122;52;0,5;0,875
"547";3584;140;3854;4;87;140;53;0,625;1
"548";3584;140;3855;4;70;140;70;0,5;1
"549";3584;140;3856;4;52;105;53;0,375;0,75
"550";3584;140;3857;4;17;70;53;0,125;0,5
"551";3584;140;3858;5;24;49;25;0,176470588235294;0,352941176470588
"552";3584;140;3859;5;57;82;25;0,411764705882353;0,588235294117647
"553";3584;140;3860;5;32;57;25;0,235294117647059;0,411764705882353
"554";3584;140;3861;5;65;90;25;0,470588235294118;0,647058823529412
"555";3584;140;3862;5;74;99;25;0,529411764705882;0,705882352941177
"556";3584;140;3863;5;82;107;25;0,588235294117647;0,764705882352941
"557";3584;140;3864;5;107;132;25;0,764705882352941;0,941176470588235
"558";3584;140;3865;5;107;140;33;0,764705882352941;1
"559";3584;140;3866;5;49;74;25;0,352941176470588;0,529411764705882
"560";3584;140;3867;5;82;115;33;0,588235294117647;0,823529411764706
"561";3584;140;3868;5;99;123;24;0,705882352941177;0,882352941176471
"562";3584;140;3869;5;115;140;25;0,823529411764706;1
"563";3584;140;3870;5;90;115;25;0,647058823529412;0,823529411764706
"564";3584;140;3871;5;90;123;33;0,647058823529412;0,882352941176471
"565";3584;140;3872;5;99;132;33;0,705882352941177;0,941176470588235
"566";3584;140;3873;5;99;140;41;0,705882352941177;1
"567";3584;140;3874;5;49;82;33;0,352941176470588;0,588235294117647
"568";3584;140;3875;5;65;99;34;0,470588235294118;0,705882352941177
"569";3584;140;3876;5;40;65;25;0,294117647058824;0,470588235294118
"570";3584;140;3877;5;90;132;42;0,647058823529412;0,941176470588235
"571";3584;140;3878;5;16;40;24;0,117647058823529;0,294117647058824
"572";3584;140;3879;5;74;107;33;0,529411764705882;0,764705882352941
"573";3584;140;3880;6;39;51;12;0,285714285714286;0,371428571428571
"574";3584;140;3881;6;23;35;12;0,171428571428571;0,257142857142857
"575";3584;140;3882;6;35;47;12;0,257142857142857;0,342857142857143
"576";3584;140;3883;6;51;63;12;0,371428571428571;0,457142857142857
"577";3584;140;3884;6;67;80;13;0,485714285714286;0,571428571428571
"578";3584;140;3885;6;72;84;12;0,514285714285714;0,6
"579";3584;140;3886;6;76;88;12;0,542857142857143;0,628571428571429
"580";3584;140;3887;6;116;128;12;0,828571428571429;0,914285714285714
"581";3584;140;3888;6;116;132;16;0,828571428571429;0,942857142857143
"582";3584;140;3889;6;55;67;12;0,4;0,485714285714286
"583";3584;140;3890;6;63;76;13;0,457142857142857;0,542857142857143
"584";3584;140;3891;6;84;96;12;0,6;0,685714285714286
"585";3584;140;3892;6;100;112;12;0,714285714285714;0,8
"586";3584;140;3893;6;100;116;16;0,714285714285714;0,828571428571429
"587";3584;140;3894;6;104;116;12;0,742857142857143;0,828571428571429
"588";3584;140;3895;6;104;120;16;0,742857142857143;0,857142857142857
"589";3584;140;3896;6;120;132;12;0,857142857142857;0,942857142857143
"590";3584;140;3897;6;120;136;16;0,857142857142857;0,971428571428571
"591";3584;140;3898;6;80;92;12;0,571428571428571;0,657142857142857
"592";3584;140;3899;6;15;27;12;0,114285714285714;0,2
"593";3584;140;3900;6;84;100;16;0,6;0,714285714285714
"594";3584;140;3901;6;88;100;12;0,628571428571429;0,714285714285714
"595";3584;140;3902;6;120;140;20;0,857142857142857;1
"596";3584;140;3903;6;124;136;12;0,885714285714286;0,971428571428571
"597";3584;140;3904;6;124;140;16;0,885714285714286;1
"598";3584;140;3905;6;47;59;12;0,342857142857143;0,428571428571429
"599";3584;140;3906;6;43;55;12;0,314285714285714;0,4
"600";3584;140;3907;6;108;120;12;0,771428571428571;0,857142857142857
"601";3584;140;3908;6;72;88;16;0,514285714285714;0,628571428571429
"602";3584;140;3909;6;27;39;12;0,2;0,285714285714286
"603";3584;140;3910;6;92;104;12;0,657142857142857;0,742857142857143
"604";3584;140;3911;6;19;31;12;0,142857142857143;0,228571428571429
"605";3584;140;3912;6;88;104;16;0,628571428571429;0,742857142857143
"606";3584;140;3913;6;100;120;20;0,714285714285714;0,857142857142857
"607";3584;140;3914;6;108;124;16;0,771428571428571;0,885714285714286
"608";3584;140;3915;6;116;136;20;0,828571428571429;0,971428571428571
"609";3584;140;3916;6;116;140;24;0,828571428571429;1
"610";3584;140;3917;6;67;84;17;0,485714285714286;0,6
"611";3584;140;3918;6;59;72;13;0,428571428571429;0,514285714285714
"612";3584;140;3919;6;59;76;17;0,428571428571429;0,542857142857143
"613";3584;140;3920;6;96;108;12;0,685714285714286;0,771428571428571
"614";3584;140;3921;6;96;112;16;0,685714285714286;0,8
"615";3584;140;3922;6;63;80;17;0,457142857142857;0,571428571428571
"616";3584;140;3923;6;104;124;20;0,742857142857143;0,885714285714286
"617";3584;140;3924;6;104;128;24;0,742857142857143;0,914285714285714
"618";3584;140;3925;6;104;132;28;0,742857142857143;0,942857142857143
"619";3584;140;3926;6;104;136;32;0,742857142857143;0,971428571428571
"620";3584;140;3927;6;104;140;36;0,742857142857143;1
"621";3584;140;3928;6;112;124;12;0,8;0,885714285714286
"622";3584;140;3929;6;35;51;16;0,257142857142857;0,371428571428571
"623";3584;140;3930;6;112;128;16;0,8;0,914285714285714
"624";3584;140;3931;6;96;116;20;0,685714285714286;0,828571428571429
"625";3584;140;3932;6;84;104;20;0,6;0,742857142857143
"626";3584;140;3933;6;31;43;12;0,228571428571429;0,314285714285714
"627";3584;140;3934;6;80;96;16;0,571428571428571;0,685714285714286
"628";3584;140;3935;6;43;59;16;0,314285714285714;0,428571428571429
"629";3584;140;3936;6;108;128;20;0,771428571428571;0,914285714285714
"630";3584;140;3937;6;108;132;24;0,771428571428571;0,942857142857143
"631";3584;140;3938;6;76;92;16;0,542857142857143;0,657142857142857
"632";3584;140;3939;6;92;108;16;0,657142857142857;0,771428571428571
"633";3584;140;3940;6;76;96;20;0,542857142857143;0,685714285714286
"634";3584;140;3941;6;112;132;20;0,8;0,942857142857143
"635";3584;140;3942;6;27;43;16;0,2;0,314285714285714
"636";4007;132;4135;4;66;115;49;0,5;0,875
"637";4007;132;4136;4;82;132;50;0,625;1
"638";4007;132;4137;4;49;99;50;0,375;0,75
"639";4007;132;4138;5;74;99;25;0,5625;0,75
"640";4007;132;4139;5;82;107;25;0,625;0,8125
"641";4007;132;4140;5;107;132;25;0,8125;1
"642";4007;132;4141;5;90;115;25;0,6875;0,875
"643";4007;132;4142;5;99;124;25;0,75;0,9375
"644";4007;132;4143;5;99;132;33;0,75;1
"645";4007;132;4144;5;66;90;24;0,5;0,6875
"646";4007;132;4145;5;82;115;33;0,625;0,875
"647";4007;132;4146;5;90;124;34;0,6875;0,9375
"648";4007;132;4147;6;39;51;12;0,303030303030303;0,393939393939394
"649";4007;132;4148;6;84;96;12;0,636363636363636;0,727272727272727
"650";4007;132;4149;6;88;100;12;0,666666666666667;0,757575757575758
"651";4007;132;4150;6;92;104;12;0,696969696969697;0,787878787878788
"652";4007;132;4151;6;112;124;12;0,848484848484849;0,939393939393939
"653";4007;132;4152;6;112;128;16;0,848484848484849;0,96969696969697
"654";4007;132;4153;6;116;128;12;0,878787878787879;0,96969696969697
"655";4007;132;4154;6;51;63;12;0,393939393939394;0,484848484848485
"656";4007;132;4155;6;63;76;13;0,484848484848485;0,575757575757576
"657";4007;132;4156;6;88;104;16;0,666666666666667;0,787878787878788
"658";4007;132;4157;6;88;108;20;0,666666666666667;0,818181818181818
"659";4007;132;4158;6;92;108;16;0,696969696969697;0,818181818181818
"660";4007;132;4159;6;96;108;12;0,727272727272727;0,818181818181818
"661";4007;132;4160;6;100;112;12;0,757575757575758;0,848484848484849
"662";4007;132;4161;6;112;132;20;0,848484848484849;1
"663";4007;132;4162;6;116;132;16;0,878787878787879;1
"664";4007;132;4163;6;120;132;12;0,909090909090909;1
"665";4007;132;4164;6;23;35;12;0,181818181818182;0,272727272727273
"666";4007;132;4165;6;76;88;12;0,575757575757576;0,666666666666667
"667";4007;132;4166;6;80;92;12;0,606060606060606;0,696969696969697
"668";4007;132;4167;6;80;96;16;0,606060606060606;0,727272727272727
"669";4007;132;4168;6;84;100;16;0,636363636363636;0,757575757575758
"670";4007;132;4169;6;96;112;16;0,727272727272727;0,848484848484849
"671";4007;132;4170;6;100;116;16;0,757575757575758;0,878787878787879
"672";4007;132;4171;6;108;120;12;0,818181818181818;0,909090909090909
"673";4007;132;4172;6;92;112;20;0,696969696969697;0,848484848484849
"674";4007;132;4173;6;108;124;16;0,818181818181818;0,939393939393939
"675";4007;132;4174;6;108;128;20;0,818181818181818;0,96969696969697
"676";4007;132;4175;6;84;104;20;0,636363636363636;0,787878787878788
"677";4007;132;4176;6;19;31;12;0,151515151515152;0,242424242424242
"678";4007;132;4177;6;68;80;12;0,515151515151515;0,606060606060606
"679";4007;132;4178;6;72;84;12;0,545454545454545;0,636363636363636
"680";4007;132;4179;6;104;116;12;0,787878787878788;0,878787878787879
"681";4007;132;4180;6;15;27;12;0,121212121212121;0,212121212121212
"682";4007;132;4181;6;88;112;24;0,666666666666667;0,848484848484849
"683";4007;132;4182;6;11;23;12;0,0909090909090909;0,181818181818182
"684";4007;132;4183;6;72;88;16;0,545454545454545;0,666666666666667
"685";4007;132;4184;6;108;132;24;0,818181818181818;1
"686";4007;132;4185;6;35;47;12;0,272727272727273;0,363636363636364
"687";4007;132;4186;6;84;108;24;0,636363636363636;0,818181818181818
"688";4445;110;4973;4;84;110;26;0,769230769230769;1
"689";4445;110;4974;4;76;101;25;0,692307692307692;0,923076923076923
"690";4445;110;4975;4;76;110;34;0,692307692307692;1
"691";4445;110;4976;4;67;93;26;0,615384615384615;0,846153846153846
"692";4445;110;4977;5;85;98;13;0,777777777777778;0,888888888888889
"693";4445;110;4978;5;89;102;13;0,814814814814815;0,925925925925926
"694";4445;110;4979;5;85;102;17;0,777777777777778;0,925925925925926
"695";4445;110;4980;5;85;106;21;0,777777777777778;0,962962962962963
"696";4445;110;4981;5;85;110;25;0,777777777777778;1
"697";4445;110;4982;5;89;106;17;0,814814814814815;0,962962962962963
"698";4445;110;4983;5;89;110;21;0,814814814814815;1
"699";4445;110;4984;5;81;94;13;0,740740740740741;0,851851851851852
"700";4445;110;4985;5;81;98;17;0,740740740740741;0,888888888888889
"701";4445;110;4986;5;81;102;21;0,740740740740741;0,925925925925926
"702";4445;110;4987;5;81;106;25;0,740740740740741;0,962962962962963
"703";4445;110;4988;5;81;110;29;0,740740740740741;1
"704";4445;110;4989;5;77;89;12;0,703703703703704;0,814814814814815
"705";4445;110;4990;5;69;81;12;0,62962962962963;0,740740740740741
"706";4445;110;4991;5;48;61;13;0,444444444444444;0,555555555555556
"707";4445;110;4992;5;73;85;12;0,666666666666667;0,777777777777778
"708";4445;110;4993;5;32;44;12;0,296296296296296;0,407407407407407
"709";4445;110;4994;5;77;94;17;0,703703703703704;0,851851851851852
"710";4445;110;4995;5;52;65;13;0,481481481481481;0,592592592592593
"711";4445;110;4996;5;15;28;13;0,148148148148148;0,259259259259259
"712";4445;110;4997;6;84;90;6;0,763636363636364;0,818181818181818
"713";4445;110;4998;6;88;94;6;0,8;0,854545454545454
"714";4445;110;4999;6;84;92;8;0,763636363636364;0,836363636363636
"715";4445;110;5000;6;84;94;10;0,763636363636364;0,854545454545454
"716";4445;110;5001;6;84;96;12;0,763636363636364;0,872727272727273
"717";4445;110;5002;6;86;92;6;0,781818181818182;0,836363636363636
"718";4445;110;5003;6;86;94;8;0,781818181818182;0,854545454545454
"719";4445;110;5004;6;86;96;10;0,781818181818182;0,872727272727273
"720";4445;110;5005;6;88;96;8;0,8;0,872727272727273
"721";4445;110;5006;6;88;98;10;0,8;0,890909090909091
"722";4445;110;5007;6;88;100;12;0,8;0,909090909090909
"723";4445;110;5008;6;39;45;6;0,363636363636364;0,418181818181818
"724";4445;110;5009;6;68;74;6;0,618181818181818;0,672727272727273
"725";4445;110;5010;6;84;98;14;0,763636363636364;0,890909090909091
"726";4445;110;5011;6;84;100;16;0,763636363636364;0,909090909090909
"727";4445;110;5012;6;84;102;18;0,763636363636364;0,927272727272727
"728";4445;110;5013;6;84;104;20;0,763636363636364;0,945454545454545
"729";4445;110;5014;6;84;106;22;0,763636363636364;0,963636363636364
"730";4445;110;5015;6;86;98;12;0,781818181818182;0,890909090909091
"731";4445;110;5016;6;86;100;14;0,781818181818182;0,909090909090909
"732";4445;110;5017;6;86;102;16;0,781818181818182;0,927272727272727
"733";4445;110;5018;6;86;104;18;0,781818181818182;0,945454545454545
"734";4445;110;5019;6;86;106;20;0,781818181818182;0,963636363636364
"735";4445;110;5020;6;86;108;22;0,781818181818182;0,981818181818182
"736";4445;110;5021;6;76;82;6;0,690909090909091;0,745454545454545
"737";4445;110;5022;6;56;62;6;0,509090909090909;0,563636363636364
"738";4445;110;5023;6;88;102;14;0,8;0,927272727272727
"739";4445;110;5024;6;88;104;16;0,8;0,945454545454545
"740";4445;110;5025;6;84;108;24;0,763636363636364;0,981818181818182
"741";4445;110;5026;6;84;110;26;0,763636363636364;1
"742";4445;110;5027;6;88;106;18;0,8;0,963636363636364
"743";4445;110;5028;6;88;108;20;0,8;0,981818181818182
"744";4445;110;5029;6;88;110;22;0,8;1
"745";4445;110;5030;6;41;47;6;0,381818181818182;0,436363636363636
"746";4445;110;5031;6;7;13;6;0,0727272727272727;0,127272727272727
"747";4445;110;5032;6;78;84;6;0,709090909090909;0,763636363636364
"748";4445;110;5033;6;19;25;6;0,181818181818182;0,236363636363636
"749";4445;110;5034;6;66;72;6;0,6;0,654545454545455
"750";4445;110;5035;6;35;41;6;0,327272727272727;0,381818181818182
"751";4445;110;5036;6;49;56;7;0,454545454545455;0,509090909090909
"752";4445;110;5037;6;33;39;6;0,309090909090909;0,363636363636364
"753";4445;110;5038;6;23;29;6;0,218181818181818;0,272727272727273
"754";4445;110;5039;6;21;27;6;0,2;0,254545454545455
"755";4445;110;5040;6;47;53;6;0,436363636363636;0,490909090909091
"756";4445;110;5041;6;86;110;24;0,781818181818182;1
"757";4445;110;5042;6;31;37;6;0,290909090909091;0,345454545454545
"758";4445;110;5043;6;37;43;6;0,345454545454545;0,4
"759";4445;110;5044;6;70;76;6;0,636363636363636;0,690909090909091
"760";4445;110;5045;6;39;47;8;0,363636363636364;0,436363636363636
"761";4445;110;5046;6;60;66;6;0,545454545454545;0,6
"762";4445;110;5047;6;37;45;8;0,345454545454545;0,418181818181818
"763";4445;110;5048;6;17;23;6;0,163636363636364;0,218181818181818
"764";4445;110;5049;6;35;43;8;0,327272727272727;0,4
"765";4445;110;5050;6;66;74;8;0,6;0,672727272727273
"766";4445;110;5051;6;5;11;6;0,0545454545454545;0,109090909090909
"767";4614;77;5151;3;18;77;59;0,25;1
"768";4614;77;5152;4;42;68;26;0,555555555555556;0,888888888888889
"769";4614;77;5153;4;42;77;35;0,555555555555556;1
"770";4614;77;5154;4;51;77;26;0,666666666666667;1
"771";4614;77;5155;4;34;60;26;0,444444444444444;0,777777777777778
"772";4614;77;5156;4;34;68;34;0,444444444444444;0,888888888888889
"773";4614;77;5157;4;34;77;43;0,444444444444444;1
"774";4614;77;5158;5;44;56;12;0,578947368421053;0,736842105263158
"775";4614;77;5159;5;44;61;17;0,578947368421053;0,789473684210526
"776";4614;77;5160;5;52;65;13;0,684210526315789;0,842105263157895
"777";4614;77;5161;5;44;65;21;0,578947368421053;0,842105263157895
"778";4614;77;5162;5;44;69;25;0,578947368421053;0,894736842105263
"779";4614;77;5163;5;44;73;29;0,578947368421053;0,947368421052632
"780";4614;77;5164;5;44;77;33;0,578947368421053;1
"781";4614;77;5165;5;52;69;17;0,684210526315789;0,894736842105263
"782";4614;77;5166;5;52;73;21;0,684210526315789;0,947368421052632
"783";4614;77;5167;5;52;77;25;0,684210526315789;1
"784";4614;77;5168;5;32;44;12;0,421052631578947;0,578947368421053
"785";4614;77;5169;6;35;41;6;0,461538461538462;0,538461538461538
"786";4614;77;5170;6;35;43;8;0,461538461538462;0,564102564102564
"787";4614;77;5171;6;45;51;6;0,58974358974359;0,666666666666667
"788";4614;77;5172;6;45;53;8;0,58974358974359;0,692307692307692
"789";4614;77;5173;6;53;59;6;0,692307692307692;0,769230769230769
"790";4614;77;5174;6;45;55;10;0,58974358974359;0,717948717948718
"791";4614;77;5175;6;45;57;12;0,58974358974359;0,743589743589744
"792";4614;77;5176;6;45;59;14;0,58974358974359;0,769230769230769
"793";4614;77;5177;6;45;61;16;0,58974358974359;0,794871794871795
"794";4614;77;5178;6;53;61;8;0,692307692307692;0,794871794871795
"795";4614;77;5179;6;53;63;10;0,692307692307692;0,82051282051282
"796";4614;77;5180;6;53;65;12;0,692307692307692;0,846153846153846
"797";4614;77;5181;6;45;63;18;0,58974358974359;0,82051282051282
"798";4614;77;5182;6;45;65;20;0,58974358974359;0,846153846153846
"799";4614;77;5183;6;53;67;14;0,692307692307692;0,871794871794872
"800";4614;77;5184;6;53;69;16;0,692307692307692;0,897435897435897
"801";4614;77;5185;6;45;67;22;0,58974358974359;0,871794871794872
"802";4614;77;5186;6;45;69;24;0,58974358974359;0,897435897435897
"803";4614;77;5187;6;45;71;26;0,58974358974359;0,923076923076923
"804";4614;77;5188;6;45;73;28;0,58974358974359;0,948717948717949
"805";4614;77;5189;6;45;75;30;0,58974358974359;0,974358974358974
"806";4614;77;5190;6;45;77;32;0,58974358974359;1
"807";4614;77;5191;6;53;71;18;0,692307692307692;0,923076923076923
"808";4614;77;5192;6;53;73;20;0,692307692307692;0,948717948717949
"809";4614;77;5193;6;53;75;22;0,692307692307692;0,974358974358974
"810";4614;77;5194;6;53;77;24;0,692307692307692;1
"811";4614;77;5195;6;35;45;10;0,461538461538462;0,58974358974359
"812";4867;97;5344;3;48;97;49;0,5;1
"813";4867;97;5345;3;32;81;49;0,333333333333333;0,833333333333333
"814";4867;97;5346;4;32;56;24;0,333333333333333;0,583333333333333
"815";4867;97;5347;4;56;81;25;0,583333333333333;0,833333333333333
"816";4867;97;5348;4;56;89;33;0,583333333333333;0,916666666666667
"817";4867;97;5349;4;56;97;41;0,583333333333333;1
"818";4867;97;5350;4;72;97;25;0,75;1
"819";4867;97;5351;4;48;72;24;0,5;0,75
"820";4867;97;5352;4;48;81;33;0,5;0,833333333333333
"821";4867;97;5353;4;48;89;41;0,5;0,916666666666667
"822";4867;97;5354;4;48;97;49;0,5;1
"823";4867;97;5355;4;64;89;25;0,666666666666667;0,916666666666667
"824";4867;97;5356;4;64;97;33;0,666666666666667;1
"825";4867;97;5357;4;40;64;24;0,416666666666667;0,666666666666667
"826";4867;97;5358;4;7;32;25;0,0833333333333333;0,333333333333333
"827";4867;97;5359;4;40;72;32;0,416666666666667;0,75
"828";4867;97;5360;4;40;81;41;0,416666666666667;0,833333333333333
"829";4867;97;5361;5;36;48;12;0,375;0,5
"830";4867;97;5362;5;7;19;12;0,0833333333333333;0,208333333333333
"831";4867;97;5363;5;56;68;12;0,583333333333333;0,708333333333333
"832";4867;97;5364;5;56;72;16;0,583333333333333;0,75
"833";4867;97;5365;5;56;77;21;0,583333333333333;0,791666666666667
"834";4867;97;5366;5;64;77;13;0,666666666666667;0,791666666666667
"835";4867;97;5367;5;72;85;13;0,75;0,875
"836";4867;97;5368;5;77;89;12;0,791666666666667;0,916666666666667
"837";4867;97;5369;5;40;52;12;0,416666666666667;0,541666666666667
"838";4867;97;5370;5;64;81;17;0,666666666666667;0,833333333333333
"839";4867;97;5371;5;64;85;21;0,666666666666667;0,875
"840";4867;97;5372;5;64;89;25;0,666666666666667;0,916666666666667
"841";4867;97;5373;5;72;89;17;0,75;0,916666666666667
"842";4867;97;5374;5;72;93;21;0,75;0,958333333333333
"843";4867;97;5375;5;56;81;25;0,583333333333333;0,833333333333333
"844";4867;97;5376;5;56;85;29;0,583333333333333;0,875
"845";4867;97;5377;5;56;89;33;0,583333333333333;0,916666666666667
"846";4867;97;5378;5;56;93;37;0,583333333333333;0,958333333333333
"847";4867;97;5379;5;56;97;41;0,583333333333333;1
"848";4867;97;5380;5;60;72;12;0,625;0,75
"849";4867;97;5381;5;60;77;17;0,625;0,791666666666667
"850";4867;97;5382;5;60;81;21;0,625;0,833333333333333
"851";4867;97;5383;5;60;85;25;0,625;0,875
"852";4867;97;5384;5;60;89;29;0,625;0,916666666666667
"853";4867;97;5385;5;60;93;33;0,625;0,958333333333333
"854";4867;97;5386;5;60;97;37;0,625;1
"855";4867;97;5387;5;64;93;29;0,666666666666667;0,958333333333333
"856";4867;97;5388;5;64;97;33;0,666666666666667;1
"857";4867;97;5389;5;72;97;25;0,75;1
"858";4867;97;5390;5;77;93;16;0,791666666666667;0,958333333333333
"859";4867;97;5391;5;77;97;20;0,791666666666667;1
"860";4867;97;5392;5;48;60;12;0,5;0,625
"861";4867;97;5393;5;48;64;16;0,5;0,666666666666667
"862";4867;97;5394;5;52;64;12;0,541666666666667;0,666666666666667
"863";4867;97;5395;5;32;44;12;0,333333333333333;0,458333333333333
"864";4867;97;5396;5;36;52;16;0,375;0,541666666666667
"865";4867;97;5397;5;40;56;16;0,416666666666667;0,583333333333333
"866";4867;97;5398;5;52;68;16;0,541666666666667;0,708333333333333
"867";4867;97;5399;5;52;72;20;0,541666666666667;0,75
"868";4867;97;5400;5;44;56;12;0,458333333333333;0,583333333333333
"869";4867;97;5401;5;52;77;25;0,541666666666667;0,791666666666667
"870";4867;97;5402;5;19;32;13;0,208333333333333;0,333333333333333
"871";4867;97;5403;5;32;48;16;0,333333333333333;0,5
"872";4867;97;5404;5;11;24;13;0,125;0,25
"873";4867;97;5405;5;40;60;20;0,416666666666667;0,625
"874";4867;97;5406;5;52;81;29;0,541666666666667;0,833333333333333
"875";4867;97;5407;5;52;85;33;0,541666666666667;0,875
"876";4867;97;5408;5;52;89;37;0,541666666666667;0,916666666666667
"877";4867;97;5409;5;52;93;41;0,541666666666667;0,958333333333333
"878";4867;97;5410;5;52;97;45;0,541666666666667;1
"879";4867;97;5411;5;36;56;20;0,375;0,583333333333333
"880";4867;97;5412;5;48;68;20;0,5;0,708333333333333
"881";4867;97;5413;5;48;72;24;0,5;0,75
"882";4867;97;5414;5;15;28;13;0,166666666666667;0,291666666666667
"883";4867;97;5415;6;1;7;6;0,0204081632653061;0,0816326530612245
"884";4867;97;5416;6;1;9;8;0,0204081632653061;0,102040816326531
"885";4867;97;5417;6;3;9;6;0,0408163265306122;0,102040816326531
"886";4867;97;5418;6;39;45;6;0,408163265306122;0,469387755102041
"887";4867;97;5419;6;39;47;8;0,408163265306122;0,489795918367347
"888";4867;97;5420;6;39;49;10;0,408163265306122;0,510204081632653
"889";4867;97;5421;6;41;47;6;0,428571428571429;0,489795918367347
"890";4867;97;5422;6;41;49;8;0,428571428571429;0,510204081632653
"891";4867;97;5423;6;43;49;6;0,448979591836735;0,510204081632653
"892";4867;97;5424;6;47;53;6;0,489795918367347;0,551020408163265
"893";4867;97;5425;6;53;59;6;0,551020408163265;0,612244897959184
"894";4867;97;5426;6;53;61;8;0,551020408163265;0,63265306122449
"895";4867;97;5427;6;53;63;10;0,551020408163265;0,653061224489796
"896";4867;97;5428;6;53;65;12;0,551020408163265;0,673469387755102
"897";4867;97;5429;6;55;61;6;0,571428571428571;0,63265306122449
"898";4867;97;5430;6;55;63;8;0,571428571428571;0,653061224489796
"899";4867;97;5431;6;55;65;10;0,571428571428571;0,673469387755102
"900";4867;97;5432;6;57;63;6;0,591836734693878;0,653061224489796
"901";4867;97;5433;6;57;65;8;0,591836734693878;0,673469387755102
"902";4867;97;5434;6;59;65;6;0,612244897959184;0,673469387755102
"903";4867;97;5435;6;65;71;6;0,673469387755102;0,73469387755102
"904";4867;97;5436;6;73;79;6;0,755102040816326;0,816326530612245
"905";4867;97;5437;6;73;81;8;0,755102040816326;0,836734693877551
"906";4867;97;5438;6;75;81;6;0,775510204081633;0,836734693877551
"907";4867;97;5439;6;55;67;12;0,571428571428571;0,693877551020408
"908";4867;97;5440;6;55;69;14;0,571428571428571;0,714285714285714
"909";4867;97;5441;6;55;71;16;0,571428571428571;0,73469387755102
"910";4867;97;5442;6;55;73;18;0,571428571428571;0,755102040816326
"911";4867;97;5443;6;55;75;20;0,571428571428571;0,775510204081633
"912";4867;97;5444;6;57;67;10;0,591836734693878;0,693877551020408
"913";4867;97;5445;6;57;69;12;0,591836734693878;0,714285714285714
"914";4867;97;5446;6;57;71;14;0,591836734693878;0,73469387755102
"915";4867;97;5447;6;57;73;16;0,591836734693878;0,755102040816326
"916";4867;97;5448;6;57;75;18;0,591836734693878;0,775510204081633
"917";4867;97;5449;6;59;67;8;0,612244897959184;0,693877551020408
"918";4867;97;5450;6;59;69;10;0,612244897959184;0,714285714285714
"919";4867;97;5451;6;59;71;12;0,612244897959184;0,73469387755102
"920";4867;97;5452;6;59;73;14;0,612244897959184;0,755102040816326
"921";4867;97;5453;6;59;75;16;0,612244897959184;0,775510204081633
"922";4867;97;5454;6;59;77;18;0,612244897959184;0,795918367346939
"923";4867;97;5455;6;61;67;6;0,63265306122449;0,693877551020408
"924";4867;97;5456;6;61;69;8;0,63265306122449;0,714285714285714
"925";4867;97;5457;6;61;71;10;0,63265306122449;0,73469387755102
"926";4867;97;5458;6;61;73;12;0,63265306122449;0,755102040816326
"927";4867;97;5459;6;61;75;14;0,63265306122449;0,775510204081633
"928";4867;97;5460;6;61;77;16;0,63265306122449;0,795918367346939
"929";4867;97;5461;6;61;79;18;0,63265306122449;0,816326530612245
"930";4867;97;5462;6;65;73;8;0,673469387755102;0,755102040816326
"931";4867;97;5463;6;65;75;10;0,673469387755102;0,775510204081633
"932";4867;97;5464;6;65;77;12;0,673469387755102;0,795918367346939
"933";4867;97;5465;6;65;79;14;0,673469387755102;0,816326530612245
"934";4867;97;5466;6;65;81;16;0,673469387755102;0,836734693877551
"935";4867;97;5467;6;73;83;10;0,755102040816326;0,857142857142857
"936";4867;97;5468;6;73;85;12;0,755102040816326;0,877551020408163
"937";4867;97;5469;6;73;87;14;0,755102040816326;0,897959183673469
"938";4867;97;5470;6;73;89;16;0,755102040816326;0,918367346938776
"939";4867;97;5471;6;73;91;18;0,755102040816326;0,938775510204082
"940";4867;97;5472;6;75;83;8;0,775510204081633;0,857142857142857
"941";4867;97;5473;6;75;85;10;0,775510204081633;0,877551020408163
"942";4867;97;5474;6;75;87;12;0,775510204081633;0,897959183673469
"943";4867;97;5475;6;75;89;14;0,775510204081633;0,918367346938776
"944";4867;97;5476;6;75;91;16;0,775510204081633;0,938775510204082
"945";4867;97;5477;6;15;21;6;0,163265306122449;0,224489795918367
"946";4867;97;5478;6;37;43;6;0,387755102040816;0,448979591836735
"947";4867;97;5479;6;39;51;12;0,408163265306122;0,530612244897959
"948";4867;97;5480;6;39;53;14;0,408163265306122;0,551020408163265
"949";4867;97;5481;6;41;51;10;0,428571428571429;0,530612244897959
"950";4867;97;5482;6;43;51;8;0,448979591836735;0,530612244897959
"951";4867;97;5483;6;49;55;6;0,510204081632653;0,571428571428571
"952";4867;97;5484;6;57;77;20;0,591836734693878;0,795918367346939
"953";4867;97;5485;6;57;79;22;0,591836734693878;0,816326530612245
"954";4867;97;5486;6;57;81;24;0,591836734693878;0,836734693877551
"955";4867;97;5487;6;57;83;26;0,591836734693878;0,857142857142857
"956";4867;97;5488;6;57;85;28;0,591836734693878;0,877551020408163
"957";4867;97;5489;6;57;87;30;0,591836734693878;0,897959183673469
"958";4867;97;5490;6;57;89;32;0,591836734693878;0,918367346938776
"959";4867;97;5491;6;59;79;20;0,612244897959184;0,816326530612245
"960";4867;97;5492;6;59;81;22;0,612244897959184;0,836734693877551
"961";4867;97;5493;6;59;83;24;0,612244897959184;0,857142857142857
"962";4867;97;5494;6;59;85;26;0,612244897959184;0,877551020408163
"963";4867;97;5495;6;59;87;28;0,612244897959184;0,897959183673469
"964";4867;97;5496;6;59;89;30;0,612244897959184;0,918367346938776
"965";4867;97;5497;6;61;81;20;0,63265306122449;0,836734693877551
"966";4867;97;5498;6;61;83;22;0,63265306122449;0,857142857142857
"967";4867;97;5499;6;61;85;24;0,63265306122449;0,877551020408163
"968";4867;97;5500;6;65;83;18;0,673469387755102;0,857142857142857
"969";4867;97;5501;6;65;85;20;0,673469387755102;0,877551020408163
"970";4867;97;5502;6;65;87;22;0,673469387755102;0,897959183673469
"971";4867;97;5503;6;27;33;6;0,285714285714286;0,346938775510204
"972";4867;97;5504;6;17;23;6;0,183673469387755;0,244897959183673
"973";4867;97;5505;6;47;55;8;0,489795918367347;0,571428571428571
"974";4867;97;5506;6;37;45;8;0,387755102040816;0,469387755102041
"975";4867;97;5507;6;23;29;6;0,244897959183673;0,306122448979592
"976";4867;97;5508;6;37;47;10;0,387755102040816;0,489795918367347
"977";4867;97;5509;6;37;49;12;0,387755102040816;0,510204081632653
"978";4867;97;5510;6;37;51;14;0,387755102040816;0,530612244897959
"979";4867;97;5511;6;41;53;12;0,428571428571429;0,551020408163265
"980";4867;97;5512;6;43;53;10;0,448979591836735;0,551020408163265
"981";4867;97;5513;6;49;57;8;0,510204081632653;0,591836734693878
"982";4867;97;5514;6;53;67;14;0,551020408163265;0,693877551020408
"983";4867;97;5515;6;75;93;18;0,775510204081633;0,959183673469388
"984";4867;97;5516;6;75;95;20;0,775510204081633;0,979591836734694
"985";4867;97;5517;6;35;41;6;0,36734693877551;0,428571428571429
"986";4867;97;5518;6;37;53;16;0,387755102040816;0,551020408163265
"987";4867;97;5519;6;33;39;6;0,346938775510204;0,408163265306122
"988";4867;97;5520;6;49;59;10;0,510204081632653;0,612244897959184
"989";4867;97;5521;6;73;93;20;0,755102040816326;0,959183673469388
"990";4867;97;5522;6;53;69;16;0,551020408163265;0,714285714285714
"991";4867;97;5523;6;53;71;18;0,551020408163265;0,73469387755102
"992";4867;97;5524;6;53;73;20;0,551020408163265;0,755102040816326
"993";4867;97;5525;6;53;75;22;0,551020408163265;0,775510204081633
"994";4867;97;5526;6;53;77;24;0,551020408163265;0,795918367346939
"995";4867;97;5527;6;55;77;22;0,571428571428571;0,795918367346939
"996";4867;97;5528;6;13;19;6;0,142857142857143;0,204081632653061
"997";4867;97;5529;6;55;79;24;0,571428571428571;0,816326530612245
"998";4867;97;5530;6;55;81;26;0,571428571428571;0,836734693877551
"999";4867;97;5531;6;55;83;28;0,571428571428571;0,857142857142857
"1000";4867;97;5532;6;55;85;30;0,571428571428571;0,877551020408163
"1001";4867;97;5533;6;61;87;26;0,63265306122449;0,897959183673469
"1002";4867;97;5534;6;65;89;24;0,673469387755102;0,918367346938776
"1003";4867;97;5535;6;73;95;22;0,755102040816326;0,979591836734694
"1004";4867;97;5536;6;75;97;22;0,775510204081633;1
"1005";4867;97;5537;6;73;97;24;0,755102040816326;1
"1006";4867;97;5538;6;55;87;32;0,571428571428571;0,897959183673469
"1007";4867;97;5539;6;61;89;28;0,63265306122449;0,918367346938776
"1008";4867;97;5540;6;61;91;30;0,63265306122449;0,938775510204082
"1009";4867;97;5541;6;65;91;26;0,673469387755102;0,938775510204082
"1010";4867;97;5542;6;11;17;6;0,122448979591837;0,183673469387755
"1011";4867;97;5543;6;55;89;34;0,571428571428571;0,918367346938776
"1012";4936;90;5644;4;16;40;24;0,181818181818182;0,454545454545455
"1013";4936;90;5645;4;65;90;25;0,727272727272727;1
"1014";4936;90;5646;5;49;61;12;0,545454545454545;0,681818181818182
"1015";4936;90;5647;5;73;86;13;0,818181818181818;0,954545454545455
"1016";4936;90;5648;5;78;90;12;0,863636363636364;1
"1017";4936;90;5649;5;20;32;12;0,227272727272727;0,363636363636364
"1018";4936;90;5650;5;73;90;17;0,818181818181818;1
"1019";4936;90;5651;5;69;82;13;0,772727272727273;0,909090909090909
"1020";4936;90;5652;5;69;86;17;0,772727272727273;0,954545454545455
"1021";4936;90;5653;5;3;16;13;0,0454545454545455;0,181818181818182
"1022";4936;90;5654;5;65;78;13;0,727272727272727;0,863636363636364
"1023";4936;90;5655;6;11;17;6;0,133333333333333;0,2
"1024";4936;90;5656;6;21;27;6;0,244444444444444;0,311111111111111
"1025";4936;90;5657;6;37;43;6;0,422222222222222;0,488888888888889
"1026";4936;90;5658;6;50;56;6;0,555555555555556;0,622222222222222
"1027";4936;90;5659;6;70;76;6;0,777777777777778;0,844444444444444
"1028";4936;90;5660;6;76;82;6;0,844444444444444;0,911111111111111
"1029";4936;90;5661;6;7;13;6;0,0888888888888889;0,155555555555556
"1030";4936;90;5662;6;21;29;8;0,244444444444444;0,333333333333333
"1031";4936;90;5663;6;23;29;6;0,266666666666667;0,333333333333333
"1032";4936;90;5664;6;37;46;9;0,422222222222222;0,511111111111111
"1033";4936;90;5665;6;50;58;8;0,555555555555556;0,644444444444444
"1034";4936;90;5666;6;50;60;10;0,555555555555556;0,666666666666667
"1035";4936;90;5667;6;50;62;12;0,555555555555556;0,688888888888889
"1036";4936;90;5668;6;50;64;14;0,555555555555556;0,711111111111111
"1037";4936;90;5669;6;31;37;6;0,355555555555556;0,422222222222222
"1038";4936;90;5670;6;13;19;6;0,155555555555556;0,222222222222222
"1039";4936;90;5671;6;7;15;8;0,0888888888888889;0,177777777777778
"1040";4936;90;5672;6;39;46;7;0,444444444444444;0,511111111111111
"1041";4936;90;5673;6;70;78;8;0,777777777777778;0,866666666666667
"1042";4936;90;5674;6;76;84;8;0,844444444444444;0,933333333333333
"1043";4936;90;5675;6;76;86;10;0,844444444444444;0,955555555555556
"1044";4936;90;5676;6;76;88;12;0,844444444444444;0,977777777777778
"1045";4936;90;5677;6;76;90;14;0,844444444444444;1
"1046";4936;90;5678;6;68;74;6;0,755555555555556;0,822222222222222
"1047";4936;90;5679;6;5;11;6;0,0666666666666667;0,133333333333333
"1048";4936;90;5680;6;7;17;10;0,0888888888888889;0,2
"1049";4936;90;5681;6;9;15;6;0,111111111111111;0,177777777777778
"1050";4936;90;5682;6;9;17;8;0,111111111111111;0,2
"1051";4936;90;5683;6;11;19;8;0,133333333333333;0,222222222222222
"1052";4936;90;5684;6;68;76;8;0,755555555555556;0,844444444444444
"1053";4936;90;5685;6;66;72;6;0,733333333333333;0,8
"1054";4936;90;5686;6;29;35;6;0,333333333333333;0,4
"1055";4936;90;5687;6;21;31;10;0,244444444444444;0,355555555555556
"1056";4936;90;5688;6;29;37;8;0,333333333333333;0,422222222222222
"1057";4936;90;5689;6;64;70;6;0,711111111111111;0,777777777777778
"1058";4936;90;5690;6;19;25;6;0,222222222222222;0,288888888888889
"1059";7858;133;7649;4;16;66;50;0,125;0,5
"1060";7858;133;7650;4;49;100;51;0,375;0,75
"1061";7858;133;7651;4;32;83;51;0,25;0,625
"1062";7858;133;7652;5;74;100;26;0,5625;0,75
"1063";7858;133;7653;5;108;133;25;0,8125;1
"1064";7858;133;7654;5;49;74;25;0,375;0,5625
"1065";7858;133;7655;5;32;58;26;0,25;0,4375
"1066";7858;133;7656;5;66;91;25;0,5;0,6875
"1067";7858;133;7657;5;41;66;25;0,3125;0,5
"1068";7858;133;7658;5;66;100;34;0,5;0,75
"1069";7858;133;7659;5;24;49;25;0,1875;0,375
"1070";7858;133;7660;5;58;83;25;0,4375;0,625
"1071";7858;133;7661;5;16;41;25;0,125;0,3125
"1072";7858;133;7662;6;23;36;13;0,181818181818182;0,272727272727273
"1073";7858;133;7663;6;113;125;12;0,848484848484849;0,939393939393939
"1074";7858;133;7664;6;44;56;12;0,333333333333333;0,424242424242424
"1075";7858;133;7665;6;56;68;12;0,424242424242424;0,515151515151515
"1076";7858;133;7666;6;15;27;12;0,121212121212121;0,212121212121212
"1077";7858;133;7667;6;19;31;12;0,151515151515152;0,242424242424242
"1078";7858;133;7668;6;48;60;12;0,363636363636364;0,454545454545455
"1079";7858;133;7669;6;68;80;12;0,515151515151515;0,606060606060606
"1080";7858;133;7670;6;52;64;12;0,393939393939394;0,484848484848485
"1081";7858;133;7671;6;27;40;13;0,212121212121212;0,303030303030303
"1082";7858;133;7672;6;48;64;16;0,363636363636364;0,484848484848485
"1083";7858;133;7673;6;72;84;12;0,545454545454545;0,636363636363636
"1084";7858;133;7674;6;40;52;12;0,303030303030303;0,393939393939394
"1085";7858;133;7675;6;52;68;16;0,393939393939394;0,515151515151515
"1086";7858;133;7676;6;68;84;16;0,515151515151515;0,636363636363636
"1087";7858;133;7677;6;60;72;12;0,454545454545455;0,545454545454545
"1088";7858;133;7678;6;31;44;13;0,242424242424242;0,333333333333333
"1089";7858;133;7679;6;76;88;12;0,575757575757576;0,666666666666667
"1090";7858;133;7680;6;36;48;12;0,272727272727273;0,363636363636364
"1091";7858;133;7681;6;84;96;12;0,636363636363636;0,727272727272727
"1092";7858;133;7682;6;64;76;12;0,484848484848485;0,575757575757576
"1093";7858;133;7683;6;113;129;16;0,848484848484849;0,96969696969697
"1094";7858;133;7684;6;109;121;12;0,818181818181818;0,909090909090909
"1095";7858;133;7685;6;109;125;16;0,818181818181818;0,939393939393939
"1096";7858;133;7686;6;109;129;20;0,818181818181818;0,96969696969697
"1097";7858;133;7687;6;109;133;24;0,818181818181818;1
"1098";7858;133;7688;6;72;88;16;0,545454545454545;0,666666666666667
"1099";7858;133;7689;6;113;133;20;0,848484848484849;1
"1100";7858;133;7690;6;101;113;12;0,757575757575758;0,848484848484849
"1101";11187;75;9416;3;18;75;57;0,25;1
"1102";11187;75;9417;4;41;67;26;0,555555555555556;0,888888888888889
"1103";11187;75;9418;4;41;75;34;0,555555555555556;1
"1104";11187;75;9419;4;50;75;25;0,666666666666667;1
"1105";11187;75;9420;4;24;50;26;0,333333333333333;0,666666666666667
"1106";11187;75;9421;5;43;55;12;0,578947368421053;0,736842105263158
"1107";11187;75;9422;5;43;59;16;0,578947368421053;0,789473684210526
"1108";11187;75;9423;5;51;63;12;0,684210526315789;0,842105263157895
"1109";11187;75;9424;5;55;67;12;0,736842105263158;0,894736842105263
"1110";11187;75;9425;5;55;71;16;0,736842105263158;0,947368421052632
"1111";11187;75;9426;5;27;39;12;0,368421052631579;0,526315789473684
"1112";11187;75;9427;5;27;43;16;0,368421052631579;0,578947368421053
"1113";11187;75;9428;5;43;63;20;0,578947368421053;0,842105263157895
"1114";11187;75;9429;5;43;67;24;0,578947368421053;0,894736842105263
"1115";11187;75;9430;5;43;71;28;0,578947368421053;0,947368421052632
"1116";11187;75;9431;5;43;75;32;0,578947368421053;1
"1117";11187;75;9432;5;51;67;16;0,684210526315789;0,894736842105263
"1118";11187;75;9433;5;51;71;20;0,684210526315789;0,947368421052632
"1119";11187;75;9434;5;51;75;24;0,684210526315789;1
"1120";11187;75;9435;5;55;75;20;0,736842105263158;1
"1121";11187;75;9436;5;27;47;20;0,368421052631579;0,631578947368421
"1122";11187;75;9437;5;39;51;12;0,526315789473684;0,684210526315789
"1123";11187;75;9438;5;7;19;12;0,105263157894737;0,263157894736842
"1124";11187;75;9439;6;43;49;6;0,578947368421053;0,657894736842105
"1125";11187;75;9440;6;43;51;8;0,578947368421053;0,684210526315789
"1126";11187;75;9441;6;53;59;6;0,710526315789474;0,789473684210526
"1127";11187;75;9442;6;55;61;6;0,736842105263158;0,815789473684211
"1128";11187;75;9443;6;55;63;8;0,736842105263158;0,842105263157895
"1129";11187;75;9444;6;13;19;6;0,184210526315789;0,263157894736842
"1130";11187;75;9445;6;27;33;6;0,368421052631579;0,447368421052632
"1131";11187;75;9446;6;27;35;8;0,368421052631579;0,473684210526316
"1132";11187;75;9447;6;27;37;10;0,368421052631579;0,5
"1133";11187;75;9448;6;43;53;10;0,578947368421053;0,710526315789474
"1134";11187;75;9449;6;43;55;12;0,578947368421053;0,736842105263158
"1135";11187;75;9450;6;43;57;14;0,578947368421053;0,763157894736842
"1136";11187;75;9451;6;43;59;16;0,578947368421053;0,789473684210526
"1137";11187;75;9452;6;53;61;8;0,710526315789474;0,815789473684211
"1138";11187;75;9453;6;53;63;10;0,710526315789474;0,842105263157895
"1139";11187;75;9454;6;53;65;12;0,710526315789474;0,868421052631579
"1140";11187;75;9455;6;55;65;10;0,736842105263158;0,868421052631579
"1141";11187;75;9456;6;55;67;12;0,736842105263158;0,894736842105263
"1142";11187;75;9457;6;55;69;14;0,736842105263158;0,921052631578947
"1143";11187;75;9458;6;55;71;16;0,736842105263158;0,947368421052632
"1144";11187;75;9459;6;27;39;12;0,368421052631579;0,526315789473684
"1145";11187;75;9460;6;27;41;14;0,368421052631579;0,552631578947368
"1146";11187;75;9461;6;27;43;16;0,368421052631579;0,578947368421053
"1147";11187;75;9462;6;43;61;18;0,578947368421053;0,815789473684211
"1148";11187;75;9463;6;43;63;20;0,578947368421053;0,842105263157895
"1149";11187;75;9464;6;53;67;14;0,710526315789474;0,894736842105263
"1150";11187;75;9465;6;53;69;16;0,710526315789474;0,921052631578947
"1151";11187;75;9466;6;53;71;18;0,710526315789474;0,947368421052632
"1152";11187;75;9467;6;53;73;20;0,710526315789474;0,973684210526316
"1153";11187;75;9468;6;43;65;22;0,578947368421053;0,868421052631579
"1154";11187;75;9469;6;53;75;22;0,710526315789474;1
"1155";11187;75;9470;6;55;73;18;0,736842105263158;0,973684210526316
"1156";11187;75;9471;6;55;75;20;0,736842105263158;1
"1157";11187;75;9472;6;11;17;6;0,157894736842105;0,236842105263158
"1158";11187;75;9473;6;39;45;6;0,526315789473684;0,605263157894737
"1159";11187;75;9474;6;41;47;6;0,552631578947368;0,631578947368421
"1160";11187;75;9475;6;7;13;6;0,105263157894737;0,184210526315789
"1161";11187;75;9476;6;5;11;6;0,0789473684210526;0,157894736842105
"1162";11187;75;9477;6;1;7;6;0,0263157894736842;0,105263157894737
"1163";11187;75;9478;6;43;67;24;0,578947368421053;0,894736842105263
"1164";11187;75;9479;6;43;69;26;0,578947368421053;0,921052631578947
"1165";11187;75;9480;6;43;71;28;0,578947368421053;0,947368421052632
"1166";11187;75;9481;6;43;73;30;0,578947368421053;0,973684210526316
"1167";11187;75;9482;6;43;75;32;0,578947368421053;1
"1168";11389;65;9591;4;40;65;25;0,625;1
"1169";11389;65;9592;4;7;32;25;0,125;0,5
"1170";11389;65;9593;4;16;40;24;0,25;0,625
"1171";11389;65;9594;5;16;28;12;0,25;0,4375
"1172";11389;65;9595;5;16;32;16;0,25;0,5
"1173";11389;65;9596;5;16;36;20;0,25;0,5625
"1174";11389;65;9597;5;40;53;13;0,625;0,8125
"1175";11389;65;9598;5;40;57;17;0,625;0,875
"1176";11389;65;9599;5;44;57;13;0,6875;0,875
"1177";11389;65;9600;5;44;61;17;0,6875;0,9375
"1178";11389;65;9601;5;44;65;21;0,6875;1
"1179";11389;65;9602;5;7;20;13;0,125;0,3125
"1180";11389;65;9603;5;11;24;13;0,1875;0,375
"1181";11389;65;9604;5;11;28;17;0,1875;0,4375
"1182";11389;65;9605;5;11;32;21;0,1875;0,5
"1183";11389;65;9606;5;11;36;25;0,1875;0,5625
"1184";11389;65;9607;5;7;24;17;0,125;0,375
"1185";11389;65;9608;5;7;28;21;0,125;0,4375
"1186";11389;65;9609;5;7;32;25;0,125;0,5
"1187";11389;65;9610;5;7;36;29;0,125;0,5625
"1188";11389;65;9611;6;9;15;6;0,151515151515152;0,242424242424242
"1189";11389;65;9612;6;9;17;8;0,151515151515152;0,272727272727273
"1190";11389;65;9613;6;11;17;6;0,181818181818182;0,272727272727273
"1191";11389;65;9614;6;17;23;6;0,272727272727273;0,363636363636364
"1192";11389;65;9615;6;17;25;8;0,272727272727273;0,393939393939394
"1193";11389;65;9616;6;17;27;10;0,272727272727273;0,424242424242424
"1194";11389;65;9617;6;41;47;6;0,636363636363636;0,727272727272727
"1195";11389;65;9618;6;43;49;6;0,666666666666667;0,757575757575758
"1196";11389;65;9619;6;43;51;8;0,666666666666667;0,787878787878788
"1197";11389;65;9620;6;43;53;10;0,666666666666667;0,818181818181818
"1198";11389;65;9621;6;45;51;6;0,696969696969697;0,787878787878788
"1199";11389;65;9622;6;45;53;8;0,696969696969697;0,818181818181818
"1200";11389;65;9623;6;45;55;10;0,696969696969697;0,848484848484849
"1201";11389;65;9624;6;7;13;6;0,121212121212121;0,212121212121212
"1202";11389;65;9625;6;17;29;12;0,272727272727273;0,454545454545455
"1203";11389;65;9626;6;17;31;14;0,272727272727273;0,484848484848485
"1204";11389;65;9627;6;17;33;16;0,272727272727273;0,515151515151515
"1205";11389;65;9628;6;17;35;18;0,272727272727273;0,545454545454545
"1206";11389;65;9629;6;17;37;20;0,272727272727273;0,575757575757576
"1207";11389;65;9630;6;17;39;22;0,272727272727273;0,606060606060606
"1208";11389;65;9631;6;43;55;12;0,666666666666667;0,848484848484849
"1209";11389;65;9632;6;43;57;14;0,666666666666667;0,878787878787879
"1210";11389;65;9633;6;43;59;16;0,666666666666667;0,909090909090909
"1211";11389;65;9634;6;43;61;18;0,666666666666667;0,939393939393939
"1212";11389;65;9635;6;43;63;20;0,666666666666667;0,96969696969697
"1213";11389;65;9636;6;9;19;10;0,151515151515152;0,303030303030303
"1214";11389;65;9637;6;9;21;12;0,151515151515152;0,333333333333333
"1215";11389;65;9638;6;9;23;14;0,151515151515152;0,363636363636364
"1216";11389;65;9639;6;9;25;16;0,151515151515152;0,393939393939394
"1217";11389;65;9640;6;9;27;18;0,151515151515152;0,424242424242424
"1218";11389;65;9641;6;9;29;20;0,151515151515152;0,454545454545455
"1219";11389;65;9642;6;9;31;22;0,151515151515152;0,484848484848485
"1220";11389;65;9643;6;45;57;12;0,696969696969697;0,878787878787879
"1221";11389;65;9644;6;45;59;14;0,696969696969697;0,909090909090909
"1222";11389;65;9645;6;45;61;16;0,696969696969697;0,939393939393939
"1223";11389;65;9646;6;45;63;18;0,696969696969697;0,96969696969697
"1224";11389;65;9647;6;45;65;20;0,696969696969697;1
"1225";11389;65;9648;6;11;19;8;0,181818181818182;0,303030303030303
"1226";11389;65;9649;6;11;21;10;0,181818181818182;0,333333333333333
"1227";11389;65;9650;6;11;23;12;0,181818181818182;0,363636363636364
"1228";11389;65;9651;6;11;25;14;0,181818181818182;0,393939393939394
"1229";11389;65;9652;6;11;27;16;0,181818181818182;0,424242424242424
"1230";11389;65;9653;6;11;29;18;0,181818181818182;0,454545454545455
"1231";11389;65;9654;6;11;31;20;0,181818181818182;0,484848484848485
"1232";11389;65;9655;6;11;33;22;0,181818181818182;0,515151515151515
"1233";11389;65;9656;6;11;35;24;0,181818181818182;0,545454545454545
"1234";11389;65;9657;6;11;37;26;0,181818181818182;0,575757575757576
"1235";11389;65;9658;6;11;39;28;0,181818181818182;0,606060606060606
"1236";11389;65;9659;6;43;65;22;0,666666666666667;1
"1237";12053;87;9957;3;34;87;53;0,4;1
"1238";12053;87;9958;4;63;87;24;0,727272727272727;1
"1239";12053;87;9959;4;55;79;24;0,636363636363636;0,909090909090909
"1240";12053;87;9960;4;55;87;32;0,636363636363636;1
"1241";12053;87;9961;4;15;39;24;0,181818181818182;0,454545454545455
"1242";12053;87;9962;4;23;47;24;0,272727272727273;0,545454545454545
"1243";12053;87;9963;4;47;71;24;0,545454545454545;0,818181818181818
"1244";12053;87;9964;4;47;79;32;0,545454545454545;0,909090909090909
"1245";12053;87;9965;4;47;87;40;0,545454545454545;1
"1246";12053;87;9966;5;59;71;12;0,681818181818182;0,818181818181818
"1247";12053;87;9967;5;67;79;12;0,772727272727273;0,909090909090909
"1248";12053;87;9968;5;11;23;12;0,136363636363636;0,272727272727273
"1249";12053;87;9969;5;19;31;12;0,227272727272727;0,363636363636364
"1250";12053;87;9970;5;59;75;16;0,681818181818182;0,863636363636364
"1251";12053;87;9971;5;59;79;20;0,681818181818182;0,909090909090909
"1252";12053;87;9972;5;15;27;12;0,181818181818182;0,318181818181818
"1253";12053;87;9973;5;19;35;16;0,227272727272727;0,409090909090909
"1254";12053;87;9974;5;23;35;12;0,272727272727273;0,409090909090909
"1255";12053;87;9975;5;35;47;12;0,409090909090909;0,545454545454545
"1256";12053;87;9976;5;47;59;12;0,545454545454545;0,681818181818182
"1257";12053;87;9977;5;55;67;12;0,636363636363636;0,772727272727273
"1258";12053;87;9978;5;55;71;16;0,636363636363636;0,818181818181818
"1259";12053;87;9979;5;59;83;24;0,681818181818182;0,954545454545455
"1260";12053;87;9980;5;59;87;28;0,681818181818182;1
"1261";12053;87;9981;5;63;75;12;0,727272727272727;0,863636363636364
"1262";12053;87;9982;5;63;79;16;0,727272727272727;0,909090909090909
"1263";12053;87;9983;5;63;83;20;0,727272727272727;0,954545454545455
"1264";12053;87;9984;5;63;87;24;0,727272727272727;1
"1265";12053;87;9985;5;67;83;16;0,772727272727273;0,954545454545455
"1266";12053;87;9986;5;67;87;20;0,772727272727273;1
"1267";12053;87;9987;5;7;19;12;0,0909090909090909;0,227272727272727
"1268";12053;87;9988;5;31;43;12;0,363636363636364;0,5
"1269";12053;87;9989;5;51;63;12;0,590909090909091;0,727272727272727
"1270";12053;87;9990;5;55;75;20;0,636363636363636;0,863636363636364
"1271";12053;87;9991;5;15;31;16;0,181818181818182;0,363636363636364
"1272";12053;87;9992;5;55;79;24;0,636363636363636;0,909090909090909
"1273";12053;87;9993;5;55;83;28;0,636363636363636;0,954545454545455
"1274";12053;87;9994;5;55;87;32;0,636363636363636;1
"1275";12053;87;9995;5;11;27;16;0,136363636363636;0,318181818181818
"1276";12053;87;9996;6;63;69;6;0,727272727272727;0,795454545454545
"1277";12053;87;9997;6;27;33;6;0,318181818181818;0,386363636363636
"1278";12053;87;9998;6;35;41;6;0,409090909090909;0,477272727272727
"1279";12053;87;9999;6;35;43;8;0,409090909090909;0,5
"1280";12053;87;10000;6;37;43;6;0,431818181818182;0,5
"1281";12053;87;10001;6;39;45;6;0,454545454545455;0,522727272727273
"1282";12053;87;10002;6;57;63;6;0,659090909090909;0,727272727272727
"1283";12053;87;10003;6;65;71;6;0,75;0,818181818181818
"1284";12053;87;10004;6;9;15;6;0,113636363636364;0,181818181818182
"1285";12053;87;10005;6;15;21;6;0,181818181818182;0,25
"1286";12053;87;10006;6;15;23;8;0,181818181818182;0,272727272727273
"1287";12053;87;10007;6;35;45;10;0,409090909090909;0,522727272727273
"1288";12053;87;10008;6;37;45;8;0,431818181818182;0,522727272727273
"1289";12053;87;10009;6;51;57;6;0,590909090909091;0,659090909090909
"1290";12053;87;10010;6;51;59;8;0,590909090909091;0,681818181818182
"1291";12053;87;10011;6;53;59;6;0,613636363636364;0,681818181818182
"1292";12053;87;10012;6;57;65;8;0,659090909090909;0,75
"1293";12053;87;10013;6;57;67;10;0,659090909090909;0,772727272727273
"1294";12053;87;10014;6;57;69;12;0,659090909090909;0,795454545454545
"1295";12053;87;10015;6;57;71;14;0,659090909090909;0,818181818181818
"1296";12053;87;10016;6;61;67;6;0,704545454545455;0,772727272727273
"1297";12053;87;10017;6;61;69;8;0,704545454545455;0,795454545454545
"1298";12053;87;10018;6;61;71;10;0,704545454545455;0,818181818181818
"1299";12053;87;10019;6;61;73;12;0,704545454545455;0,840909090909091
"1300";12053;87;10020;6;63;71;8;0,727272727272727;0,818181818181818
"1301";12053;87;10021;6;63;73;10;0,727272727272727;0,840909090909091
"1302";12053;87;10022;6;65;73;8;0,75;0,840909090909091
"1303";12053;87;10023;6;65;75;10;0,75;0,863636363636364
"1304";12053;87;10024;6;65;77;12;0,75;0,886363636363636
"1305";12053;87;10025;6;65;79;14;0,75;0,909090909090909
"1306";12053;87;10026;6;5;11;6;0,0681818181818182;0,136363636363636
"1307";12053;87;10027;6;13;19;6;0,159090909090909;0,227272727272727
"1308";12053;87;10028;6;45;51;6;0,522727272727273;0,590909090909091
"1309";12053;87;10029;6;57;73;16;0,659090909090909;0,840909090909091
"1310";12053;87;10030;6;57;75;18;0,659090909090909;0,863636363636364
"1311";12053;87;10031;6;57;77;20;0,659090909090909;0,886363636363636
"1312";12053;87;10032;6;57;79;22;0,659090909090909;0,909090909090909
"1313";12053;87;10033;6;63;75;12;0,727272727272727;0,863636363636364
"1314";12053;87;10034;6;63;77;14;0,727272727272727;0,886363636363636
"1315";12053;87;10035;6;63;79;16;0,727272727272727;0,909090909090909
"1316";12053;87;10036;6;63;81;18;0,727272727272727;0,931818181818182
"1317";12053;87;10037;6;63;83;20;0,727272727272727;0,954545454545455
"1318";12053;87;10038;6;63;85;22;0,727272727272727;0,977272727272727
"1319";12053;87;10039;6;11;17;6;0,136363636363636;0,204545454545455
"1320";12053;87;10040;6;11;19;8;0,136363636363636;0,227272727272727
"1321";12053;87;10041;6;21;27;6;0,25;0,318181818181818
"1322";12053;87;10042;6;49;55;6;0,568181818181818;0,636363636363636
"1323";12053;87;10043;6;17;23;6;0,204545454545455;0,272727272727273
"1324";12053;87;10044;6;19;25;6;0,227272727272727;0,295454545454545
"1325";12053;87;10045;6;5;13;8;0,0681818181818182;0,159090909090909
"1326";12053;87;10046;6;23;29;6;0,272727272727273;0,340909090909091
"1327";12053;87;10047;6;33;39;6;0,386363636363636;0,454545454545455
"1328";12053;87;10048;6;33;41;8;0,386363636363636;0,477272727272727
"1329";12053;87;10049;6;33;43;10;0,386363636363636;0,5
"1330";12053;87;10050;6;33;45;12;0,386363636363636;0,522727272727273
"1331";12053;87;10051;6;53;61;8;0,613636363636364;0,704545454545455
"1332";12053;87;10052;6;55;61;6;0,636363636363636;0,704545454545455
"1333";12053;87;10053;6;55;63;8;0,636363636363636;0,727272727272727
"1334";12053;87;10054;6;65;81;16;0,75;0,931818181818182
"1335";12053;87;10055;6;65;83;18;0,75;0,954545454545455
"1336";12053;87;10056;6;7;13;6;0,0909090909090909;0,159090909090909
"1337";12053;87;10057;6;9;17;8;0,113636363636364;0,204545454545455
"1338";12053;87;10058;6;23;31;8;0,272727272727273;0,363636363636364
"1339";12053;87;10059;6;17;25;8;0,204545454545455;0,295454545454545
"1340";12053;87;10060;6;17;27;10;0,204545454545455;0,318181818181818
"1341";12053;87;10061;6;61;75;14;0,704545454545455;0,863636363636364
"1342";12053;87;10062;6;61;77;16;0,704545454545455;0,886363636363636
"1343";12053;87;10063;6;61;79;18;0,704545454545455;0,909090909090909
"1344";12053;87;10064;6;61;81;20;0,704545454545455;0,931818181818182
"1345";12053;87;10065;6;61;83;22;0,704545454545455;0,954545454545455
"1346";12053;87;10066;6;61;85;24;0,704545454545455;0,977272727272727
"1347";12053;87;10067;6;63;87;24;0,727272727272727;1
"1348";12053;87;10068;6;65;85;20;0,75;0,977272727272727
"1349";12053;87;10069;6;65;87;22;0,75;1
"1350";12053;87;10070;6;21;29;8;0,25;0,340909090909091
"1351";12053;87;10071;6;21;31;10;0,25;0,363636363636364
"1352";12053;87;10072;6;47;53;6;0,545454545454545;0,613636363636364
"1353";12053;87;10073;6;13;21;8;0,159090909090909;0,25
"1354";12053;87;10074;6;25;31;6;0,295454545454545;0,363636363636364
"1355";12053;87;10075;6;25;33;8;0,295454545454545;0,386363636363636
"1356";12053;87;10076;6;39;47;8;0,454545454545455;0,545454545454545
"1357";12053;87;10077;6;49;57;8;0,568181818181818;0,659090909090909
"1358";12053;87;10078;6;11;21;10;0,136363636363636;0,25
"1359";12053;87;10079;6;55;65;10;0,636363636363636;0,75
"1360";12053;87;10080;6;55;67;12;0,636363636363636;0,772727272727273
"1361";12053;87;10081;6;55;69;14;0,636363636363636;0,795454545454545
"1362";12053;87;10082;6;19;27;8;0,227272727272727;0,318181818181818
"1363";12053;87;10083;6;57;81;24;0,659090909090909;0,931818181818182
"1364";12053;87;10084;6;57;83;26;0,659090909090909;0,954545454545455
"1365";12053;87;10085;6;57;85;28;0,659090909090909;0,977272727272727
"1366";12053;87;10086;6;3;9;6;0,0454545454545455;0,113636363636364
"1367";12053;87;10087;6;23;33;10;0,272727272727273;0,386363636363636
"1368";12053;87;10088;6;57;87;30;0,659090909090909;1
"1369";12547;157;10120;4;69;122;53;0,444444444444444;0,777777777777778
"1370";12547;157;10121;5;7;32;25;0,0526315789473684;0,210526315789474
"1371";12547;157;10122;5;41;66;25;0,263157894736842;0,421052631578947
"1372";12547;157;10123;5;74;99;25;0,473684210526316;0,631578947368421
"1373";12547;157;10124;5;74;107;33;0,473684210526316;0,684210526315789
"1374";12547;157;10125;5;82;107;25;0,526315789473684;0,684210526315789
"1375";12547;157;10126;5;132;157;25;0,842105263157895;1
"1376";12547;157;10127;5;16;41;25;0,105263157894737;0,263157894736842
"1377";12547;157;10128;5;24;49;25;0,157894736842105;0,315789473684211
"1378";12547;157;10129;5;32;57;25;0,210526315789474;0,368421052631579
"1379";12547;157;10130;5;32;66;34;0,210526315789474;0,421052631578947
"1380";12547;157;10131;5;16;49;33;0,105263157894737;0,315789473684211
"1381";12547;157;10132;5;82;115;33;0,526315789473684;0,736842105263158
"1382";12547;157;10133;6;15;27;12;0,102564102564103;0,179487179487179
"1383";12547;157;10134;6;48;60;12;0,307692307692308;0,384615384615385
"1384";12547;157;10135;6;80;92;12;0,512820512820513;0,58974358974359
"1385";12547;157;10136;6;84;96;12;0,538461538461538;0,615384615384615
"1386";12547;157;10137;6;88;100;12;0,564102564102564;0,641025641025641
"1387";12547;157;10138;6;92;104;12;0,58974358974359;0,666666666666667
"1388";12547;157;10139;6;108;121;13;0,692307692307692;0,769230769230769
"1389";12547;157;10140;6;108;125;17;0,692307692307692;0,794871794871795
"1390";12547;157;10141;6;112;125;13;0,717948717948718;0,794871794871795
"1391";12547;157;10142;6;133;145;12;0,846153846153846;0,923076923076923
"1392";12547;157;10143;6;141;153;12;0,897435897435897;0,974358974358974
"1393";12547;157;10144;6;48;64;16;0,307692307692308;0,41025641025641
"1394";12547;157;10145;6;48;68;20;0,307692307692308;0,435897435897436
"1395";12547;157;10146;6;52;64;12;0,333333333333333;0,41025641025641
"1396";12547;157;10147;6;52;68;16;0,333333333333333;0,435897435897436
"1397";12547;157;10148;6;56;68;12;0,358974358974359;0,435897435897436
"1398";12547;157;10149;6;80;96;16;0,512820512820513;0,615384615384615
"1399";12547;157;10150;6;80;100;20;0,512820512820513;0,641025641025641
"1400";12547;157;10151;6;84;100;16;0,538461538461538;0,641025641025641
"1401";12547;157;10152;6;88;104;16;0,564102564102564;0,666666666666667
"1402";12547;157;10153;6;88;108;20;0,564102564102564;0,692307692307692
"1403";12547;157;10154;6;92;108;16;0,58974358974359;0,692307692307692
"1404";12547;157;10155;6;137;149;12;0,871794871794872;0,948717948717949
"1405";12547;157;10156;6;137;153;16;0,871794871794872;0,974358974358974
"1406";12547;157;10157;6;11;23;12;0,0769230769230769;0,153846153846154
"1407";12547;157;10158;6;137;157;20;0,871794871794872;1
"1408";12547;157;10159;6;141;157;16;0,897435897435897;1
"1409";12547;157;10160;6;31;44;13;0,205128205128205;0,282051282051282
"1410";12547;157;10161;6;35;48;13;0,230769230769231;0,307692307692308
"1411";12547;157;10162;6;35;52;17;0,230769230769231;0,333333333333333
"1412";12547;157;10163;6;76;88;12;0,487179487179487;0,564102564102564
"1413";12547;157;10164;6;80;104;24;0,512820512820513;0,666666666666667
"1414";12547;157;10165;6;84;104;20;0,538461538461538;0,666666666666667
"1415";12547;157;10166;6;84;108;24;0,538461538461538;0,692307692307692
"1416";12547;157;10167;6;96;108;12;0,615384615384615;0,692307692307692
"1417";12547;157;10168;6;44;56;12;0,282051282051282;0,358974358974359
"1418";12547;157;10169;6;40;52;12;0,256410256410256;0,333333333333333
"1419";12547;157;10170;6;133;149;16;0,846153846153846;0,948717948717949
"1420";12547;157;10171;6;133;153;20;0,846153846153846;0,974358974358974
"1421";12547;157;10172;6;133;157;24;0,846153846153846;1
"1422";12547;157;10173;6;76;92;16;0,487179487179487;0,58974358974359
"1423";12547;157;10174;6;40;56;16;0,256410256410256;0,358974358974359
"1424";12547;157;10175;6;80;108;28;0,512820512820513;0,692307692307692
"1425";12547;157;10176;6;31;48;17;0,205128205128205;0,307692307692308
"1426";12547;157;10177;6;7;19;12;0,0512820512820513;0,128205128205128
"1427";12547;157;10178;6;72;84;12;0,461538461538462;0,538461538461538
"1428";12547;157;10179;6;76;96;20;0,487179487179487;0,615384615384615
"1429";12547;157;10180;6;76;100;24;0,487179487179487;0,641025641025641
"1430";12547;157;10181;6;76;104;28;0,487179487179487;0,666666666666667
"1431";12547;157;10182;6;76;108;32;0,487179487179487;0,692307692307692
"1432";12547;157;10183;6;19;31;12;0,128205128205128;0,205128205128205
"1433";13079;96;10349;3;31;80;49;0,333333333333333;0,833333333333333
"1434";13079;96;10350;3;48;96;48;0,5;1
"1435";13079;96;10351;4;64;88;24;0,666666666666667;0,916666666666667
"1436";13079;96;10352;4;64;96;32;0,666666666666667;1
"1437";13079;96;10353;4;72;96;24;0,75;1
"1438";13079;96;10354;4;31;56;25;0,333333333333333;0,583333333333333
"1439";13079;96;10355;4;56;80;24;0,583333333333333;0,833333333333333
"1440";13079;96;10356;4;56;88;32;0,583333333333333;0,916666666666667
"1441";13079;96;10357;4;56;96;40;0,583333333333333;1
"1442";13079;96;10358;4;7;31;24;0,0833333333333333;0,333333333333333
"1443";13079;96;10359;4;23;48;25;0,25;0,5
"1444";13079;96;10360;5;35;48;13;0,375;0,5
"1445";13079;96;10361;5;64;76;12;0,666666666666667;0,791666666666667
"1446";13079;96;10362;5;64;80;16;0,666666666666667;0,833333333333333
"1447";13079;96;10363;5;72;84;12;0,75;0,875
"1448";13079;96;10364;5;76;88;12;0,791666666666667;0,916666666666667
"1449";13079;96;10365;5;7;19;12;0,0833333333333333;0,208333333333333
"1450";13079;96;10366;5;56;68;12;0,583333333333333;0,708333333333333
"1451";13079;96;10367;5;72;88;16;0,75;0,916666666666667
"1452";13079;96;10368;5;72;92;20;0,75;0,958333333333333
"1453";13079;96;10369;5;76;92;16;0,791666666666667;0,958333333333333
"1454";13079;96;10370;5;76;96;20;0,791666666666667;1
"1455";13079;96;10371;5;68;80;12;0,708333333333333;0,833333333333333
"1456";13079;96;10372;5;72;96;24;0,75;1
"1457";13079;96;10373;5;27;39;12;0,291666666666667;0,416666666666667
"1458";13079;96;10374;5;60;72;12;0,625;0,75
"1459";13079;96;10375;5;60;76;16;0,625;0,791666666666667
"1460";13079;96;10376;5;11;23;12;0,125;0,25
"1461";13079;96;10377;5;23;35;12;0,25;0,375
"1462";13079;96;10378;5;19;31;12;0,208333333333333;0,333333333333333
"1463";13079;96;10379;5;68;84;16;0,708333333333333;0,875
"1464";13079;96;10380;5;68;88;20;0,708333333333333;0,916666666666667
"1465";13079;96;10381;5;64;84;20;0,666666666666667;0,875
"1466";13079;96;10382;5;31;43;12;0,333333333333333;0,458333333333333
"1467";13079;96;10383;5;56;72;16;0,583333333333333;0,75
"1468";13079;96;10384;5;56;76;20;0,583333333333333;0,791666666666667
"1469";13079;96;10385;5;64;88;24;0,666666666666667;0,916666666666667
"1470";13079;96;10386;5;64;92;28;0,666666666666667;0,958333333333333
"1471";13079;96;10387;5;64;96;32;0,666666666666667;1
"1472";13079;96;10388;5;68;92;24;0,708333333333333;0,958333333333333
"1473";13079;96;10389;5;68;96;28;0,708333333333333;1
"1474";13079;96;10390;5;39;52;13;0,416666666666667;0,541666666666667
"1475";13079;96;10391;5;39;56;17;0,416666666666667;0,583333333333333
"1476";13079;96;10392;5;48;60;12;0,5;0,625
"1477";13079;96;10393;5;31;48;17;0,333333333333333;0,5
"1478";13079;96;10394;5;56;80;24;0,583333333333333;0,833333333333333
"1479";13079;96;10395;5;56;84;28;0,583333333333333;0,875
"1480";13079;96;10396;6;66;72;6;0,6875;0,75
"1481";13079;96;10397;6;56;62;6;0,583333333333333;0,645833333333333
"1482";13079;96;10398;6;58;64;6;0,604166666666667;0,666666666666667
"1483";13079;96;10399;6;66;74;8;0,6875;0,770833333333333
"1484";13079;96;10400;6;74;80;6;0,770833333333333;0,833333333333333
"1485";13079;96;10401;6;56;64;8;0,583333333333333;0,666666666666667
"1486";13079;96;10402;6;56;66;10;0,583333333333333;0,6875
"1487";13079;96;10403;6;64;70;6;0,666666666666667;0,729166666666667
"1488";13079;96;10404;6;68;74;6;0,708333333333333;0,770833333333333
"1489";13079;96;10405;6;74;82;8;0,770833333333333;0,854166666666667
"1490";13079;96;10406;6;74;84;10;0,770833333333333;0,875
"1491";13079;96;10407;6;13;19;6;0,145833333333333;0,208333333333333
"1492";13079;96;10408;6;25;31;6;0,270833333333333;0,333333333333333
"1493";13079;96;10409;6;35;41;6;0,375;0,4375
"1494";13079;96;10410;6;37;43;6;0,395833333333333;0,458333333333333
"1495";13079;96;10411;6;37;45;8;0,395833333333333;0,479166666666667
"1496";13079;96;10412;6;39;45;6;0,416666666666667;0,479166666666667
"1497";13079;96;10413;6;39;48;9;0,416666666666667;0,5
"1498";13079;96;10414;6;50;56;6;0,520833333333333;0,583333333333333
"1499";13079;96;10415;6;56;68;12;0,583333333333333;0,708333333333333
"1500";13079;96;10416;6;56;70;14;0,583333333333333;0,729166666666667
"1501";13079;96;10417;6;56;72;16;0,583333333333333;0,75
"1502";13079;96;10418;6;56;74;18;0,583333333333333;0,770833333333333
"1503";13079;96;10419;6;56;76;20;0,583333333333333;0,791666666666667
"1504";13079;96;10420;6;60;66;6;0,625;0,6875
"1505";13079;96;10421;6;60;68;8;0,625;0,708333333333333
"1506";13079;96;10422;6;60;70;10;0,625;0,729166666666667
"1507";13079;96;10423;6;60;72;12;0,625;0,75
"1508";13079;96;10424;6;64;72;8;0,666666666666667;0,75
"1509";13079;96;10425;6;48;54;6;0,5;0,5625
"1510";13079;96;10426;6;48;56;8;0,5;0,583333333333333
"1511";13079;96;10427;6;62;68;6;0,645833333333333;0,708333333333333
"1512";13079;96;10428;6;70;76;6;0,729166666666667;0,791666666666667
"1513";13079;96;10429;6;70;78;8;0,729166666666667;0,8125
"1514";13079;96;10430;6;70;80;10;0,729166666666667;0,833333333333333
"1515";13079;96;10431;6;70;82;12;0,729166666666667;0,854166666666667
"1516";13079;96;10432;6;74;86;12;0,770833333333333;0,895833333333333
"1517";13079;96;10433;6;15;21;6;0,166666666666667;0,229166666666667
"1518";13079;96;10434;6;33;39;6;0,354166666666667;0,416666666666667
"1519";13079;96;10435;6;35;43;8;0,375;0,458333333333333
"1520";13079;96;10436;6;7;13;6;0,0833333333333333;0,145833333333333
"1521";13079;96;10437;6;23;29;6;0,25;0,3125
"1522";13079;96;10438;6;33;41;8;0,354166666666667;0,4375
"1523";13079;96;10439;6;45;52;7;0,479166666666667;0,541666666666667
"1524";13079;96;10440;6;45;54;9;0,479166666666667;0,5625
"1525";13079;96;10441;6;45;56;11;0,479166666666667;0,583333333333333
"1526";13079;96;10442;6;62;70;8;0,645833333333333;0,729166666666667
"1527";13079;96;10443;6;62;72;10;0,645833333333333;0,75
"1528";13079;96;10444;6;62;74;12;0,645833333333333;0,770833333333333
"1529";13079;96;10445;6;64;74;10;0,666666666666667;0,770833333333333
"1530";13079;96;10446;6;31;37;6;0,333333333333333;0,395833333333333
"1531";13079;96;10447;6;60;74;14;0,625;0,770833333333333
"1532";13079;96;10448;6;58;66;8;0,604166666666667;0,6875
"1533";13079;96;10449;6;72;78;6;0,75;0,8125
"1534";13079;96;10450;6;72;80;8;0,75;0,833333333333333
"1535";13079;96;10451;6;21;27;6;0,229166666666667;0,291666666666667
"1536";13079;96;10452;6;62;76;14;0,645833333333333;0,791666666666667
"1537";13079;96;10453;6;31;39;8;0,333333333333333;0,416666666666667
"1538";13079;96;10454;6;37;48;11;0,395833333333333;0,5
"1539";13079;96;10455;6;60;76;16;0,625;0,791666666666667
"1540";13079;96;10456;6;60;78;18;0,625;0,8125
"1541";13079;96;10457;6;60;80;20;0,625;0,833333333333333
"1542";13079;96;10458;6;62;78;16;0,645833333333333;0,8125
"1543";13079;96;10459;6;62;80;18;0,645833333333333;0,833333333333333
"1544";13079;96;10460;6;62;82;20;0,645833333333333;0,854166666666667
"1545";13079;96;10461;6;64;76;12;0,666666666666667;0,791666666666667
"1546";13079;96;10462;6;64;78;14;0,666666666666667;0,8125
"1547";13079;96;10463;6;64;80;16;0,666666666666667;0,833333333333333
"1548";13079;96;10464;6;64;82;18;0,666666666666667;0,854166666666667
"1549";13079;96;10465;6;74;88;14;0,770833333333333;0,916666666666667
"1550";13079;96;10466;6;74;90;16;0,770833333333333;0,9375
"1551";13079;96;10467;6;74;92;18;0,770833333333333;0,958333333333333
"1552";13079;96;10468;6;74;94;20;0,770833333333333;0,979166666666667
"1553";13079;96;10469;6;66;76;10;0,6875;0,791666666666667
"1554";13079;96;10470;6;72;82;10;0,75;0,854166666666667
"1555";13079;96;10471;6;35;45;10;0,375;0,479166666666667
"1556";13079;96;10472;6;60;82;22;0,625;0,854166666666667
"1557";13079;96;10473;6;60;84;24;0,625;0,875
"1558";13079;96;10474;6;60;86;26;0,625;0,895833333333333
"1559";13079;96;10475;6;62;84;22;0,645833333333333;0,875
"1560";13079;96;10476;6;62;86;24;0,645833333333333;0,895833333333333
"1561";13079;96;10477;6;62;88;26;0,645833333333333;0,916666666666667
"1562";13079;96;10478;6;64;84;20;0,666666666666667;0,875
"1563";13079;96;10479;6;64;86;22;0,666666666666667;0,895833333333333
"1564";13079;96;10480;6;64;88;24;0,666666666666667;0,916666666666667
"1565";13079;96;10481;6;66;78;12;0,6875;0,8125
"1566";13079;96;10482;6;68;76;8;0,708333333333333;0,791666666666667
"1567";13079;96;10483;6;68;78;10;0,708333333333333;0,8125
"1568";13079;96;10484;6;70;84;14;0,729166666666667;0,875
"1569";13079;96;10485;6;70;86;16;0,729166666666667;0,895833333333333
"1570";13079;96;10486;6;70;88;18;0,729166666666667;0,916666666666667
"1571";13079;96;10487;6;52;58;6;0,541666666666667;0,604166666666667
"1572";13079;96;10488;6;58;68;10;0,604166666666667;0,708333333333333
"1573";13079;96;10489;6;58;70;12;0,604166666666667;0,729166666666667
"1574";13079;96;10490;6;29;35;6;0,3125;0,375
"1575";13079;96;10491;6;21;29;8;0,229166666666667;0,3125
"1576";13079;96;10492;6;43;50;7;0,458333333333333;0,520833333333333
"1577";13079;96;10493;6;29;37;8;0,3125;0,395833333333333
"1578";13079;96;10494;6;64;90;26;0,666666666666667;0,9375
"1579";15700;136;11011;4;85;136;51;0,625;1
"1580";15700;136;11012;5;112;136;24;0,823529411764706;1
"1581";15700;136;11013;5;88;112;24;0,647058823529412;0,823529411764706
"1582";15700;136;11014;5;96;120;24;0,705882352941177;0,882352941176471
"1583";15700;136;11015;5;96;128;32;0,705882352941177;0,941176470588235
"1584";15700;136;11016;5;104;128;24;0,764705882352941;0,941176470588235
"1585";15700;136;11017;5;104;136;32;0,764705882352941;1
"1586";15700;136;11018;5;96;136;40;0,705882352941177;1
"1587";15700;136;11019;5;47;72;25;0,352941176470588;0,529411764705882
"1588";15700;136;11020;6;96;108;12;0,705882352941177;0,794117647058823
"1589";15700;136;11021;6;112;124;12;0,823529411764706;0,911764705882353
"1590";15700;136;11022;6;116;128;12;0,852941176470588;0,941176470588235
"1591";15700;136;11023;6;120;132;12;0,882352941176471;0,970588235294118
"1592";15700;136;11024;6;96;112;16;0,705882352941177;0,823529411764706
"1593";15700;136;11025;6;100;112;12;0,735294117647059;0,823529411764706
"1594";15700;136;11026;6;100;116;16;0,735294117647059;0,852941176470588
"1595";15700;136;11027;6;112;128;16;0,823529411764706;0,941176470588235
"1596";15700;136;11028;6;112;132;20;0,823529411764706;0,970588235294118
"1597";15700;136;11029;6;116;132;16;0,852941176470588;0,970588235294118
"1598";15700;136;11030;6;35;47;12;0,264705882352941;0,352941176470588
"1599";15700;136;11031;6;84;96;12;0,617647058823529;0,705882352941177
"1600";15700;136;11032;6;120;136;16;0,882352941176471;1
"1601";15700;136;11033;6;100;120;20;0,735294117647059;0,882352941176471
"1602";15700;136;11034;6;100;124;24;0,735294117647059;0,911764705882353
"1603";15700;136;11035;6;100;128;28;0,735294117647059;0,941176470588235
"1604";15700;136;11036;6;100;132;32;0,735294117647059;0,970588235294118
"1605";15700;136;11037;6;104;116;12;0,764705882352941;0,852941176470588
"1606";15700;136;11038;6;108;120;12;0,794117647058823;0,882352941176471
"1607";15700;136;11039;6;108;124;16;0,794117647058823;0,911764705882353
"1608";15700;136;11040;6;108;128;20;0,794117647058823;0,941176470588235
"1609";15700;136;11041;6;108;132;24;0,794117647058823;0,970588235294118
"1610";15700;136;11042;6;108;136;28;0,794117647058823;1
"1611";15700;136;11043;6;112;136;24;0,823529411764706;1
"1612";15700;136;11044;6;116;136;20;0,852941176470588;1
"1613";15700;136;11045;6;51;63;12;0,382352941176471;0,470588235294118
"1614";15700;136;11046;6;96;116;20;0,705882352941177;0,852941176470588
"1615";15700;136;11047;6;104;120;16;0,764705882352941;0,882352941176471
"1616";15700;136;11048;6;31;43;12;0,235294117647059;0,323529411764706
"1617";15700;136;11049;6;55;68;13;0,411764705882353;0,5
"1618";15700;136;11050;6;88;100;12;0,647058823529412;0,735294117647059
"1619";15700;136;11051;6;96;120;24;0,705882352941177;0,882352941176471
"1620";15700;136;11052;6;96;124;28;0,705882352941177;0,911764705882353
"1621";15700;136;11053;6;92;104;12;0,676470588235294;0,764705882352941
"1622";15700;136;11054;6;104;124;20;0,764705882352941;0,911764705882353
"1623";16025;92;11149;4;67;92;25;0,727272727272727;1
"1624";16025;92;11150;4;58;84;26;0,636363636363636;0,909090909090909
"1625";16025;92;11151;4;58;92;34;0,636363636363636;1
"1626";16025;92;11152;5;64;76;12;0,695652173913043;0,826086956521739
"1627";16025;92;11153;5;68;80;12;0,739130434782609;0,869565217391304
"1628";16025;92;11154;5;68;84;16;0,739130434782609;0,91304347826087
"1629";16025;92;11155;5;68;88;20;0,739130434782609;0,956521739130435
"1630";16025;92;11156;5;64;80;16;0,695652173913043;0,869565217391304
"1631";16025;92;11157;5;64;84;20;0,695652173913043;0,91304347826087
"1632";16025;92;11158;5;64;88;24;0,695652173913043;0,956521739130435
"1633";16025;92;11159;5;64;92;28;0,695652173913043;1
"1634";16025;92;11160;5;68;92;24;0,739130434782609;1
"1635";16025;92;11161;5;72;84;12;0,782608695652174;0,91304347826087
"1636";16025;92;11162;5;72;88;16;0,782608695652174;0,956521739130435
"1637";16025;92;11163;5;72;92;20;0,782608695652174;1
"1638";16025;92;11164;5;76;88;12;0,826086956521739;0,956521739130435
"1639";16025;92;11165;5;76;92;16;0,826086956521739;1
"1640";16025;92;11166;5;43;56;13;0,478260869565217;0,608695652173913
"1641";16025;92;11167;5;56;68;12;0,608695652173913;0,739130434782609
"1642";16025;92;11168;5;60;72;12;0,652173913043478;0,782608695652174
"1643";16025;92;11169;5;60;76;16;0,652173913043478;0,826086956521739
"1644";16025;92;11170;5;60;80;20;0,652173913043478;0,869565217391304
"1645";16025;92;11171;5;60;84;24;0,652173913043478;0,91304347826087
"1646";16025;92;11172;5;39;52;13;0,434782608695652;0,565217391304348
"1647";16025;92;11173;6;11;17;6;0,130434782608696;0,195652173913043
"1648";16025;92;11174;6;58;64;6;0,630434782608696;0,695652173913043
"1649";16025;92;11175;6;64;70;6;0,695652173913043;0,760869565217391
"1650";16025;92;11176;6;64;72;8;0,695652173913043;0,782608695652174
"1651";16025;92;11177;6;64;74;10;0,695652173913043;0,804347826086957
"1652";16025;92;11178;6;64;76;12;0,695652173913043;0,826086956521739
"1653";16025;92;11179;6;64;78;14;0,695652173913043;0,847826086956522
"1654";16025;92;11180;6;66;72;6;0,717391304347826;0,782608695652174
"1655";16025;92;11181;6;66;74;8;0,717391304347826;0,804347826086957
"1656";16025;92;11182;6;66;76;10;0,717391304347826;0,826086956521739
"1657";16025;92;11183;6;66;78;12;0,717391304347826;0,847826086956522
"1658";16025;92;11184;6;68;74;6;0,739130434782609;0,804347826086957
"1659";16025;92;11185;6;68;76;8;0,739130434782609;0,826086956521739
"1660";16025;92;11186;6;68;78;10;0,739130434782609;0,847826086956522
"1661";16025;92;11187;6;68;80;12;0,739130434782609;0,869565217391304
"1662";16025;92;11188;6;70;76;6;0,760869565217391;0,826086956521739
"1663";16025;92;11189;6;70;78;8;0,760869565217391;0,847826086956522
"1664";16025;92;11190;6;70;80;10;0,760869565217391;0,869565217391304
"1665";16025;92;11191;6;70;82;12;0,760869565217391;0,891304347826087
"1666";16025;92;11192;6;72;78;6;0,782608695652174;0,847826086956522
"1667";16025;92;11193;6;72;80;8;0,782608695652174;0,869565217391304
"1668";16025;92;11194;6;72;82;10;0,782608695652174;0,891304347826087
"1669";16025;92;11195;6;72;84;12;0,782608695652174;0,91304347826087
"1670";16025;92;11196;6;74;80;6;0,804347826086957;0,869565217391304
"1671";16025;92;11197;6;74;82;8;0,804347826086957;0,891304347826087
"1672";16025;92;11198;6;76;82;6;0,826086956521739;0,891304347826087
"1673";16025;92;11199;6;76;84;8;0,826086956521739;0,91304347826087
"1674";16025;92;11200;6;39;46;7;0,434782608695652;0,5
"1675";16025;92;11201;6;66;80;14;0,717391304347826;0,869565217391304
"1676";16025;92;11202;6;66;82;16;0,717391304347826;0,891304347826087
"1677";16025;92;11203;6;66;84;18;0,717391304347826;0,91304347826087
"1678";16025;92;11204;6;66;86;20;0,717391304347826;0,934782608695652
"1679";16025;92;11205;6;66;88;22;0,717391304347826;0,956521739130435
"1680";16025;92;11206;6;66;90;24;0,717391304347826;0,978260869565217
"1681";16025;92;11207;6;68;82;14;0,739130434782609;0,891304347826087
"1682";16025;92;11208;6;68;84;16;0,739130434782609;0,91304347826087
"1683";16025;92;11209;6;68;86;18;0,739130434782609;0,934782608695652
"1684";16025;92;11210;6;68;88;20;0,739130434782609;0,956521739130435
"1685";16025;92;11211;6;68;90;22;0,739130434782609;0,978260869565217
"1686";16025;92;11212;6;70;84;14;0,760869565217391;0,91304347826087
"1687";16025;92;11213;6;70;86;16;0,760869565217391;0,934782608695652
"1688";16025;92;11214;6;70;88;18;0,760869565217391;0,956521739130435
"1689";16025;92;11215;6;70;90;20;0,760869565217391;0,978260869565217
"1690";16025;92;11216;6;74;84;10;0,804347826086957;0,91304347826087
"1691";16025;92;11217;6;74;86;12;0,804347826086957;0,934782608695652
"1692";16025;92;11218;6;74;88;14;0,804347826086957;0,956521739130435
"1693";16025;92;11219;6;74;90;16;0,804347826086957;0,978260869565217
"1694";16025;92;11220;6;9;15;6;0,108695652173913;0,173913043478261
"1695";16025;92;11221;6;9;17;8;0,108695652173913;0,195652173913043
"1696";16025;92;11222;6;46;52;6;0,5;0,565217391304348
"1697";16025;92;11223;6;43;50;7;0,478260869565217;0,543478260869565
"1698";16025;92;11224;6;43;52;9;0,478260869565217;0,565217391304348
"1699";16025;92;11225;6;72;86;14;0,782608695652174;0,934782608695652
"1700";16025;92;11226;6;50;56;6;0,543478260869565;0,608695652173913
"1701";16025;92;11227;6;56;62;6;0,608695652173913;0,673913043478261
"1702";16025;92;11228;6;56;64;8;0,608695652173913;0,695652173913043
"1703";16025;92;11229;6;46;54;8;0,5;0,58695652173913
"1704";16025;92;11230;6;76;86;10;0,826086956521739;0,934782608695652
"1705";16025;92;11231;6;76;88;12;0,826086956521739;0,956521739130435
"1706";16025;92;11232;6;37;43;6;0,41304347826087;0,478260869565217
"1707";16025;92;11233;6;64;80;16;0,695652173913043;0,869565217391304
"1708";16025;92;11234;6;64;82;18;0,695652173913043;0,891304347826087
"1709";16025;92;11235;6;72;88;16;0,782608695652174;0,956521739130435
"1710";16025;92;11236;6;64;84;20;0,695652173913043;0,91304347826087
"1711";16025;92;11237;6;64;86;22;0,695652173913043;0,934782608695652
"1712";16025;92;11238;6;74;92;18;0,804347826086957;1
"1713";16025;92;11239;6;76;90;14;0,826086956521739;0,978260869565217
"1714";16025;92;11240;6;76;92;16;0,826086956521739;1
"1715";16025;92;11241;6;62;68;6;0,673913043478261;0,739130434782609
"1716";16025;92;11242;6;66;92;26;0,717391304347826;1
"1717";16025;92;11243;6;68;92;24;0,739130434782609;1
"1718";16025;92;11244;6;70;92;22;0,760869565217391;1
"1719";16025;92;11245;6;72;90;18;0,782608695652174;0,978260869565217
"1720";16025;92;11246;6;72;92;20;0,782608695652174;1
"1721";16025;92;11247;6;48;54;6;0,521739130434783;0,58695652173913
"1722";16025;92;11248;6;64;88;24;0,695652173913043;0,956521739130435
"1723";16025;92;11249;6;64;90;26;0,695652173913043;0,978260869565217
"1724";16025;92;11250;6;64;92;28;0,695652173913043;1
"1725";19596;62;11768;3;35;62;27;0,571428571428571;1
"1726";19596;62;11769;4;41;54;13;0,666666666666667;0,866666666666667
"1727";19596;62;11770;4;41;58;17;0,666666666666667;0,933333333333333
"1728";19596;62;11771;4;41;62;21;0,666666666666667;1
"1729";19596;62;11772;4;37;49;12;0,6;0,8
"1730";19596;62;11773;4;37;54;17;0,6;0,866666666666667
"1731";19596;62;11774;4;37;58;21;0,6;0,933333333333333
"1732";19596;62;11775;4;24;37;13;0,4;0,6
"1733";19596;62;11776;5;40;46;6;0,645161290322581;0,741935483870968
"1734";19596;62;11777;5;40;48;8;0,645161290322581;0,774193548387097
"1735";19596;62;11778;5;40;50;10;0,645161290322581;0,806451612903226
"1736";19596;62;11779;5;3;9;6;0,0645161290322581;0,161290322580645
"1737";19596;62;11780;5;5;11;6;0,0967741935483871;0,193548387096774
"1738";19596;62;11781;5;32;38;6;0,516129032258065;0,612903225806452
"1739";19596;62;11782;5;29;36;7;0,483870967741935;0,580645161290323
"1740";19596;62;11783;5;40;52;12;0,645161290322581;0,838709677419355
"1741";19596;62;11784;5;40;54;14;0,645161290322581;0,870967741935484
"1742";19596;62;11785;5;40;56;16;0,645161290322581;0,903225806451613
"1743";19596;62;11786;5;40;58;18;0,645161290322581;0,935483870967742
"1744";19596;62;11787;5;40;60;20;0,645161290322581;0,967741935483871
"1745";19596;62;11788;5;40;62;22;0,645161290322581;1
"1746";19596;62;11789;5;42;48;6;0,67741935483871;0,774193548387097
"1747";19596;62;11790;5;42;50;8;0,67741935483871;0,806451612903226
"1748";19596;62;11791;5;42;52;10;0,67741935483871;0,838709677419355
"1749";19596;62;11792;5;42;54;12;0,67741935483871;0,870967741935484
"1750";19596;62;11793;5;42;56;14;0,67741935483871;0,903225806451613
"1751";19596;62;11794;5;42;58;16;0,67741935483871;0,935483870967742
"1752";19596;62;11795;5;7;13;6;0,129032258064516;0,225806451612903
"1753";19596;62;11796;5;11;17;6;0,193548387096774;0,290322580645161
"1754";19596;62;11797;5;3;11;8;0,0645161290322581;0,193548387096774
"1755";19596;62;11798;5;9;15;6;0,161290322580645;0,258064516129032
"1756";19596;62;11799;5;27;34;7;0,451612903225806;0,548387096774194
"1757";19596;62;11800;5;1;7;6;0,032258064516129;0,129032258064516
"1758";19596;62;11801;5;42;60;18;0,67741935483871;0,967741935483871
"1759";19596;62;11802;5;42;62;20;0,67741935483871;1
"1760";19596;62;11803;5;17;23;6;0,290322580645161;0,387096774193548
"1761";19596;62;11804;5;19;25;6;0,32258064516129;0,419354838709677
"1762";21585;79;11964;4;55;79;24;0,7;1
"1763";21585;79;11965;4;47;71;24;0,6;0,9
"1764";21585;79;11966;4;47;79;32;0,6;1
"1765";21585;79;11967;5;55;67;12;0,7;0,85
"1766";21585;79;11968;5;3;15;12;0,05;0,2
"1767";21585;79;11969;5;3;19;16;0,05;0,25
"1768";21585;79;11970;5;3;23;20;0,05;0,3
"1769";21585;79;11971;5;59;71;12;0,75;0,9
"1770";21585;79;11972;5;59;75;16;0,75;0,95
"1771";21585;79;11973;5;63;75;12;0,8;0,95
"1772";21585;79;11974;5;63;79;16;0,8;1
"1773";21585;79;11975;5;43;55;12;0,55;0,7
"1774";21585;79;11976;5;59;79;20;0,75;1
"1775";21585;79;11977;5;55;71;16;0,7;0,9
"1776";21585;79;11978;5;55;75;20;0,7;0,95
"1777";21585;79;11979;5;55;79;24;0,7;1
"1778";21585;79;11980;5;47;59;12;0,6;0,75
"1779";21585;79;11981;6;1;7;6;0,025;0,1
"1780";21585;79;11982;6;1;9;8;0,025;0,125
"1781";21585;79;11983;6;1;11;10;0,025;0,15
"1782";21585;79;11984;6;47;53;6;0,6;0,675
"1783";21585;79;11985;6;47;55;8;0,6;0,7
"1784";21585;79;11986;6;49;55;6;0,625;0,7
"1785";21585;79;11987;6;55;61;6;0,7;0,775
"1786";21585;79;11988;6;61;67;6;0,775;0,85
"1787";21585;79;11989;6;61;69;8;0,775;0,875
"1788";21585;79;11990;6;61;71;10;0,775;0,9
"1789";21585;79;11991;6;1;13;12;0,025;0,175
"1790";21585;79;11992;6;1;15;14;0,025;0,2
"1791";21585;79;11993;6;1;17;16;0,025;0,225
"1792";21585;79;11994;6;1;19;18;0,025;0,25
"1793";21585;79;11995;6;33;39;6;0,425;0,5
"1794";21585;79;11996;6;33;41;8;0,425;0,525
"1795";21585;79;11997;6;33;43;10;0,425;0,55
"1796";21585;79;11998;6;61;73;12;0,775;0,925
"1797";21585;79;11999;6;35;41;6;0,45;0,525
"1798";21585;79;12000;6;35;43;8;0,45;0,55
"1799";21585;79;12001;6;35;45;10;0,45;0,575
"1800";21585;79;12002;6;45;51;6;0,575;0,65
"1801";21585;79;12003;6;61;75;14;0,775;0,95
"1802";21585;79;12004;6;61;77;16;0,775;0,975
"1803";21585;79;12005;6;61;79;18;0,775;1
"1804";21585;79;12006;6;55;63;8;0,7;0,8
"1805";21585;79;12007;6;1;21;20;0,025;0,275
"1806";21585;79;12008;6;1;23;22;0,025;0,3
"1807";21585;79;12009;6;45;53;8;0,575;0,675
"1808";21585;79;12010;6;57;63;6;0,725;0,8
"1809";21585;79;12011;6;57;65;8;0,725;0,825
"1810";21585;79;12012;6;57;67;10;0,725;0,85
"1811";21585;79;12013;6;57;69;12;0,725;0,875
"1812";21585;79;12014;6;57;71;14;0,725;0,9
"1813";21585;79;12015;6;33;45;12;0,425;0,575
"1814";25037;59;12095;3;33;59;26;0,571428571428571;1
"1815";25037;59;12096;4;27;39;12;0,466666666666667;0,666666666666667
"1816";25037;59;12097;4;43;55;12;0,733333333333333;0,933333333333333
"1817";25037;59;12098;4;43;59;16;0,733333333333333;1
"1818";25037;59;12099;4;39;51;12;0,666666666666667;0,866666666666667
"1819";25037;59;12100;4;11;23;12;0,2;0,4
"1820";25037;59;12101;4;23;35;12;0,4;0,6
"1821";25037;59;12102;4;7;19;12;0,133333333333333;0,333333333333333
"1822";25037;59;12103;4;15;27;12;0,266666666666667;0,466666666666667
"1823";25037;59;12104;4;39;55;16;0,666666666666667;0,933333333333333
"1824";25037;59;12105;4;39;59;20;0,666666666666667;1
"1825";25037;59;12106;5;39;45;6;0,666666666666667;0,766666666666667
"1826";25037;59;12107;5;13;19;6;0,233333333333333;0,333333333333333
"1827";25037;59;12108;5;21;27;6;0,366666666666667;0,466666666666667
"1828";25037;59;12109;5;41;47;6;0,7;0,8
"1829";25037;59;12110;5;41;49;8;0,7;0,833333333333333
"1830";25037;59;12111;5;23;29;6;0,4;0,5
"1831";25037;59;12112;5;11;17;6;0,2;0,3
"1832";25037;59;12113;5;25;31;6;0,433333333333333;0,533333333333333
"1833";25037;59;12114;5;27;33;6;0,466666666666667;0,566666666666667
"1834";25037;59;12115;5;25;33;8;0,433333333333333;0,566666666666667
"1835";25037;59;12116;5;27;35;8;0,466666666666667;0,6
"1836";25037;59;12117;5;29;35;6;0,5;0,6
"1837";25037;59;12118;5;41;51;10;0,7;0,866666666666667
"1838";25037;59;12119;5;11;19;8;0,2;0,333333333333333
"1839";25037;59;12120;5;41;53;12;0,7;0,9
"1840";25037;59;12121;5;41;55;14;0,7;0,933333333333333
"1841";25037;59;12122;5;5;11;6;0,1;0,2
"1842";25037;59;12123;5;9;15;6;0,166666666666667;0,266666666666667
"1843";25037;59;12124;5;33;39;6;0,566666666666667;0,666666666666667
"1844";25037;59;12125;5;41;57;16;0,7;0,966666666666667
"1845";25037;59;12126;5;31;37;6;0,533333333333333;0,633333333333333
"1846";25037;59;12127;5;39;47;8;0,666666666666667;0,8
"1847";25037;59;12128;5;39;49;10;0,666666666666667;0,833333333333333
"1848";25037;59;12129;5;41;59;18;0,7;1
"1849";25037;59;12130;5;23;31;8;0,4;0,533333333333333
"1850";31992;46;13571;3;18;46;28;0,4;1
"1851";31992;46;13572;3;8;37;29;0,2;0,8
"1852";31992;46;13573;3;8;46;38;0,2;1
"1853";31992;46;13574;4;29;42;13;0,636363636363636;0,909090909090909
"1854";31992;46;13575;4;16;29;13;0,363636363636364;0,636363636363636
"1855";31992;46;13576;4;16;33;17;0,363636363636364;0,727272727272727
"1856";31992;46;13577;4;16;37;21;0,363636363636364;0,818181818181818
"1857";31992;46;13578;4;16;42;26;0,363636363636364;0,909090909090909
"1858";31992;46;13579;4;16;46;30;0,363636363636364;1
"1859";31992;46;13580;4;29;46;17;0,636363636363636;1
"1860";31992;46;13581;4;12;25;13;0,272727272727273;0,545454545454545
"1861";31992;46;13582;4;12;29;17;0,272727272727273;0,636363636363636
"1862";31992;46;13583;4;3;16;13;0,0909090909090909;0,363636363636364
"1863";31992;46;13584;5;30;36;6;0,652173913043478;0,782608695652174
"1864";31992;46;13585;5;17;24;7;0,391304347826087;0,521739130434783
"1865";31992;46;13586;5;17;26;9;0,391304347826087;0,565217391304348
"1866";31992;46;13587;5;17;28;11;0,391304347826087;0,608695652173913
"1867";31992;46;13588;5;17;30;13;0,391304347826087;0,652173913043478
"1868";31992;46;13589;5;17;32;15;0,391304347826087;0,695652173913043
"1869";31992;46;13590;5;30;38;8;0,652173913043478;0,826086956521739
"1870";31992;46;13591;5;30;40;10;0,652173913043478;0,869565217391304
"1871";31992;46;13592;5;30;42;12;0,652173913043478;0,91304347826087
"1872";31992;46;13593;5;30;44;14;0,652173913043478;0,956521739130435
"1873";31992;46;13594;5;17;34;17;0,391304347826087;0,739130434782609
"1874";31992;46;13595;5;13;19;6;0,304347826086957;0,434782608695652
"1875";31992;46;13596;5;3;9;6;0,0869565217391304;0,217391304347826
"1876";31992;46;13597;5;5;11;6;0,130434782608696;0,260869565217391
"1877";31992;46;13598;5;15;21;6;0,347826086956522;0,478260869565217
"1878";31992;46;13599;5;11;17;6;0,260869565217391;0,391304347826087
"1879";31992;46;13600;5;30;46;16;0,652173913043478;1
"1880";31992;46;13601;5;17;36;19;0,391304347826087;0,782608695652174
"1881";31992;46;13602;5;17;38;21;0,391304347826087;0,826086956521739
"1882";31992;46;13603;5;17;40;23;0,391304347826087;0,869565217391304
"1883";31992;46;13604;5;17;42;25;0,391304347826087;0,91304347826087
"1884";31992;46;13605;5;17;44;27;0,391304347826087;0,956521739130435
"1885";31992;46;13606;5;1;7;6;0,0434782608695652;0,173913043478261
"1886";31992;46;13607;5;17;46;29;0,391304347826087;1
"1887";31992;46;13608;5;15;24;9;0,347826086956522;0,521739130434783
"1888";41745;100;14118;3;50;100;50;0,5;1
"1889";41745;100;14119;4;58;83;25;0,583333333333333;0,833333333333333
"1890";41745;100;14120;4;58;92;34;0,583333333333333;0,916666666666667
"1891";41745;100;14121;4;58;100;42;0,583333333333333;1
"1892";41745;100;14122;4;75;100;25;0,75;1
"1893";41745;100;14123;5;60;72;12;0,6;0,72
"1894";41745;100;14124;5;60;76;16;0,6;0,76
"1895";41745;100;14125;5;60;80;20;0,6;0,8
"1896";41745;100;14126;5;76;88;12;0,76;0,88
"1897";41745;100;14127;5;80;92;12;0,8;0,92
"1898";41745;100;14128;5;80;96;16;0,8;0,96
"1899";41745;100;14129;5;80;100;20;0,8;1
"1900";41745;100;14130;5;76;92;16;0,76;0,92
"1901";41745;100;14131;5;76;96;20;0,76;0,96
"1902";41745;100;14132;5;43;56;13;0,44;0,56
"1903";41745;100;14133;5;60;84;24;0,6;0,84
"1904";41745;100;14134;5;60;88;28;0,6;0,88
"1905";41745;100;14135;5;60;92;32;0,6;0,92
"1906";41745;100;14136;5;60;96;36;0,6;0,96
"1907";41745;100;14137;5;60;100;40;0,6;1
"1908";41745;100;14138;5;76;100;24;0,76;1
"1909";41745;100;14139;5;3;15;12;0,04;0,16
"1910";41745;100;14140;6;7;13;6;0,08;0,14
"1911";41745;100;14141;6;60;66;6;0,6;0,66
"1912";41745;100;14142;6;60;68;8;0,6;0,68
"1913";41745;100;14143;6;60;70;10;0,6;0,7
"1914";41745;100;14144;6;78;84;6;0,78;0,84
"1915";41745;100;14145;6;78;86;8;0,78;0,86
"1916";41745;100;14146;6;78;88;10;0,78;0,88
"1917";41745;100;14147;6;41;47;6;0,42;0,48
"1918";41745;100;14148;6;60;72;12;0,6;0,72
"1919";41745;100;14149;6;60;74;14;0,6;0,74
"1920";41745;100;14150;6;60;76;16;0,6;0,76
"1921";41745;100;14151;6;60;78;18;0,6;0,78
"1922";41745;100;14152;6;60;80;20;0,6;0,8
"1923";41745;100;14153;6;78;90;12;0,78;0,9
"1924";41745;100;14154;6;78;92;14;0,78;0,92
"1925";41745;100;14155;6;78;94;16;0,78;0,94
"1926";41745;100;14156;6;78;96;18;0,78;0,96
"1927";41745;100;14157;6;78;98;20;0,78;0,98
"1928";41745;100;14158;6;15;21;6;0,16;0,22
"1929";41745;100;14159;6;60;82;22;0,6;0,82
"1930";41745;100;14160;6;5;11;6;0,06;0,12
"1931";41745;100;14161;6;41;50;9;0,42;0,5
"1932";41745;100;14162;6;19;25;6;0,2;0,26
"1933";41745;100;14163;6;78;100;22;0,78;1
"1934";41745;100;14164;6;13;19;6;0,14;0,2
"1935";41745;100;14165;6;58;64;6;0,58;0,64
"1936";41745;100;14166;6;58;66;8;0,58;0,66
"1937";41745;100;14167;6;5;13;8;0,06;0,14
"1938";41745;100;14168;6;41;52;11;0,42;0,52
"1939";41745;100;14169;6;41;54;13;0,42;0,54
"1940";41745;100;14170;6;41;56;15;0,42;0,56
"1941";41745;100;14171;6;60;84;24;0,6;0,84
"1942";41745;100;14172;6;60;86;26;0,6;0,86
"1943";41745;100;14173;6;60;88;28;0,6;0,88
"1944";41745;100;14174;6;60;90;30;0,6;0,9
"1945";41745;100;14175;6;39;45;6;0,4;0,46
"1946";41745;100;14176;6;39;47;8;0,4;0,48
"1947";41745;100;14177;6;39;50;11;0,4;0,5
"1948";41745;100;14178;6;41;58;17;0,42;0,58
"1949";41745;100;14179;6;3;9;6;0,04;0,1
"1950";82358;79;14733;4;31;55;24;0,4;0,7
"1951";82358;79;14734;4;23;47;24;0,3;0,6
"1952";82358;79;14735;4;55;79;24;0,7;1
"1953";82358;79;14736;5;39;51;12;0,5;0,65
"1954";82358;79;14737;5;55;67;12;0,7;0,85
"1955";82358;79;14738;5;59;71;12;0,75;0,9
"1956";82358;79;14739;5;3;15;12;0,05;0,2
"1957";82358;79;14740;5;31;43;12;0,4;0,55
"1958";82358;79;14741;5;31;47;16;0,4;0,6
"1959";82358;79;14742;5;35;47;12;0,45;0,6
"1960";82358;79;14743;5;35;51;16;0,45;0,65
"1961";82358;79;14744;5;39;55;16;0,5;0,7
"1962";82358;79;14745;5;27;39;12;0,35;0,5
"1963";82358;79;14746;5;43;55;12;0,55;0,7
"1964";82358;79;14747;5;55;71;16;0,7;0,9
"1965";82358;79;14748;5;55;75;20;0,7;0,95
"1966";82358;79;14749;5;55;79;24;0,7;1
"1967";82358;79;14750;5;59;75;16;0,75;0,95
"1968";82358;79;14751;5;59;79;20;0,75;1
"1969";82358;79;14752;5;7;19;12;0,1;0,25
"1970";82358;79;14753;5;35;55;20;0,45;0,7
"1971";82358;79;14754;5;27;43;16;0,35;0,55
"1972";82358;79;14755;5;31;51;20;0,4;0,65
"1973";82358;79;14756;5;31;55;24;0,4;0,7
"1974";82358;79;14757;5;3;19;16;0,05;0,25
"1975";82358;79;14758;6;3;9;6;0,05;0,125
"1976";82358;79;14759;6;5;11;6;0,075;0,15
"1977";82358;79;14760;6;37;43;6;0,475;0,55
"1978";82358;79;14761;6;39;45;6;0,5;0,575
"1979";82358;79;14762;6;45;51;6;0,575;0,65
"1980";82358;79;14763;6;57;63;6;0,725;0,8
"1981";82358;79;14764;6;59;65;6;0,75;0,825
"1982";82358;79;14765;6;5;13;8;0,075;0,175
"1983";82358;79;14766;6;5;15;10;0,075;0,2
"1984";82358;79;14767;6;29;35;6;0,375;0,45
"1985";82358;79;14768;6;29;37;8;0,375;0,475
"1986";82358;79;14769;6;37;45;8;0,475;0,575
"1987";82358;79;14770;6;37;47;10;0,475;0,6
"1988";82358;79;14771;6;37;49;12;0,475;0,625
"1989";82358;79;14772;6;45;53;8;0,575;0,675
"1990";82358;79;14773;6;45;55;10;0,575;0,7
"1991";82358;79;14774;6;57;65;8;0,725;0,825
"1992";82358;79;14775;6;57;67;10;0,725;0,85
"1993";82358;79;14776;6;57;69;12;0,725;0,875
"1994";82358;79;14777;6;59;67;8;0,75;0,85
"1995";82358;79;14778;6;59;69;10;0,75;0,875
"1996";82358;79;14779;6;3;11;8;0,05;0,15
"1997";82358;79;14780;6;3;13;10;0,05;0,175
"1998";82358;79;14781;6;37;51;14;0,475;0,65
"1999";82358;79;14782;6;37;53;16;0,475;0,675
"2000";82358;79;14783;6;37;55;18;0,475;0,7
"2001";82358;79;14784;6;39;47;8;0,5;0,6
"2002";82358;79;14785;6;39;49;10;0,5;0,625
"2003";82358;79;14786;6;39;51;12;0,5;0,65
"2004";82358;79;14787;6;39;53;14;0,5;0,675
"2005";82358;79;14788;6;39;55;16;0,5;0,7
"2006";82358;79;14789;6;57;71;14;0,725;0,9
"2007";82358;79;14790;6;57;73;16;0,725;0,925
"2008";82358;79;14791;6;57;75;18;0,725;0,95
"2009";82358;79;14792;6;57;77;20;0,725;0,975
"2010";82358;79;14793;6;59;71;12;0,75;0,9
"2011";82358;79;14794;6;59;73;14;0,75;0,925
"2012";82358;79;14795;6;57;79;22;0,725;1
"2013";82358;79;14796;6;59;75;16;0,75;0,95
"2014";82358;79;14797;6;59;77;18;0,75;0,975
"2015";82358;79;14798;6;59;79;20;0,75;1
"2016";82358;79;14799;6;27;33;6;0,35;0,425
"2017";82358;79;14800;6;35;41;6;0,45;0,525
"2018";82358;79;14801;6;35;43;8;0,45;0,55
"2019";82358;79;14802;6;35;45;10;0,45;0,575
"2020";82358;79;14803;6;35;47;12;0,45;0,6
"2021";82358;79;14804;6;3;15;12;0,05;0,2
"2022";82358;79;14805;6;25;31;6;0,325;0,4
"2023";82358;79;14806;6;31;37;6;0,4;0,475
"2024";82358;79;14807;6;55;61;6;0,7;0,775
"2025";82358;79;14808;6;55;63;8;0,7;0,8
"2026";82358;79;14809;6;55;65;10;0,7;0,825
"2027";82358;79;14810;6;55;67;12;0,7;0,85
"2028";82358;79;14811;6;55;69;14;0,7;0,875
"2029";83356;55;14812;3;31;55;24;0,571428571428571;1
"2030";83356;55;14813;4;27;39;12;0,5;0,714285714285714
"2031";83356;55;14814;4;27;43;16;0,5;0,785714285714286
"2032";83356;55;14815;4;27;47;20;0,5;0,857142857142857
"2033";83356;55;14816;4;27;51;24;0,5;0,928571428571429
"2034";83356;55;14817;4;27;55;28;0,5;1
"2035";83356;55;14818;5;25;31;6;0,464285714285714;0,571428571428571
"2036";83356;55;14819;5;25;33;8;0,464285714285714;0,607142857142857
"2037";83356;55;14820;5;25;35;10;0,464285714285714;0,642857142857143
"2038";83356;55;14821;5;25;37;12;0,464285714285714;0,678571428571429
"2039";83356;55;14822;5;25;39;14;0,464285714285714;0,714285714285714
"2040";83356;55;14823;5;25;41;16;0,464285714285714;0,75
"2041";83356;55;14824;5;25;43;18;0,464285714285714;0,785714285714286
"2042";83356;55;14825;5;25;45;20;0,464285714285714;0,821428571428571
"2043";83356;55;14826;5;25;47;22;0,464285714285714;0,857142857142857
"2044";132068;59;15020;3;8;33;25;0,142857142857143;0,571428571428571
"2045";132068;59;15021;3;25;50;25;0,428571428571429;0,857142857142857
"2046";132068;59;15022;3;16;42;26;0,285714285714286;0,714285714285714
"2047";132068;59;15023;3;25;59;34;0,428571428571429;1
"2048";132068;59;15024;4;11;23;12;0,2;0,4
"2049";132068;59;15025;4;47;59;12;0,8;1
"2050";132068;59;15026;4;27;39;12;0,466666666666667;0,666666666666667
"2051";132068;59;15027;4;27;43;16;0,466666666666667;0,733333333333333
"2052";132068;59;15028;4;31;43;12;0,533333333333333;0,733333333333333
"2053";132068;59;15029;4;43;55;12;0,733333333333333;0,933333333333333
"2054";132068;59;15030;4;27;47;20;0,466666666666667;0,8
"2055";132068;59;15031;4;27;51;24;0,466666666666667;0,866666666666667
"2056";132068;59;15032;4;31;47;16;0,533333333333333;0,8
"2057";132068;59;15033;4;31;51;20;0,533333333333333;0,866666666666667
"2058";132068;59;15034;4;31;55;24;0,533333333333333;0,933333333333333
"2059";132068;59;15035;4;31;59;28;0,533333333333333;1
"2060";132068;59;15036;4;35;47;12;0,6;0,8
"2061";132068;59;15037;4;43;59;16;0,733333333333333;1
"2062";132068;59;15038;4;15;27;12;0,266666666666667;0,466666666666667
"2063";132068;59;15039;4;19;31;12;0,333333333333333;0,533333333333333
"2064";132068;59;15040;4;19;35;16;0,333333333333333;0,6
"2065";132068;59;15041;4;27;55;28;0,466666666666667;0,933333333333333
"2066";132068;59;15042;4;27;59;32;0,466666666666667;1
"2067";132068;59;15043;4;23;35;12;0,4;0,6
"2068";132068;59;15044;4;23;39;16;0,4;0,666666666666667
"2069";132068;59;15045;4;15;31;16;0,266666666666667;0,533333333333333
"2070";132068;59;15046;4;11;27;16;0,2;0,466666666666667
"2071";132068;59;15047;4;15;35;20;0,266666666666667;0,6
"2072";132068;59;15048;5;15;21;6;0,266666666666667;0,366666666666667
"2073";132068;59;15049;5;21;27;6;0,366666666666667;0,466666666666667
"2074";132068;59;15050;5;27;33;6;0,466666666666667;0,566666666666667
"2075";132068;59;15051;5;27;35;8;0,466666666666667;0,6
"2076";132068;59;15052;5;47;53;6;0,8;0,9
"2077";132068;59;15053;5;47;55;8;0,8;0,933333333333333
"2078";132068;59;15054;5;33;39;6;0,566666666666667;0,666666666666667
"2079";132068;59;15055;5;37;43;6;0,633333333333333;0,733333333333333
"2080";132068;59;15056;5;39;45;6;0,666666666666667;0,766666666666667
"2081";132068;59;15057;5;43;49;6;0,733333333333333;0,833333333333333
"2082";132068;59;15058;5;43;51;8;0,733333333333333;0,866666666666667
"2083";132068;59;15059;5;45;51;6;0,766666666666667;0,866666666666667
"2084";132068;59;15060;5;45;53;8;0,766666666666667;0,9
"2085";132068;59;15061;5;45;55;10;0,766666666666667;0,933333333333333
"2086";132068;59;15062;5;45;57;12;0,766666666666667;0,966666666666667
"2087";132068;59;15063;5;45;59;14;0,766666666666667;1
"2088";132068;59;15064;5;47;57;10;0,8;0,966666666666667
"2089";132068;59;15065;5;47;59;12;0,8;1
"2090";132068;59;15066;5;11;17;6;0,2;0,3
"2091";132068;59;15067;5;27;37;10;0,466666666666667;0,633333333333333
"2092";132068;59;15068;5;27;39;12;0,466666666666667;0,666666666666667
"2093";132068;59;15069;5;29;35;6;0,5;0,6
"2094";132068;59;15070;5;29;37;8;0,5;0,633333333333333
"2095";132068;59;15071;5;29;39;10;0,5;0,666666666666667
"2096";132068;59;15072;5;29;41;12;0,5;0,7
"2097";132068;59;15073;5;35;41;6;0,6;0,7
"2098";132068;59;15074;5;43;53;10;0,733333333333333;0,9
"2099";132068;59;15075;5;43;55;12;0,733333333333333;0,933333333333333
"2100";132068;59;15076;5;43;57;14;0,733333333333333;0,966666666666667
"2101";132068;59;15077;5;17;23;6;0,3;0,4
"2102";132068;59;15078;5;17;25;8;0,3;0,433333333333333
"2103";132068;59;15079;5;27;41;14;0,466666666666667;0,7
"2104";132068;59;15080;5;27;43;16;0,466666666666667;0,733333333333333
"2105";132068;59;15081;5;27;45;18;0,466666666666667;0,766666666666667
"2106";132068;59;15082;5;27;47;20;0,466666666666667;0,8
"2107";132068;59;15083;5;35;43;8;0,6;0,733333333333333
"2108";132068;59;15084;5;35;45;10;0,6;0,766666666666667
"2109";132068;59;15085;5;35;47;12;0,6;0,8
"2110";132068;59;15086;5;39;47;8;0,666666666666667;0,8
"2111";132068;59;15087;5;39;49;10;0,666666666666667;0,833333333333333
"2112";132068;59;15088;5;39;51;12;0,666666666666667;0,866666666666667
"2113";132068;59;15089;5;39;53;14;0,666666666666667;0,9
"2114";132068;59;15090;5;39;55;16;0,666666666666667;0,933333333333333
"2115";132068;59;15091;5;43;59;16;0,733333333333333;1
"2116";132068;59;15092;5;13;19;6;0,233333333333333;0,333333333333333
"2117";132068;59;15093;5;11;19;8;0,2;0,333333333333333
"2118";132068;59;15094;5;9;15;6;0,166666666666667;0,266666666666667
"2119";132068;59;15095;5;13;21;8;0,233333333333333;0,366666666666667
"2120";132068;59;15096;5;15;23;8;0,266666666666667;0,4
"2121";132068;59;15097;5;39;57;18;0,666666666666667;0,966666666666667
"2122";132068;59;15098;5;39;59;20;0,666666666666667;1
"2123";155830;95;15122;4;47;71;24;0,5;0,75
"2124";155830;95;15123;4;71;95;24;0,75;1
"2125";155830;95;15124;4;39;63;24;0,416666666666667;0,666666666666667
"2126";155830;95;15125;4;39;71;32;0,416666666666667;0,75
"2127";155830;95;15126;5;47;59;12;0,5;0,625
"2128";155830;95;15127;5;83;95;12;0,875;1
"2129";155830;95;15128;5;47;63;16;0,5;0,666666666666667
"2130";155830;95;15129;5;79;91;12;0,833333333333333;0,958333333333333
"2131";155830;95;15130;5;27;39;12;0,291666666666667;0,416666666666667
"2132";155830;95;15131;5;47;67;20;0,5;0,708333333333333
"2133";155830;95;15132;5;47;71;24;0,5;0,75
"2134";155830;95;15133;5;75;87;12;0,791666666666667;0,916666666666667
"2135";155830;95;15134;5;79;95;16;0,833333333333333;1
"2136";155830;95;15135;5;43;55;12;0,458333333333333;0,583333333333333
"2137";155830;95;15136;5;75;91;16;0,791666666666667;0,958333333333333
"2138";155830;95;15137;5;43;59;16;0,458333333333333;0,625
"2139";155830;95;15138;5;43;63;20;0,458333333333333;0,666666666666667
"2140";155830;95;15139;5;43;67;24;0,458333333333333;0,708333333333333
"2141";155830;95;15140;5;71;83;12;0,75;0,875
"2142";155830;95;15141;5;75;95;20;0,791666666666667;1
"2143";155830;95;15142;6;45;51;6;0,479166666666667;0,541666666666667
"2144";155830;95;15143;6;81;87;6;0,854166666666667;0,916666666666667
"2145";155830;95;15144;6;25;31;6;0,270833333333333;0,333333333333333
"2146";155830;95;15145;6;45;53;8;0,479166666666667;0,5625
"2147";155830;95;15146;6;45;55;10;0,479166666666667;0,583333333333333
"2148";155830;95;15147;6;45;57;12;0,479166666666667;0,604166666666667
"2149";155830;95;15148;6;75;81;6;0,791666666666667;0,854166666666667
"2150";155830;95;15149;6;81;89;8;0,854166666666667;0,9375
"2151";155830;95;15150;6;81;91;10;0,854166666666667;0,958333333333333
"2152";155830;95;15151;6;81;93;12;0,854166666666667;0,979166666666667
"2153";155830;95;15152;6;83;89;6;0,875;0,9375
"2154";155830;95;15153;6;25;33;8;0,270833333333333;0,354166666666667
"2155";155830;95;15154;6;25;35;10;0,270833333333333;0,375
"2156";155830;95;15155;6;25;37;12;0,270833333333333;0,395833333333333
"2157";155830;95;15156;6;45;59;14;0,479166666666667;0,625
"2158";155830;95;15157;6;3;9;6;0,0416666666666667;0,104166666666667
"2159";155830;95;15158;6;17;23;6;0,1875;0,25
"2160";155830;95;15159;6;79;85;6;0,833333333333333;0,895833333333333
"2161";155830;95;15160;6;79;87;8;0,833333333333333;0,916666666666667
"2162";155830;95;15161;6;5;11;6;0,0625;0,125
"2163";155830;95;15162;6;77;83;6;0,8125;0,875
"2164";155830;95;15163;6;77;85;8;0,8125;0,895833333333333
"2165";155830;95;15164;6;79;89;10;0,833333333333333;0,9375
"2166";155830;95;15165;6;45;61;16;0,479166666666667;0,645833333333333
"2167";155830;95;15166;6;45;63;18;0,479166666666667;0,666666666666667
"2168";155830;95;15167;6;45;65;20;0,479166666666667;0,6875
"2169";155830;95;15168;6;75;83;8;0,791666666666667;0,875
"2170";155830;95;15169;6;75;85;10;0,791666666666667;0,895833333333333
"2171";155830;95;15170;6;75;87;12;0,791666666666667;0,916666666666667
"2172";155830;95;15171;6;75;89;14;0,791666666666667;0,9375
"2173";155830;95;15172;6;75;91;16;0,791666666666667;0,958333333333333
"2174";155830;95;15173;6;75;93;18;0,791666666666667;0,979166666666667
"2175";155830;95;15174;6;75;95;20;0,791666666666667;1
"2176";155830;95;15175;6;77;87;10;0,8125;0,916666666666667
"2177";155830;95;15176;6;77;89;12;0,8125;0,9375
"2178";155830;95;15177;6;77;91;14;0,8125;0,958333333333333
"2179";155830;95;15178;6;77;93;16;0,8125;0,979166666666667
"2180";155830;95;15179;6;77;95;18;0,8125;1
"2181";155830;95;15180;6;79;91;12;0,833333333333333;0,958333333333333
"2182";155830;95;15181;6;79;93;14;0,833333333333333;0,979166666666667
"2183";155830;95;15182;6;79;95;16;0,833333333333333;1
"2184";155830;95;15183;6;81;95;14;0,854166666666667;1
"2185";155830;95;15184;6;73;79;6;0,770833333333333;0,833333333333333
"2186";155830;95;15185;6;23;29;6;0,25;0,3125
"2187";155830;95;15186;6;25;39;14;0,270833333333333;0,416666666666667
"2188";155830;95;15187;6;25;41;16;0,270833333333333;0,4375
"2189";155830;95;15188;6;83;91;8;0,875;0,958333333333333
"2190";155830;95;15189;6;83;93;10;0,875;0,979166666666667
"2191";155830;95;15190;6;83;95;12;0,875;1
"2192";155830;95;15191;6;43;49;6;0,458333333333333;0,520833333333333
"2193";155830;95;15192;6;43;51;8;0,458333333333333;0,541666666666667
"2194";155830;95;15193;6;45;67;22;0,479166666666667;0,708333333333333
"2195";155830;95;15194;6;43;53;10;0,458333333333333;0,5625
"2196";308924;90;15331;3;35;90;55;0,4;1
"2197";308924;90;15332;4;49;73;24;0,545454545454545;0,818181818181818
"2198";308924;90;15333;4;57;82;25;0,636363636363636;0,909090909090909
"2199";308924;90;15334;4;32;57;25;0,363636363636364;0,636363636363636
"2200";308924;90;15335;4;65;90;25;0,727272727272727;1
"2201";308924;90;15336;5;16;28;12;0,181818181818182;0,318181818181818
"2202";308924;90;15337;5;53;65;12;0,590909090909091;0,727272727272727
"2203";308924;90;15338;5;53;69;16;0,590909090909091;0,772727272727273
"2204";308924;90;15339;5;57;69;12;0,636363636363636;0,772727272727273
"2205";308924;90;15340;5;32;44;12;0,363636363636364;0,5
"2206";308924;90;15341;5;69;82;13;0,772727272727273;0,909090909090909
"2207";308924;90;15342;5;28;40;12;0,318181818181818;0,454545454545455
"2208";308924;90;15343;5;28;44;16;0,318181818181818;0,5
"2209";308924;90;15344;5;49;61;12;0,545454545454545;0,681818181818182
"2210";308924;90;15345;5;61;73;12;0,681818181818182;0,818181818181818
"2211";308924;90;15346;5;65;78;13;0,727272727272727;0,863636363636364
"2212";308924;90;15347;5;69;86;17;0,772727272727273;0,954545454545455
"2213";308924;90;15348;5;69;90;21;0,772727272727273;1
"2214";308924;90;15349;5;73;86;13;0,818181818181818;0,954545454545455
"2215";308924;90;15350;5;73;90;17;0,818181818181818;1
"2216";308924;90;15351;5;78;90;12;0,863636363636364;1
"2217";308924;90;15352;5;61;78;17;0,681818181818182;0,863636363636364
"2218";308924;90;15353;5;65;82;17;0,727272727272727;0,909090909090909
"2219";308924;90;15354;5;7;20;13;0,0909090909090909;0,227272727272727
"2220";308924;90;15355;5;49;65;16;0,545454545454545;0,727272727272727
"2221";308924;90;15356;5;11;24;13;0,136363636363636;0,272727272727273
"2222";308924;90;15357;6;15;21;6;0,177777777777778;0,244444444444444
"2223";308924;90;15358;6;21;27;6;0,244444444444444;0,311111111111111
"2224";308924;90;15359;6;56;62;6;0,622222222222222;0,688888888888889
"2225";308924;90;15360;6;3;9;6;0,0444444444444444;0,111111111111111
"2226";308924;90;15361;6;5;11;6;0,0666666666666667;0,133333333333333
"2227";308924;90;15362;6;17;23;6;0,2;0,266666666666667
"2228";308924;90;15363;6;27;33;6;0,311111111111111;0,377777777777778
"2229";308924;90;15364;6;29;35;6;0,333333333333333;0,4
"2230";308924;90;15365;6;29;37;8;0,333333333333333;0,422222222222222
"2231";308924;90;15366;6;31;37;6;0,355555555555556;0,422222222222222
"2232";308924;90;15367;6;33;39;6;0,377777777777778;0,444444444444444
"2233";308924;90;15368;6;33;41;8;0,377777777777778;0,466666666666667
"2234";308924;90;15369;6;35;41;6;0,4;0,466666666666667
"2235";308924;90;15370;6;35;43;8;0,4;0,488888888888889
"2236";308924;90;15371;6;37;43;6;0,422222222222222;0,488888888888889
"2237";308924;90;15372;6;50;56;6;0,555555555555556;0,622222222222222
"2238";308924;90;15373;6;52;58;6;0,577777777777778;0,644444444444444
"2239";308924;90;15374;6;60;66;6;0,666666666666667;0,733333333333333
"2240";308924;90;15375;6;62;68;6;0,688888888888889;0,755555555555556
"2241";308924;90;15376;6;68;74;6;0,755555555555556;0,822222222222222
"2242";308924;90;15377;6;70;76;6;0,777777777777778;0,844444444444444
"2243";308924;90;15378;6;70;78;8;0,777777777777778;0,866666666666667
"2244";308924;90;15379;6;70;80;10;0,777777777777778;0,888888888888889
"2245";308924;90;15380;6;72;78;6;0,8;0,866666666666667
"2246";308924;90;15381;6;72;80;8;0,8;0,888888888888889
"2247";308924;90;15382;6;76;82;6;0,844444444444444;0,911111111111111
"2248";308924;90;15383;6;76;84;8;0,844444444444444;0,933333333333333
"2249";308924;90;15384;6;78;84;6;0,866666666666667;0,933333333333333
"2250";308924;90;15385;6;78;86;8;0,866666666666667;0,955555555555556
"2251";308924;90;15386;6;78;88;10;0,866666666666667;0,977777777777778
"2252";308924;90;15387;6;3;11;8;0,0444444444444444;0,133333333333333
"2253";308924;90;15388;6;19;25;6;0,222222222222222;0,288888888888889
"2254";308924;90;15389;6;31;39;8;0,355555555555556;0,444444444444444
"2255";308924;90;15390;6;31;41;10;0,355555555555556;0,466666666666667
"2256";308924;90;15391;6;31;43;12;0,355555555555556;0,488888888888889
"2257";308924;90;15392;6;37;46;9;0,422222222222222;0,511111111111111
"2258";308924;90;15393;6;56;64;8;0,622222222222222;0,711111111111111
"2259";308924;90;15394;6;60;68;8;0,666666666666667;0,755555555555556
"2260";308924;90;15395;6;70;82;12;0,777777777777778;0,911111111111111
"2261";308924;90;15396;6;52;60;8;0,577777777777778;0,666666666666667
"2262";308924;90;15397;6;29;39;10;0,333333333333333;0,444444444444444
"2263";308924;90;15398;6;33;43;10;0,377777777777778;0,488888888888889
"2264";308924;90;15399;6;33;46;13;0,377777777777778;0,511111111111111
"2265";308924;90;15400;6;56;66;10;0,622222222222222;0,733333333333333
"2266";308924;90;15401;6;58;64;6;0,644444444444444;0,711111111111111
"2267";308924;90;15402;6;58;66;8;0,644444444444444;0,733333333333333
"2268";308924;90;15403;6;60;70;10;0,666666666666667;0,777777777777778
"2269";308924;90;15404;6;62;70;8;0,688888888888889;0,777777777777778
"2270";308924;90;15405;6;64;70;6;0,711111111111111;0,777777777777778
"2271";308924;90;15406;6;68;76;8;0,755555555555556;0,844444444444444
"2272";308924;90;15407;6;68;78;10;0,755555555555556;0,866666666666667
"2273";308924;90;15408;6;68;80;12;0,755555555555556;0,888888888888889
"2274";308924;90;15409;6;72;82;10;0,8;0,911111111111111
"2275";308924;90;15410;6;76;86;10;0,844444444444444;0,955555555555556
"2276";308924;90;15411;6;78;90;12;0,866666666666667;1
"2277";308924;90;15412;6;1;7;6;0,0222222222222222;0,0888888888888889
"2278";308924;90;15413;6;23;29;6;0,266666666666667;0,333333333333333
"2279";308924;90;15414;6;29;41;12;0,333333333333333;0,466666666666667
"2280";308924;90;15415;6;56;68;12;0,622222222222222;0,755555555555556
"2281";308924;90;15416;6;68;82;14;0,755555555555556;0,911111111111111
"2282";308924;90;15417;6;70;84;14;0,777777777777778;0,933333333333333
"2283";308924;90;15418;6;70;86;16;0,777777777777778;0,955555555555556
"2284";308924;90;15419;6;70;88;18;0,777777777777778;0,977777777777778
"2285";308924;90;15420;6;70;90;20;0,777777777777778;1
"2286";308924;90;15421;6;50;58;8;0,555555555555556;0,644444444444444
"2287";308924;90;15422;6;72;84;12;0,8;0,933333333333333
"2288";308924;90;15423;6;76;88;12;0,844444444444444;0,977777777777778
"2289";317799;21;15483;4;1;7;6;0,0909090909090909;0,363636363636364
"2290";317799;21;15484;4;1;9;8;0,0909090909090909;0,454545454545455
"2291";317799;21;15485;4;1;11;10;0,0909090909090909;0,545454545454545
"2292";317799;21;15486;4;1;13;12;0,0909090909090909;0,636363636363636
"2293";317799;21;15487;4;1;15;14;0,0909090909090909;0,727272727272727
"2294";317799;21;15488;4;1;17;16;0,0909090909090909;0,818181818181818
"2295";318015;52;15489;3;26;52;26;0,5;1
"2296";318015;52;15490;4;11;23;12;0,230769230769231;0,461538461538462
"2297";318015;52;15491;4;11;28;17;0,230769230769231;0,538461538461538
"2298";318015;52;15492;4;15;28;13;0,307692307692308;0,538461538461538
"2299";318015;52;15493;4;32;44;12;0,615384615384615;0,846153846153846
"2300";318015;52;15494;4;32;48;16;0,615384615384615;0,923076923076923
"2301";318015;52;15495;4;32;52;20;0,615384615384615;1
"2302";318015;52;15496;4;7;19;12;0,153846153846154;0,384615384615385
"2303";318015;52;15497;4;28;40;12;0,538461538461538;0,769230769230769
"2304";318015;52;15498;5;11;17;6;0,230769230769231;0,346153846153846
"2305";318015;52;15499;5;13;19;6;0,269230769230769;0,384615384615385
"2306";318015;52;15500;5;13;21;8;0,269230769230769;0,423076923076923
"2307";318015;52;15501;5;13;23;10;0,269230769230769;0,461538461538462
"2308";318015;52;15502;5;30;36;6;0,576923076923077;0,692307692307692
"2309";318015;52;15503;5;30;38;8;0,576923076923077;0,730769230769231
"2310";318015;52;15504;5;30;40;10;0,576923076923077;0,769230769230769
"2311";318015;52;15505;5;32;38;6;0,615384615384615;0,730769230769231
"2312";318015;52;15506;5;32;40;8;0,615384615384615;0,769230769230769
"2313";318015;52;15507;5;32;42;10;0,615384615384615;0,807692307692308
"2314";318015;52;15508;5;11;19;8;0,230769230769231;0,384615384615385
"2315";318015;52;15509;5;11;21;10;0,230769230769231;0,423076923076923
"2316";318015;52;15510;5;11;23;12;0,230769230769231;0,461538461538462
"2317";318015;52;15511;5;11;26;15;0,230769230769231;0,5
"2318";318015;52;15512;5;11;28;17;0,230769230769231;0,538461538461538
"2319";318015;52;15513;5;13;26;13;0,269230769230769;0,5
"2320";318015;52;15514;5;13;28;15;0,269230769230769;0,538461538461538
"2321";318015;52;15515;5;30;42;12;0,576923076923077;0,807692307692308
"2322";318015;52;15516;5;30;44;14;0,576923076923077;0,846153846153846
"2323";318015;52;15517;5;30;46;16;0,576923076923077;0,884615384615385
"2324";318015;52;15518;5;30;48;18;0,576923076923077;0,923076923076923
"2325";318015;52;15519;5;30;50;20;0,576923076923077;0,961538461538462
"2326";318015;52;15520;5;32;44;12;0,615384615384615;0,846153846153846
"2327";318015;52;15521;5;32;46;14;0,615384615384615;0,884615384615385
"2328";318015;52;15522;5;32;48;16;0,615384615384615;0,923076923076923
"2329";318015;52;15523;5;32;50;18;0,615384615384615;0,961538461538462
"2330";318015;52;15524;5;32;52;20;0,615384615384615;1
"2331";318015;52;15525;5;9;15;6;0,192307692307692;0,307692307692308
"2332";318015;52;15526;5;9;17;8;0,192307692307692;0,346153846153846
"2333";318015;52;15527;5;9;19;10;0,192307692307692;0,384615384615385
"2334";318015;52;15528;5;9;21;12;0,192307692307692;0,423076923076923
"2335";318015;52;15529;5;9;23;14;0,192307692307692;0,461538461538462
"2336";318015;52;15530;5;28;34;6;0,538461538461538;0,653846153846154
"2337";322065;51;15531;3;25;51;26;0,5;1
"2338";322065;51;15532;4;31;43;12;0,615384615384615;0,846153846153846
"2339";322065;51;15533;4;31;47;16;0,615384615384615;0,923076923076923
"2340";322065;51;15534;4;27;39;12;0,538461538461538;0,769230769230769
"2341";322065;51;15535;4;31;51;20;0,615384615384615;1
"2342";322065;51;15536;4;35;47;12;0,692307692307692;0,923076923076923
"2343";322065;51;15537;4;35;51;16;0,692307692307692;1
"2344";322065;51;15538;4;7;19;12;0,153846153846154;0,384615384615385
"2345";322065;51;15539;5;7;13;6;0,153846153846154;0,269230769230769
"2346";322065;51;15540;5;7;15;8;0,153846153846154;0,307692307692308
"2347";322065;51;15541;5;9;15;6;0,192307692307692;0,307692307692308
"2348";322065;51;15542;5;27;33;6;0,538461538461538;0,653846153846154
"2349";322065;51;15543;5;27;35;8;0,538461538461538;0,692307692307692
"2350";322065;51;15544;5;29;35;6;0,576923076923077;0,692307692307692
"2351";322065;51;15545;5;29;37;8;0,576923076923077;0,730769230769231
"2352";322065;51;15546;5;29;39;10;0,576923076923077;0,769230769230769
"2353";322065;51;15547;5;35;41;6;0,692307692307692;0,807692307692308
"2354";322065;51;15548;5;35;43;8;0,692307692307692;0,846153846153846
"2355";322065;51;15549;5;35;45;10;0,692307692307692;0,884615384615385
"2356";322065;51;15550;5;29;41;12;0,576923076923077;0,807692307692308
"2357";322065;51;15551;5;29;43;14;0,576923076923077;0,846153846153846
"2358";322065;51;15552;5;29;45;16;0,576923076923077;0,884615384615385
"2359";322065;51;15553;5;7;17;10;0,153846153846154;0,346153846153846
"2360";322065;51;15554;5;35;47;12;0,692307692307692;0,923076923076923
"2361";322065;51;15555;5;29;47;18;0,576923076923077;0,923076923076923
"2362";322065;51;15556;5;29;49;20;0,576923076923077;0,961538461538462
"2363";322065;51;15557;5;35;49;14;0,692307692307692;0,961538461538462
"2364";322065;51;15558;5;35;51;16;0,692307692307692;1
"2365";322065;51;15559;5;9;17;8;0,192307692307692;0,346153846153846
"2366";322065;51;15560;5;15;21;6;0,307692307692308;0,423076923076923
"2367";322065;51;15561;5;11;17;6;0,230769230769231;0,346153846153846
"2368";307140;115;15569;3;49;98;49;0,428571428571429;0,857142857142857
"2369";307140;115;15570;3;65;115;50;0,571428571428571;1
"2370";307140;115;15571;3;49;115;66;0,428571428571429;1
"2371";307140;115;15572;4;40;65;25;0,357142857142857;0,571428571428571
"2372";307140;115;15573;4;65;90;25;0,571428571428571;0,785714285714286
"2373";307140;115;15574;4;74;98;24;0,642857142857143;0,857142857142857
"2374";307140;115;15575;4;65;98;33;0,571428571428571;0,857142857142857
"2375";307140;115;15576;4;65;107;42;0,571428571428571;0,928571428571429
"2376";307140;115;15577;4;57;82;25;0,5;0,714285714285714
"2377";307140;115;15578;4;57;90;33;0,5;0,785714285714286
"2378";307140;115;15579;4;57;98;41;0,5;0,857142857142857
"2379";307140;115;15580;4;57;107;50;0,5;0,928571428571429
"2380";307140;115;15581;4;57;115;58;0,5;1
"2381";307140;115;15582;4;65;115;50;0,571428571428571;1
"2382";307140;115;15583;4;74;107;33;0,642857142857143;0,928571428571429
"2383";307140;115;15584;4;74;115;41;0,642857142857143;1
"2384";307140;115;15585;4;49;74;25;0,428571428571429;0,642857142857143
"2385";307140;115;15586;4;49;82;33;0,428571428571429;0,714285714285714
"2386";307140;115;15587;4;40;74;34;0,357142857142857;0,642857142857143
"2387";307140;115;15588;5;47;59;12;0,413793103448276;0,517241379310345
"2388";307140;115;15589;5;63;75;12;0,551724137931034;0,655172413793103
"2389";307140;115;15590;5;67;79;12;0,586206896551724;0,689655172413793
"2390";307140;115;15591;5;67;83;16;0,586206896551724;0,724137931034483
"2391";307140;115;15592;5;71;83;12;0,620689655172414;0,724137931034483
"2392";307140;115;15593;5;35;47;12;0,310344827586207;0,413793103448276
"2393";307140;115;15594;5;47;63;16;0,413793103448276;0,551724137931034
"2394";307140;115;15595;5;51;63;12;0,448275862068966;0,551724137931034
"2395";307140;115;15596;5;63;79;16;0,551724137931034;0,689655172413793
"2396";307140;115;15597;5;63;83;20;0,551724137931034;0,724137931034483
"2397";307140;115;15598;5;63;87;24;0,551724137931034;0,758620689655172
"2398";307140;115;15599;5;67;87;20;0,586206896551724;0,758620689655172
"2399";307140;115;15600;5;67;91;24;0,586206896551724;0,793103448275862
"2400";307140;115;15601;5;67;95;28;0,586206896551724;0,827586206896552
"2401";307140;115;15602;5;71;87;16;0,620689655172414;0,758620689655172
"2402";307140;115;15603;5;71;91;20;0,620689655172414;0,793103448275862
"2403";307140;115;15604;5;71;95;24;0,620689655172414;0,827586206896552
"2404";307140;115;15605;5;63;91;28;0,551724137931034;0,793103448275862
"2405";307140;115;15606;5;63;95;32;0,551724137931034;0,827586206896552
"2406";307140;115;15607;5;63;99;36;0,551724137931034;0,862068965517241
"2407";307140;115;15608;5;63;103;40;0,551724137931034;0,896551724137931
"2408";307140;115;15609;5;63;107;44;0,551724137931034;0,931034482758621
"2409";307140;115;15610;5;63;111;48;0,551724137931034;0,96551724137931
"2410";307140;115;15611;5;67;99;32;0,586206896551724;0,862068965517241
"2411";307140;115;15612;5;67;103;36;0,586206896551724;0,896551724137931
"2412";307140;115;15613;5;67;107;40;0,586206896551724;0,931034482758621
"2413";307140;115;15614;5;67;111;44;0,586206896551724;0,96551724137931
"2414";307140;115;15615;5;43;55;12;0,379310344827586;0,482758620689655
"2415";307140;115;15616;5;67;115;48;0,586206896551724;1
"2416";307140;115;15617;5;71;99;28;0,620689655172414;0,862068965517241
"2417";307140;115;15618;5;71;103;32;0,620689655172414;0,896551724137931
"2418";307140;115;15619;5;71;107;36;0,620689655172414;0,931034482758621
"2419";307140;115;15620;5;71;111;40;0,620689655172414;0,96551724137931
"2420";307140;115;15621;5;71;115;44;0,620689655172414;1
"2421";307140;115;15622;5;39;51;12;0,344827586206897;0,448275862068966
"2422";307140;115;15623;5;59;71;12;0,517241379310345;0,620689655172414
"2423";307140;115;15624;6;41;47;6;0,362068965517241;0,413793103448276
"2424";307140;115;15625;6;47;53;6;0,413793103448276;0,46551724137931
"2425";307140;115;15626;6;51;57;6;0,448275862068966;0,5
"2426";307140;115;15627;6;63;69;6;0,551724137931034;0,603448275862069
"2427";307140;115;15628;6;69;75;6;0,603448275862069;0,655172413793103
"2428";307140;115;15629;6;35;41;6;0,310344827586207;0,362068965517241
"2429";307140;115;15630;6;37;43;6;0,327586206896552;0,379310344827586
"2430";307140;115;15631;6;47;55;8;0,413793103448276;0,482758620689655
"2431";307140;115;15632;6;47;57;10;0,413793103448276;0,5
"2432";307140;115;15633;6;47;59;12;0,413793103448276;0,517241379310345
"2433";307140;115;15634;6;51;59;8;0,448275862068966;0,517241379310345
"2434";307140;115;15635;6;51;61;10;0,448275862068966;0,53448275862069
"2435";307140;115;15636;6;61;67;6;0,53448275862069;0,586206896551724
"2436";307140;115;15637;6;61;69;8;0,53448275862069;0,603448275862069
"2437";307140;115;15638;6;63;71;8;0,551724137931034;0,620689655172414
"2438";307140;115;15639;6;63;73;10;0,551724137931034;0,637931034482759
"2439";307140;115;15640;6;63;75;12;0,551724137931034;0,655172413793103
"2440";307140;115;15641;6;65;71;6;0,568965517241379;0,620689655172414
"2441";307140;115;15642;6;65;73;8;0,568965517241379;0,637931034482759
"2442";307140;115;15643;6;65;75;10;0,568965517241379;0,655172413793103
"2443";307140;115;15644;6;69;77;8;0,603448275862069;0,672413793103448
"2444";307140;115;15645;6;69;79;10;0,603448275862069;0,689655172413793
"2445";307140;115;15646;6;69;81;12;0,603448275862069;0,706896551724138
"2446";307140;115;15647;6;43;49;6;0,379310344827586;0,431034482758621
"2447";307140;115;15648;6;47;61;14;0,413793103448276;0,53448275862069
"2448";307140;115;15649;6;61;71;10;0,53448275862069;0,620689655172414
"2449";307140;115;15650;6;63;77;14;0,551724137931034;0,672413793103448
"2450";307140;115;15651;6;63;79;16;0,551724137931034;0,689655172413793
"2451";307140;115;15652;6;63;81;18;0,551724137931034;0,706896551724138
"2452";307140;115;15653;6;63;83;20;0,551724137931034;0,724137931034483
"2453";307140;115;15654;6;63;85;22;0,551724137931034;0,741379310344828
"2454";307140;115;15655;6;63;87;24;0,551724137931034;0,758620689655172
"2455";307140;115;15656;6;65;77;12;0,568965517241379;0,672413793103448
"2456";307140;115;15657;6;65;79;14;0,568965517241379;0,689655172413793
"2457";307140;115;15658;6;65;81;16;0,568965517241379;0,706896551724138
"2458";307140;115;15659;6;65;83;18;0,568965517241379;0,724137931034483
"2459";307140;115;15660;6;65;85;20;0,568965517241379;0,741379310344828
"2460";307140;115;15661;6;65;87;22;0,568965517241379;0,758620689655172
"2461";307140;115;15662;6;65;89;24;0,568965517241379;0,775862068965517
"2462";307140;115;15663;6;69;83;14;0,603448275862069;0,724137931034483
"2463";307140;115;15664;6;69;85;16;0,603448275862069;0,741379310344828
"2464";307140;115;15665;6;69;87;18;0,603448275862069;0,758620689655172
"2465";307140;115;15666;6;69;89;20;0,603448275862069;0,775862068965517
"2466";307140;115;15667;6;69;91;22;0,603448275862069;0,793103448275862
"2467";307140;115;15668;6;69;93;24;0,603448275862069;0,810344827586207
"2468";307140;115;15669;6;21;27;6;0,189655172413793;0,241379310344828
"2469";307140;115;15670;6;27;33;6;0,241379310344828;0,293103448275862
"2470";307140;115;15671;6;29;35;6;0,258620689655172;0,310344827586207
"2471";307140;115;15672;6;65;91;26;0,568965517241379;0,793103448275862
"2472";307140;115;15673;6;65;93;28;0,568965517241379;0,810344827586207
"2473";307140;115;15674;6;65;95;30;0,568965517241379;0,827586206896552
"2474";307140;115;15675;6;19;25;6;0,172413793103448;0,224137931034483
"2475";307140;115;15676;6;23;29;6;0,206896551724138;0,258620689655172
"2476";307140;115;15677;6;37;45;8;0,327586206896552;0,396551724137931
"2477";307140;115;15678;6;39;45;6;0,344827586206897;0,396551724137931
"2478";307140;115;15679;6;39;47;8;0,344827586206897;0,413793103448276
"2479";307140;115;15680;6;51;63;12;0,448275862068966;0,551724137931034
"2480";307140;115;15681;6;61;73;12;0,53448275862069;0,637931034482759
"2481";307140;115;15682;6;9;15;6;0,0862068965517241;0,137931034482759
"2482";325178;110;15683;4;76;101;25;0,692307692307692;0,923076923076923
"2483";325178;110;15684;4;67;93;26;0,615384615384615;0,846153846153846
"2484";325178;110;15685;4;67;101;34;0,615384615384615;0,923076923076923
"2485";325178;110;15686;4;76;110;34;0,692307692307692;1
"2486";325178;110;15687;4;84;110;26;0,769230769230769;1
"2487";325178;110;15688;4;16;42;26;0,153846153846154;0,384615384615385
"2488";325178;110;15689;4;25;50;25;0,230769230769231;0,461538461538462
"2489";325178;110;15690;5;69;81;12;0,62962962962963;0,740740740740741
"2490";325178;110;15691;5;81;94;13;0,740740740740741;0,851851851851852
"2491";325178;110;15692;5;81;98;17;0,740740740740741;0,888888888888889
"2492";325178;110;15693;5;85;98;13;0,777777777777778;0,888888888888889
"2493";325178;110;15694;5;85;102;17;0,777777777777778;0,925925925925926
"2494";325178;110;15695;5;89;102;13;0,814814814814815;0,925925925925926
"2495";325178;110;15696;5;89;106;17;0,814814814814815;0,962962962962963
"2496";325178;110;15697;5;28;40;12;0,259259259259259;0,37037037037037
"2497";325178;110;15698;5;77;89;12;0,703703703703704;0,814814814814815
"2498";325178;110;15699;5;77;94;17;0,703703703703704;0,851851851851852
"2499";325178;110;15700;5;77;98;21;0,703703703703704;0,888888888888889
"2500";325178;110;15701;5;77;102;25;0,703703703703704;0,925925925925926
"2501";325178;110;15702;5;77;106;29;0,703703703703704;0,962962962962963
"2502";325178;110;15703;5;81;102;21;0,740740740740741;0,925925925925926
"2503";325178;110;15704;5;81;106;25;0,740740740740741;0,962962962962963
"2504";325178;110;15705;5;85;106;21;0,777777777777778;0,962962962962963
"2505";325178;110;15706;5;24;36;12;0,222222222222222;0,333333333333333
"2506";325178;110;15707;5;57;69;12;0,518518518518518;0,62962962962963
"2507";325178;110;15708;5;61;73;12;0,555555555555556;0,666666666666667
"2508";325178;110;15709;5;73;85;12;0,666666666666667;0,777777777777778
"2509";325178;110;15710;5;73;89;16;0,666666666666667;0,814814814814815
"2510";325178;110;15711;5;77;110;33;0,703703703703704;1
"2511";325178;110;15712;5;81;110;29;0,740740740740741;1
"2512";325178;110;15713;5;85;110;25;0,777777777777778;1
"2513";325178;110;15714;5;89;110;21;0,814814814814815;1
"2514";325178;110;15715;6;17;23;6;0,163636363636364;0,218181818181818
"2515";325178;110;15716;6;25;31;6;0,236363636363636;0,290909090909091
"2516";325178;110;15717;6;27;33;6;0,254545454545455;0,309090909090909
"2517";325178;110;15718;6;70;76;6;0,636363636363636;0,690909090909091
"2518";325178;110;15719;6;70;78;8;0,636363636363636;0,709090909090909
"2519";325178;110;15720;6;72;78;6;0,654545454545455;0,709090909090909
"2520";325178;110;15721;6;80;86;6;0,727272727272727;0,781818181818182
"2521";325178;110;15722;6;82;88;6;0,745454545454545;0,8
"2522";325178;110;15723;6;86;92;6;0,781818181818182;0,836363636363636
"2523";325178;110;15724;6;86;94;8;0,781818181818182;0,854545454545454
"2524";325178;110;15725;6;88;94;6;0,8;0,854545454545454
"2525";325178;110;15726;6;88;96;8;0,8;0,872727272727273
"2526";325178;110;15727;6;90;96;6;0,818181818181818;0,872727272727273
"2527";325178;110;15728;6;90;98;8;0,818181818181818;0,890909090909091
"2528";325178;110;15729;6;11;17;6;0,109090909090909;0,163636363636364
"2529";325178;110;15730;6;17;25;8;0,163636363636364;0,236363636363636
"2530";325178;110;15731;6;19;25;6;0,181818181818182;0,236363636363636
"2531";325178;110;15732;6;27;35;8;0,254545454545455;0,327272727272727
"2532";325178;110;15733;6;29;35;6;0,272727272727273;0,327272727272727
"2533";325178;110;15734;6;29;37;8;0,272727272727273;0,345454545454545
"2534";325178;110;15735;6;31;37;6;0,290909090909091;0,345454545454545
"2535";325178;110;15736;6;31;39;8;0,290909090909091;0,363636363636364
"2536";325178;110;15737;6;33;39;6;0,309090909090909;0,363636363636364
"2537";325178;110;15738;6;43;49;6;0,4;0,454545454545455
"2538";325178;110;15739;6;72;80;8;0,654545454545455;0,727272727272727
"2539";325178;110;15740;6;76;82;6;0,690909090909091;0,745454545454545
"2540";325178;110;15741;6;78;84;6;0,709090909090909;0,763636363636364
"2541";325178;110;15742;6;78;86;8;0,709090909090909;0,781818181818182
"2542";325178;110;15743;6;78;88;10;0,709090909090909;0,8
"2543";325178;110;15744;6;78;90;12;0,709090909090909;0,818181818181818
"2544";325178;110;15745;6;78;92;14;0,709090909090909;0,836363636363636
"2545";325178;110;15746;6;78;94;16;0,709090909090909;0,854545454545454
"2546";325178;110;15747;6;78;96;18;0,709090909090909;0,872727272727273
"2547";325178;110;15748;6;80;88;8;0,727272727272727;0,8
"2548";325178;110;15749;6;80;90;10;0,727272727272727;0,818181818181818
"2549";325178;110;15750;6;80;92;12;0,727272727272727;0,836363636363636
"2550";325178;110;15751;6;80;94;14;0,727272727272727;0,854545454545454
"2551";325178;110;15752;6;82;90;8;0,745454545454545;0,818181818181818
"2552";325178;110;15753;6;82;92;10;0,745454545454545;0,836363636363636
"2553";325178;110;15754;6;82;94;12;0,745454545454545;0,854545454545454
"2554";325178;110;15755;6;82;96;14;0,745454545454545;0,872727272727273
"2555";325178;110;15756;6;82;98;16;0,745454545454545;0,890909090909091
"2556";325178;110;15757;6;84;90;6;0,763636363636364;0,818181818181818
"2557";325178;110;15758;6;84;92;8;0,763636363636364;0,836363636363636
"2558";325178;110;15759;6;84;94;10;0,763636363636364;0,854545454545454
"2559";325178;110;15760;6;84;96;12;0,763636363636364;0,872727272727273
"2560";325178;110;15761;6;84;98;14;0,763636363636364;0,890909090909091
"2561";325178;110;15762;6;84;100;16;0,763636363636364;0,909090909090909
"2562";325178;110;15763;6;84;102;18;0,763636363636364;0,927272727272727
"2563";325178;110;15764;6;86;96;10;0,781818181818182;0,872727272727273
"2564";325178;110;15765;6;86;98;12;0,781818181818182;0,890909090909091
"2565";325178;110;15766;6;86;100;14;0,781818181818182;0,909090909090909
"2566";325178;110;15767;6;86;102;16;0,781818181818182;0,927272727272727
"2567";325178;110;15768;6;88;98;10;0,8;0,890909090909091
"2568";325178;110;15769;6;88;100;12;0,8;0,909090909090909
"2569";325178;110;15770;6;88;102;14;0,8;0,927272727272727
"2570";325178;110;15771;6;90;100;10;0,818181818181818;0,909090909090909
"2571";325178;110;15772;6;90;102;12;0,818181818181818;0,927272727272727
"2572";325178;110;15773;6;90;104;14;0,818181818181818;0,945454545454545
"2573";325178;110;15774;6;27;37;10;0,254545454545455;0,345454545454545
"2574";325178;110;15775;6;68;74;6;0,618181818181818;0,672727272727273
"2575";325178;110;15776;6;72;82;10;0,654545454545455;0,745454545454545
"2576";325178;110;15777;6;72;84;12;0,654545454545455;0,763636363636364
"2577";325178;110;15778;6;76;84;8;0,690909090909091;0,763636363636364
"2578";325178;110;15779;6;76;86;10;0,690909090909091;0,781818181818182
"2579";325178;110;15780;6;76;88;12;0,690909090909091;0,8
"2580";325178;110;15781;6;76;90;14;0,690909090909091;0,818181818181818
"2581";325178;110;15782;6;80;96;16;0,727272727272727;0,872727272727273
"2582";325178;110;15783;6;80;98;18;0,727272727272727;0,890909090909091
"2583";325178;110;15784;6;80;100;20;0,727272727272727;0,909090909090909
"2584";325178;110;15785;6;80;102;22;0,727272727272727;0,927272727272727
"2585";325178;110;15786;6;82;100;18;0,745454545454545;0,909090909090909
"2586";325178;110;15787;6;82;102;20;0,745454545454545;0,927272727272727
"2587";325178;110;15788;6;86;104;18;0,781818181818182;0,945454545454545
"2588";325178;110;15789;6;88;104;16;0,8;0,945454545454545
"2589";325178;110;15790;6;88;106;18;0,8;0,963636363636364
"2590";325178;110;15791;6;53;60;7;0,490909090909091;0,545454545454545
"2591";325178;110;15792;6;25;33;8;0,236363636363636;0,309090909090909
"2592";325178;110;15793;6;58;64;6;0,527272727272727;0,581818181818182
"2593";325178;110;15794;6;56;62;6;0,509090909090909;0,563636363636364
"2594";325178;110;15795;6;90;106;16;0,818181818181818;0,963636363636364
"2595";325178;110;15796;6;90;108;18;0,818181818181818;0,981818181818182
"2596";348235;88;15869;5;72;84;12;0,818181818181818;0,954545454545455
"2597";348235;88;15870;5;72;88;16;0,818181818181818;1
"2598";348235;88;15871;6;70;76;6;0,795454545454545;0,863636363636364
"2599";348235;88;15872;6;70;78;8;0,795454545454545;0,886363636363636
"2600";348235;88;15873;6;70;80;10;0,795454545454545;0,909090909090909
"2601";348235;88;15874;6;70;82;12;0,795454545454545;0,931818181818182
"2602";348235;88;15875;6;70;84;14;0,795454545454545;0,954545454545455
"2603";348235;88;15876;6;46;52;6;0,522727272727273;0,590909090909091
"2604";350148;217;15909;5;31;56;25;0,148148148148148;0,259259259259259
"2605";350148;217;15910;6;7;19;12;0,037037037037037;0,0925925925925926
"2606";350148;217;15911;6;11;23;12;0,0555555555555556;0,111111111111111
"2607";350148;217;15912;6;7;23;16;0,037037037037037;0,111111111111111
"2608";350148;217;15913;6;27;39;12;0,12962962962963;0,185185185185185
"2609";350148;217;15914;6;27;43;16;0,12962962962963;0,203703703703704
"2610";350148;217;15915;6;96;108;12;0,444444444444444;0,5
"2611";350148;217;15916;6;173;185;12;0,796296296296296;0,851851851851852
"2612";350148;217;15917;6;173;189;16;0,796296296296296;0,87037037037037
"2613";350148;217;15918;6;181;193;12;0,833333333333333;0,888888888888889
"2614";350148;217;15919;6;185;197;12;0,851851851851852;0,907407407407407
"2615";350148;217;15920;6;201;213;12;0,925925925925926;0,981481481481482
"2616";350148;217;15921;6;177;189;12;0,814814814814815;0,87037037037037
"2617";350148;217;15922;6;177;193;16;0,814814814814815;0,888888888888889
"2618";350148;217;15923;6;177;197;20;0,814814814814815;0,907407407407407
"2619";350148;217;15924;6;205;217;12;0,944444444444444;1
"2620";350148;217;15925;6;181;197;16;0,833333333333333;0,907407407407407
"2621";350148;217;15926;6;201;217;16;0,925925925925926;1
"2622";350148;217;15927;6;27;47;20;0,12962962962963;0,222222222222222
"2623";350148;217;15928;6;27;51;24;0,12962962962963;0,240740740740741
"2624";350148;217;15929;6;197;209;12;0,907407407407407;0,962962962962963
"2625";360279;47;15993;3;23;47;24;0,5;1
"2626";360279;47;15994;4;15;27;12;0,333333333333333;0,583333333333333
"2627";360279;47;15995;4;27;39;12;0,583333333333333;0,833333333333333
"2628";360279;47;15996;4;31;43;12;0,666666666666667;0,916666666666667
"2629";360279;47;15997;4;31;47;16;0,666666666666667;1
"2630";360279;47;15998;5;13;19;6;0,291666666666667;0,416666666666667
"2631";360279;47;15999;5;13;21;8;0,291666666666667;0,458333333333333
"2632";360279;47;16000;5;17;23;6;0,375;0,5
"2633";360279;47;16001;5;29;35;6;0,625;0,75
"2634";360279;47;16002;5;29;37;8;0,625;0,791666666666667
"2635";360279;47;16003;5;13;23;10;0,291666666666667;0,5
"2636";360279;47;16004;5;19;25;6;0,416666666666667;0,541666666666667
"2637";360279;47;16005;5;19;27;8;0,416666666666667;0,583333333333333
"2638";360279;47;16006;5;27;33;6;0,583333333333333;0,708333333333333
"2639";360279;47;16007;5;17;25;8;0,375;0,541666666666667
"2640";360279;47;16008;5;17;27;10;0,375;0,583333333333333
