"";"pid";"max.age";"seq.id";"seq.revlevel";"seq.start";"seq.end";"seq.length";"seq.start.rel";"seq.end.rel"
"1";4740;63;1;4;39;63;24;0,625;1
"2";4740;63;2;5;27;39;12;0,4375;0,625
"3";4740;63;3;5;23;35;12;0,375;0,5625
"4";4740;63;4;5;7;19;12;0,125;0,3125
"5";4740;63;5;5;11;23;12;0,1875;0,375
"6";4740;63;6;5;43;55;12;0,6875;0,875
"7";4740;63;7;5;39;51;12;0,625;0,8125
"8";4740;63;8;5;47;59;12;0,75;0,9375
"9";4740;63;9;5;23;39;16;0,375;0,625
"10";4740;63;10;6;31;37;6;0,5;0,59375
"11";4740;63;11;6;41;47;6;0,65625;0,75
"12";4740;63;12;6;7;13;6;0,125;0,21875
"13";4740;63;13;6;11;17;6;0,1875;0,28125
"14";4740;63;14;6;13;19;6;0,21875;0,3125
"15";4740;63;15;6;13;21;8;0,21875;0,34375
"16";4740;63;16;6;15;21;6;0,25;0,34375
"17";4740;63;17;6;15;23;8;0,25;0,375
"18";4740;63;18;6;29;35;6;0,46875;0,5625
"19";4740;63;19;6;9;15;6;0,15625;0,25
"20";4740;63;20;6;9;17;8;0,15625;0,28125
"21";4740;63;21;6;25;31;6;0,40625;0,5
"22";4740;63;22;6;43;49;6;0,6875;0,78125
"23";4740;63;23;6;57;63;6;0,90625;1
"24";4740;63;24;6;17;23;6;0,28125;0,375
"25";4740;63;25;6;53;59;6;0,84375;0,9375
"26";4740;63;26;6;11;19;8;0,1875;0,3125
"27";4740;63;27;6;11;21;10;0,1875;0,34375
"28";4740;63;28;6;29;37;8;0,46875;0,59375
"29";4740;63;29;6;33;39;6;0,53125;0,625
"30";4740;63;30;6;27;33;6;0,4375;0,53125
"31";4740;63;31;6;9;19;10;0,15625;0,3125
"32";4740;63;32;6;27;35;8;0,4375;0,5625
"33";4740;63;33;6;39;45;6;0,625;0,71875
"34";4740;63;34;6;43;51;8;0,6875;0,8125
"35";4740;63;35;6;31;39;8;0,5;0,625
"36";4740;63;36;6;23;29;6;0,375;0,46875
"37";4740;63;37;6;7;15;8;0,125;0,25
"38";4740;63;38;6;41;49;8;0,65625;0,78125
"39";4740;63;39;6;45;51;6;0,71875;0,8125
"40";4740;63;40;6;5;11;6;0,09375;0,1875
"41";4740;63;41;6;25;33;8;0,40625;0,53125
"42";4740;63;42;6;25;35;10;0,40625;0,5625
"43";4740;63;43;6;29;39;10;0,46875;0,625
"44";4740;63;44;6;27;37;10;0,4375;0,59375
"45";4740;63;45;6;7;17;10;0,125;0,28125
"46";4740;63;46;6;7;19;12;0,125;0,3125
"47";4740;63;47;6;47;53;6;0,75;0,84375
"48";4740;63;48;6;13;23;10;0,21875;0,375
"49";585077;24;49;3;7;20;13;0,333333333333333;0,833333333333333
"50";585077;24;50;3;7;24;17;0,333333333333333;1
"51";585077;24;51;4;7;14;7;0,333333333333333;0,583333333333333
"52";585077;24;52;4;7;16;9;0,333333333333333;0,666666666666667
"53";585077;24;53;4;7;18;11;0,333333333333333;0,75
"54";585077;24;54;4;7;20;13;0,333333333333333;0,833333333333333
"55";585077;24;55;4;7;22;15;0,333333333333333;0,916666666666667
"56";585077;24;56;4;7;24;17;0,333333333333333;1
"57";3429;101;57;3;50;101;51;0,5;1
"58";3429;101;58;4;76;101;25;0,75;1
"59";3429;101;59;4;67;92;25;0,666666666666667;0,916666666666667
"60";3429;101;60;4;67;101;34;0,666666666666667;1
"61";3429;101;61;4;59;84;25;0,583333333333333;0,833333333333333
"62";3429;101;62;4;42;67;25;0,416666666666667;0,666666666666667
"63";3429;101;63;5;77;89;12;0,76;0,88
"64";3429;101;64;5;77;93;16;0,76;0,92
"65";3429;101;65;5;81;93;12;0,8;0,92
"66";3429;101;66;5;81;97;16;0,8;0,96
"67";3429;101;67;5;85;97;12;0,84;0,96
"68";3429;101;68;5;72;85;13;0,72;0,84
"69";3429;101;69;5;77;97;20;0,76;0,96
"70";3429;101;70;5;77;101;24;0,76;1
"71";3429;101;71;5;81;101;20;0,8;1
"72";3429;101;72;5;85;101;16;0,84;1
"73";3429;101;73;5;89;101;12;0,88;1
"74";3429;101;74;5;7;19;12;0,08;0,2
"75";3429;101;75;5;72;89;17;0,72;0,88
"76";3429;101;76;5;36;48;12;0,36;0,48
"77";3429;101;77;5;72;93;21;0,72;0,92
"78";3429;101;78;5;72;97;25;0,72;0,96
"79";3429;101;79;6;85;91;6;0,843137254901961;0,901960784313726
"80";3429;101;80;6;91;97;6;0,901960784313726;0,96078431372549
"81";3429;101;81;6;43;49;6;0,431372549019608;0,490196078431373
"82";3429;101;82;6;75;81;6;0,745098039215686;0,803921568627451
"83";3429;101;83;6;75;83;8;0,745098039215686;0,823529411764706
"84";3429;101;84;6;75;85;10;0,745098039215686;0,843137254901961
"85";3429;101;85;6;77;83;6;0,764705882352941;0,823529411764706
"86";3429;101;86;6;77;85;8;0,764705882352941;0,843137254901961
"87";3429;101;87;6;77;87;10;0,764705882352941;0,862745098039216
"88";3429;101;88;6;79;85;6;0,784313725490196;0,843137254901961
"89";3429;101;89;6;81;87;6;0,803921568627451;0,862745098039216
"90";3429;101;90;6;81;89;8;0,803921568627451;0,882352941176471
"91";3429;101;91;6;81;91;10;0,803921568627451;0,901960784313726
"92";3429;101;92;6;83;89;6;0,823529411764706;0,882352941176471
"93";3429;101;93;6;83;91;8;0,823529411764706;0,901960784313726
"94";3429;101;94;6;85;93;8;0,843137254901961;0,92156862745098
"95";3429;101;95;6;85;95;10;0,843137254901961;0,941176470588235
"96";3429;101;96;6;85;97;12;0,843137254901961;0,96078431372549
"97";3429;101;97;6;89;95;6;0,882352941176471;0,941176470588235
"98";3429;101;98;6;89;97;8;0,882352941176471;0,96078431372549
"99";3429;101;99;6;89;99;10;0,882352941176471;0,980392156862745
"100";3429;101;100;6;89;101;12;0,882352941176471;1
"101";3429;101;101;6;91;99;8;0,901960784313726;0,980392156862745
"102";3429;101;102;6;91;101;10;0,901960784313726;1
"103";3429;101;103;6;93;99;6;0,92156862745098;0,980392156862745
"104";3429;101;104;6;77;89;12;0,764705882352941;0,882352941176471
"105";3429;101;105;6;77;91;14;0,764705882352941;0,901960784313726
"106";3429;101;106;6;77;93;16;0,764705882352941;0,92156862745098
"107";3429;101;107;6;77;95;18;0,764705882352941;0,941176470588235
"108";3429;101;108;6;77;97;20;0,764705882352941;0,96078431372549
"109";3429;101;109;6;79;87;8;0,784313725490196;0,862745098039216
"110";3429;101;110;6;79;89;10;0,784313725490196;0,882352941176471
"111";3429;101;111;6;79;91;12;0,784313725490196;0,901960784313726
"112";3429;101;112;6;81;93;12;0,803921568627451;0,92156862745098
"113";3429;101;113;6;81;95;14;0,803921568627451;0,941176470588235
"114";3429;101;114;6;81;97;16;0,803921568627451;0,96078431372549
"115";3429;101;115;6;81;99;18;0,803921568627451;0,980392156862745
"116";3429;101;116;6;83;93;10;0,823529411764706;0,92156862745098
"117";3429;101;117;6;83;95;12;0,823529411764706;0,941176470588235
"118";3429;101;118;6;83;97;14;0,823529411764706;0,96078431372549
"119";3429;101;119;6;83;99;16;0,823529411764706;0,980392156862745
"120";3429;101;120;6;87;93;6;0,862745098039216;0,92156862745098
"121";3429;101;121;6;87;95;8;0,862745098039216;0,941176470588235
"122";3429;101;122;6;87;97;10;0,862745098039216;0,96078431372549
"123";3429;101;123;6;83;101;18;0,823529411764706;1
"124";3429;101;124;6;85;99;14;0,843137254901961;0,980392156862745
"125";3429;101;125;6;85;101;16;0,843137254901961;1
"126";3429;101;126;6;93;101;8;0,92156862745098;1
"127";3429;101;127;6;87;99;12;0,862745098039216;0,980392156862745
"128";3429;101;128;6;87;101;14;0,862745098039216;1
"129";3429;101;129;6;77;99;22;0,764705882352941;0,980392156862745
"130";3429;101;130;6;77;101;24;0,764705882352941;1
"131";3429;101;131;6;81;101;20;0,803921568627451;1
"132";3429;101;132;6;41;47;6;0,411764705882353;0,470588235294118
"133";3429;101;133;6;73;79;6;0,725490196078431;0,784313725490196
"134";3429;101;134;6;73;81;8;0,725490196078431;0,803921568627451
"135";3429;101;135;6;37;43;6;0,372549019607843;0,431372549019608
"136";3429;101;136;6;13;19;6;0,137254901960784;0,196078431372549
"137";3429;101;137;6;33;39;6;0,333333333333333;0,392156862745098
"138";3429;101;138;6;35;41;6;0,352941176470588;0,411764705882353
"139";3429;101;139;6;41;49;8;0,411764705882353;0,490196078431373
"140";3429;101;140;6;73;83;10;0,725490196078431;0,823529411764706
"141";3429;101;141;6;55;61;6;0,549019607843137;0,607843137254902
"142";3429;101;142;6;75;87;12;0,745098039215686;0,862745098039216
"143";3429;101;143;6;75;89;14;0,745098039215686;0,882352941176471
"144";3429;101;144;6;79;93;14;0,784313725490196;0,92156862745098
"145";3429;101;145;6;79;95;16;0,784313725490196;0,941176470588235
"146";3429;101;146;6;79;97;18;0,784313725490196;0,96078431372549
"147";3429;101;147;6;79;99;20;0,784313725490196;0,980392156862745
"148";3429;101;148;6;79;101;22;0,784313725490196;1
"149";3429;101;149;6;39;45;6;0,392156862745098;0,450980392156863
"150";3429;101;150;6;53;59;6;0,529411764705882;0,588235294117647
"151";3429;101;151;6;11;17;6;0,117647058823529;0,176470588235294
"152";3429;101;152;6;75;91;16;0,745098039215686;0,901960784313726
"153";3429;101;153;6;9;15;6;0,0980392156862745;0,156862745098039
"154";3429;101;154;6;73;85;12;0,725490196078431;0,843137254901961
"155";346391;48;155;3;24;48;24;0,5;1
"156";346391;48;156;4;7;19;12;0,166666666666667;0,416666666666667
"157";346391;48;157;4;24;36;12;0,5;0,75
"158";346391;48;158;4;7;24;17;0,166666666666667;0,5
"159";346391;48;159;4;11;24;13;0,25;0,5
"160";346391;48;160;4;24;40;16;0,5;0,833333333333333
"161";346391;48;161;4;24;44;20;0,5;0,916666666666667
"162";346391;48;162;4;28;40;12;0,583333333333333;0,833333333333333
"163";346391;48;163;4;28;44;16;0,583333333333333;0,916666666666667
"164";346391;48;164;4;3;15;12;0,0833333333333333;0,333333333333333
"165";346391;48;165;4;3;19;16;0,0833333333333333;0,416666666666667
"166";346391;48;166;4;28;48;20;0,583333333333333;1
"167";346391;48;167;4;24;48;24;0,5;1
"168";346391;48;168;5;7;13;6;0,166666666666667;0,291666666666667
"169";346391;48;169;5;24;30;6;0,5;0,625
"170";346391;48;170;5;7;15;8;0,166666666666667;0,333333333333333
"171";346391;48;171;5;11;17;6;0,25;0,375
"172";346391;48;172;5;11;19;8;0,25;0,416666666666667
"173";346391;48;173;5;17;24;7;0,375;0,5
"174";346391;48;174;5;24;32;8;0,5;0,666666666666667
"175";346391;48;175;5;24;34;10;0,5;0,708333333333333
"176";346391;48;176;5;28;34;6;0,583333333333333;0,708333333333333
"177";346391;48;177;5;28;36;8;0,583333333333333;0,75
"178";346391;48;178;5;28;38;10;0,583333333333333;0,791666666666667
"179";346391;48;179;5;1;7;6;0,0416666666666667;0,166666666666667
"180";346391;48;180;5;7;17;10;0,166666666666667;0,375
"181";346391;48;181;5;7;19;12;0,166666666666667;0,416666666666667
"182";346391;48;182;5;7;21;14;0,166666666666667;0,458333333333333
"183";346391;48;183;5;7;24;17;0,166666666666667;0,5
"184";346391;48;184;5;11;21;10;0,25;0,458333333333333
"185";346391;48;185;5;24;36;12;0,5;0,75
"186";346391;48;186;5;24;38;14;0,5;0,791666666666667
"187";346391;48;187;5;24;40;16;0,5;0,833333333333333
"188";346391;48;188;5;24;42;18;0,5;0,875
"189";346391;48;189;5;28;40;12;0,583333333333333;0,833333333333333
"190";346391;48;190;5;28;42;14;0,583333333333333;0,875
"191";346391;48;191;5;28;44;16;0,583333333333333;0,916666666666667
"192";346391;48;192;5;28;46;18;0,583333333333333;0,958333333333333
"193";346391;48;193;5;11;24;13;0,25;0,5
"194";346391;48;194;5;5;11;6;0,125;0,25
"195";346391;48;195;5;5;13;8;0,125;0,291666666666667
"196";346391;48;196;5;5;15;10;0,125;0,333333333333333
"197";346391;48;197;5;5;17;12;0,125;0,375
"198";346391;48;198;5;5;19;14;0,125;0,416666666666667
"199";346391;48;199;5;5;21;16;0,125;0,458333333333333
"200";346391;48;200;5;24;44;20;0,5;0,916666666666667
"201";346391;48;201;5;24;46;22;0,5;0,958333333333333
"202";346391;48;202;5;5;24;19;0,125;0,5
"203";4673;82;203;3;32;82;50;0,4;1
"204";4673;82;204;3;16;65;49;0,2;0,8
"205";4673;82;205;3;16;82;66;0,2;1
"206";4673;82;206;4;32;57;25;0,4;0,7
"207";4673;82;207;4;24;49;25;0,3;0,6
"208";4673;82;208;4;24;57;33;0,3;0,7
"209";4673;82;209;4;24;65;41;0,3;0,8
"210";4673;82;210;4;24;74;50;0,3;0,9
"211";4673;82;211;4;32;65;33;0,4;0,8
"212";4673;82;212;4;32;74;42;0,4;0,9
"213";4673;82;213;4;49;74;25;0,6;0,9
"214";4673;82;214;4;16;40;24;0,2;0,5
"215";4673;82;215;4;16;49;33;0,2;0,6
"216";4673;82;216;4;32;82;50;0,4;1
"217";4673;82;217;4;40;65;25;0,5;0,8
"218";4673;82;218;4;40;74;34;0,5;0,9
"219";4673;82;219;4;16;57;41;0,2;0,7
"220";4673;82;220;4;16;65;49;0,2;0,8
"221";4673;82;221;4;16;74;58;0,2;0,9
"222";4673;82;222;4;49;82;33;0,6;1
"223";4673;82;223;4;24;82;58;0,3;1
"224";4673;82;224;4;7;32;25;0,1;0,4
"225";4673;82;225;5;28;40;12;0,35;0,5
"226";4673;82;226;5;24;36;12;0,3;0,45
"227";4673;82;227;5;24;40;16;0,3;0,5
"228";4673;82;228;5;24;45;21;0,3;0,55
"229";4673;82;229;5;24;49;25;0,3;0,6
"230";4673;82;230;5;28;45;17;0,35;0,55
"231";4673;82;231;5;28;49;21;0,35;0,6
"232";4673;82;232;5;49;61;12;0,6;0,75
"233";4673;82;233;5;70;82;12;0,85;1
"234";4673;82;234;5;24;53;29;0,3;0,65
"235";4673;82;235;5;24;57;33;0,3;0,7
"236";4673;82;236;5;24;61;37;0,3;0,75
"237";4673;82;237;5;24;65;41;0,3;0,8
"238";4673;82;238;5;24;70;46;0,3;0,85
"239";4673;82;239;5;24;74;50;0,3;0,9
"240";4673;82;240;5;24;78;54;0,3;0,95
"241";4673;82;241;5;28;53;25;0,35;0,65
"242";4673;82;242;5;28;57;29;0,35;0,7
"243";4673;82;243;5;28;61;33;0,35;0,75
"244";4673;82;244;5;28;65;37;0,35;0,8
"245";4673;82;245;5;28;70;42;0,35;0,85
"246";4673;82;246;5;28;74;46;0,35;0,9
"247";4673;82;247;5;40;53;13;0,5;0,65
"248";4673;82;248;5;40;57;17;0,5;0,7
"249";4673;82;249;5;40;61;21;0,5;0,75
"250";4673;82;250;5;40;65;25;0,5;0,8
"251";4673;82;251;5;40;70;30;0,5;0,85
"252";4673;82;252;5;40;74;34;0,5;0,9
"253";4673;82;253;5;49;65;16;0,6;0,8
"254";4673;82;254;5;49;70;21;0,6;0,85
"255";4673;82;255;5;49;74;25;0,6;0,9
"256";4673;82;256;5;16;28;12;0,2;0,35
"257";4673;82;257;5;49;78;29;0,6;0,95
"258";4673;82;258;5;45;57;12;0,55;0,7
"259";4673;82;259;5;45;61;16;0,55;0,75
"260";4673;82;260;5;45;65;20;0,55;0,8
"261";4673;82;261;5;45;70;25;0,55;0,85
"262";4673;82;262;5;45;74;29;0,55;0,9
"263";4673;82;263;5;20;32;12;0,25;0,4
"264";4673;82;264;5;11;24;13;0,15;0,3
"265";4673;82;265;5;3;16;13;0,05;0,2
"266";4673;82;266;5;7;20;13;0,1;0,25
"267";4673;82;267;5;16;32;16;0,2;0,4
"268";4673;82;268;6;17;23;6;0,219512195121951;0,292682926829268
"269";4673;82;269;6;27;33;6;0,341463414634146;0,414634146341463
"270";4673;82;270;6;29;35;6;0,365853658536585;0,439024390243902
"271";4673;82;271;6;23;29;6;0,292682926829268;0,365853658536585
"272";4673;82;272;6;23;31;8;0,292682926829268;0,390243902439024
"273";4673;82;273;6;27;35;8;0,341463414634146;0,439024390243902
"274";4673;82;274;6;27;37;10;0,341463414634146;0,463414634146341
"275";4673;82;275;6;27;39;12;0,341463414634146;0,48780487804878
"276";4673;82;276;6;29;37;8;0,365853658536585;0,463414634146341
"277";4673;82;277;6;29;39;10;0,365853658536585;0,48780487804878
"278";4673;82;278;6;29;42;13;0,365853658536585;0,51219512195122
"279";4673;82;279;6;46;52;6;0,560975609756098;0,634146341463415
"280";4673;82;280;6;46;54;8;0,560975609756098;0,658536585365854
"281";4673;82;281;6;46;56;10;0,560975609756098;0,682926829268293
"282";4673;82;282;6;46;58;12;0,560975609756098;0,707317073170732
"283";4673;82;283;6;48;54;6;0,585365853658537;0,658536585365854
"284";4673;82;284;6;72;78;6;0,878048780487805;0,951219512195122
"285";4673;82;285;6;74;80;6;0,902439024390244;0,975609756097561
"286";4673;82;286;6;9;15;6;0,121951219512195;0,195121951219512
"287";4673;82;287;6;27;42;15;0,341463414634146;0,51219512195122
"288";4673;82;288;6;27;44;17;0,341463414634146;0,536585365853659
"289";4673;82;289;6;27;46;19;0,341463414634146;0,560975609756098
"290";4673;82;290;6;27;48;21;0,341463414634146;0,585365853658537
"291";4673;82;291;6;27;50;23;0,341463414634146;0,609756097560976
"292";4673;82;292;6;27;52;25;0,341463414634146;0,634146341463415
"293";4673;82;293;6;27;54;27;0,341463414634146;0,658536585365854
"294";4673;82;294;6;27;56;29;0,341463414634146;0,682926829268293
"295";4673;82;295;6;29;44;15;0,365853658536585;0,536585365853659
"296";4673;82;296;6;29;46;17;0,365853658536585;0,560975609756098
"297";4673;82;297;6;44;50;6;0,536585365853659;0,609756097560976
"298";4673;82;298;6;44;52;8;0,536585365853659;0,634146341463415
"299";4673;82;299;6;44;54;10;0,536585365853659;0,658536585365854
"300";4673;82;300;6;44;56;12;0,536585365853659;0,682926829268293
"301";4673;82;301;6;44;58;14;0,536585365853659;0,707317073170732
"302";4673;82;302;6;44;60;16;0,536585365853659;0,731707317073171
"303";4673;82;303;6;48;56;8;0,585365853658537;0,682926829268293
"304";4673;82;304;6;48;58;10;0,585365853658537;0,707317073170732
"305";4673;82;305;6;48;60;12;0,585365853658537;0,731707317073171
"306";4673;82;306;6;70;76;6;0,853658536585366;0,926829268292683
"307";4673;82;307;6;70;78;8;0,853658536585366;0,951219512195122
"308";4673;82;308;6;72;80;8;0,878048780487805;0,975609756097561
"309";4673;82;309;6;72;82;10;0,878048780487805;1
"310";4673;82;310;6;74;82;8;0,902439024390244;1
"311";4673;82;311;6;7;13;6;0,0975609756097561;0,170731707317073
"312";4673;82;312;6;7;15;8;0,0975609756097561;0,195121951219512
"313";4673;82;313;6;25;31;6;0,317073170731707;0,390243902439024
"314";4673;82;314;6;25;33;8;0,317073170731707;0,414634146341463
"315";4673;82;315;6;23;33;10;0,292682926829268;0,414634146341463
"316";4673;82;316;6;11;17;6;0,146341463414634;0,219512195121951
"317";4673;82;317;6;5;11;6;0,0731707317073171;0,146341463414634
"318";4673;82;318;6;15;21;6;0,195121951219512;0,268292682926829
"319";4673;82;319;6;25;35;10;0,317073170731707;0,439024390243902
"320";4673;82;320;6;48;62;14;0,585365853658537;0,75609756097561
"321";4673;82;321;6;48;64;16;0,585365853658537;0,780487804878049
"322";4673;82;322;6;48;66;18;0,585365853658537;0,804878048780488
"323";4673;82;323;6;48;68;20;0,585365853658537;0,829268292682927
"324";4673;82;324;6;48;70;22;0,585365853658537;0,853658536585366
"325";4673;82;325;6;48;72;24;0,585365853658537;0,878048780487805
"326";4673;82;326;6;48;74;26;0,585365853658537;0,902439024390244
"327";4673;82;327;6;23;35;12;0,292682926829268;0,439024390243902
"328";4673;82;328;6;23;37;14;0,292682926829268;0,463414634146341
"329";4673;82;329;6;23;39;16;0,292682926829268;0,48780487804878
"330";4673;82;330;6;25;37;12;0,317073170731707;0,463414634146341
"331";4673;82;331;6;25;39;14;0,317073170731707;0,48780487804878
"332";4673;82;332;6;25;42;17;0,317073170731707;0,51219512195122
"333";4673;82;333;6;25;44;19;0,317073170731707;0,536585365853659
"334";4673;82;334;6;25;46;21;0,317073170731707;0,560975609756098
"335";4673;82;335;6;25;48;23;0,317073170731707;0,585365853658537
"336";4673;82;336;6;25;50;25;0,317073170731707;0,609756097560976
"337";4673;82;337;6;13;19;6;0,170731707317073;0,24390243902439
"338";4673;82;338;6;46;60;14;0,560975609756098;0,731707317073171
"339";4673;82;339;6;21;27;6;0,268292682926829;0,341463414634146
"340";4673;82;340;6;21;29;8;0,268292682926829;0,365853658536585
"341";4673;82;341;6;9;17;8;0,121951219512195;0,219512195121951
"342";4673;82;342;6;23;42;19;0,292682926829268;0,51219512195122
"343";4673;82;343;6;29;48;19;0,365853658536585;0,585365853658537
"344";4673;82;344;6;44;62;18;0,536585365853659;0,75609756097561
"345";4673;82;345;6;46;62;16;0,560975609756098;0,75609756097561
"346";4673;82;346;6;46;64;18;0,560975609756098;0,780487804878049
"347";4673;82;347;6;46;66;20;0,560975609756098;0,804878048780488
"348";4673;82;348;6;13;21;8;0,170731707317073;0,268292682926829
"349";4673;82;349;6;44;64;20;0,536585365853659;0,780487804878049
"350";4673;82;350;6;44;66;22;0,536585365853659;0,804878048780488
"351";4673;82;351;6;44;68;24;0,536585365853659;0,829268292682927
"352";4673;82;352;6;44;70;26;0,536585365853659;0,853658536585366
"353";4673;82;353;6;23;44;21;0,292682926829268;0,536585365853659
"354";4673;82;354;6;23;46;23;0,292682926829268;0,560975609756098
"355";4673;82;355;6;23;48;25;0,292682926829268;0,585365853658537
"356";4673;82;356;6;27;58;31;0,341463414634146;0,707317073170732
"357";4673;82;357;6;27;60;33;0,341463414634146;0,731707317073171
"358";4673;82;358;6;17;25;8;0,219512195121951;0,317073170731707
"359";4673;82;359;6;46;68;22;0,560975609756098;0,829268292682927
"360";4673;82;360;6;27;62;35;0,341463414634146;0,75609756097561
"361";4673;82;361;6;27;64;37;0,341463414634146;0,780487804878049
"362";4673;82;362;6;29;50;21;0,365853658536585;0,609756097560976
"363";4673;82;363;6;29;52;23;0,365853658536585;0,634146341463415
"364";4673;82;364;6;29;54;25;0,365853658536585;0,658536585365854
"365";4673;82;365;6;29;56;27;0,365853658536585;0,682926829268293
"366";4673;82;366;6;29;58;29;0,365853658536585;0,707317073170732
"367";4673;82;367;6;29;60;31;0,365853658536585;0,731707317073171
"368";4673;82;368;6;29;62;33;0,365853658536585;0,75609756097561
"369";4673;82;369;6;29;64;35;0,365853658536585;0,780487804878049
"370";4673;82;370;6;44;72;28;0,536585365853659;0,878048780487805
"371";4673;82;371;6;46;70;24;0,560975609756098;0,853658536585366
"372";4673;82;372;6;46;72;26;0,560975609756098;0,878048780487805
"373";4673;82;373;6;25;52;27;0,317073170731707;0,634146341463415
"374";4673;82;374;6;25;54;29;0,317073170731707;0,658536585365854
"375";4673;82;375;6;25;56;31;0,317073170731707;0,682926829268293
"376";4673;82;376;6;25;58;33;0,317073170731707;0,707317073170732
"377";472388;43;377;3;17;43;26;0,4;1
"378";472388;43;378;4;31;43;12;0,727272727272727;1
"379";472388;43;379;4;19;31;12;0,454545454545455;0,727272727272727
"380";472388;43;380;4;27;39;12;0,636363636363636;0,909090909090909
"381";472388;43;381;4;3;15;12;0,0909090909090909;0,363636363636364
"382";472388;43;382;4;23;35;12;0,545454545454545;0,818181818181818
"383";472388;43;383;4;7;19;12;0,181818181818182;0,454545454545455
"384";472388;43;384;4;27;43;16;0,636363636363636;1
"385";472388;43;385;5;29;35;6;0,681818181818182;0,818181818181818
"386";472388;43;386;5;29;37;8;0,681818181818182;0,863636363636364
"387";472388;43;387;5;31;37;6;0,727272727272727;0,863636363636364
"388";472388;43;388;5;7;13;6;0,181818181818182;0,318181818181818
"389";472388;43;389;5;35;41;6;0,818181818181818;0,954545454545455
"390";472388;43;390;5;35;43;8;0,818181818181818;1
"391";472388;43;391;5;37;43;6;0,863636363636364;1
"392";472388;43;392;5;3;9;6;0,0909090909090909;0,227272727272727
"393";472388;43;393;5;5;11;6;0,136363636363636;0,272727272727273
"394";472388;43;394;5;9;15;6;0,227272727272727;0,363636363636364
"395";472388;43;395;5;11;17;6;0,272727272727273;0,409090909090909
"396";472388;43;396;5;33;39;6;0,772727272727273;0,909090909090909
"397";472388;43;397;5;29;39;10;0,681818181818182;0,909090909090909
"398";472388;43;398;5;29;41;12;0,681818181818182;0,954545454545455
"399";472388;43;399;5;27;33;6;0,636363636363636;0,772727272727273
"400";472388;43;400;5;19;25;6;0,454545454545455;0,590909090909091
"401";472388;43;401;5;1;7;6;0,0454545454545455;0,181818181818182
"402";472388;43;402;5;31;39;8;0,727272727272727;0,909090909090909
"403";472388;43;403;5;31;41;10;0,727272727272727;0,954545454545455
"404";472388;43;404;5;25;31;6;0,590909090909091;0,727272727272727
"405";472388;43;405;5;33;41;8;0,772727272727273;0,954545454545455
"406";472388;43;406;5;33;43;10;0,772727272727273;1
"407";472388;43;407;5;27;35;8;0,636363636363636;0,818181818181818
"408";472388;43;408;5;15;21;6;0,363636363636364;0,5
"409";472388;43;409;5;29;43;14;0,681818181818182;1
"410";472388;43;410;5;31;43;12;0,727272727272727;1
"411";472388;43;411;5;21;27;6;0,5;0,636363636363636
"412";472388;43;412;5;17;23;6;0,409090909090909;0,545454545454545
"413";472388;43;413;5;27;37;10;0,636363636363636;0,863636363636364
"414";472388;43;414;5;9;17;8;0,227272727272727;0,409090909090909
"415";23897;59;415;4;39;51;12;0,666666666666667;0,866666666666667
"416";23897;59;416;4;15;27;12;0,266666666666667;0,466666666666667
"417";23897;59;417;4;43;55;12;0,733333333333333;0,933333333333333
"418";23897;59;418;4;47;59;12;0,8;1
"419";23897;59;419;4;39;55;16;0,666666666666667;0,933333333333333
"420";23897;59;420;5;21;27;6;0,366666666666667;0,466666666666667
"421";23897;59;421;5;23;29;6;0,4;0,5
"422";23897;59;422;5;49;55;6;0,833333333333333;0,933333333333333
"423";23897;59;423;5;51;57;6;0,866666666666667;0,966666666666667
"424";23897;59;424;5;39;45;6;0,666666666666667;0,766666666666667
"425";23897;59;425;5;53;59;6;0,9;1
"426";23897;59;426;5;39;47;8;0,666666666666667;0,8
"427";23897;59;427;5;41;47;6;0,7;0,8
"428";23897;59;428;5;41;49;8;0,7;0,833333333333333
"429";23897;59;429;5;43;49;6;0,733333333333333;0,833333333333333
"430";23897;59;430;5;21;29;8;0,366666666666667;0,5
"431";23897;59;431;5;37;43;6;0,633333333333333;0,733333333333333
"432";23897;59;432;5;37;45;8;0,633333333333333;0,766666666666667
"433";23897;59;433;5;49;57;8;0,833333333333333;0,966666666666667
"434";23897;59;434;5;13;19;6;0,233333333333333;0,333333333333333
"435";23897;59;435;5;15;21;6;0,266666666666667;0,366666666666667
"436";23897;59;436;5;51;59;8;0,866666666666667;1
"437";23897;59;437;5;19;25;6;0,333333333333333;0,433333333333333
"438";23897;59;438;5;9;15;6;0,166666666666667;0,266666666666667
"439";23897;59;439;5;19;27;8;0,333333333333333;0,466666666666667
"440";23897;59;440;5;19;29;10;0,333333333333333;0,5
"441";23897;59;441;5;45;51;6;0,766666666666667;0,866666666666667
"442";23897;59;442;5;5;11;6;0,1;0,2
"443";23897;59;443;5;11;17;6;0,2;0,3
"444";23897;59;444;5;39;49;10;0,666666666666667;0,833333333333333
"445";23897;59;445;5;47;53;6;0,8;0,9
"446";23897;59;446;5;43;51;8;0,733333333333333;0,866666666666667
"447";23897;59;447;5;37;47;10;0,633333333333333;0,8
"448";7278;169;448;3;67;169;102;0,4;1
"449";7278;169;449;3;33;135;102;0,2;0,8
"450";7278;169;450;4;118;169;51;0,7;1
"451";7278;169;451;4;84;135;51;0,5;0,8
"452";7278;169;452;4;101;152;51;0,6;0,9
"453";7278;169;453;4;50;101;51;0,3;0,6
"454";7278;169;454;4;16;67;51;0,1;0,4
"455";7278;169;455;4;67;118;51;0,4;0,7
"456";7278;169;456;4;33;84;51;0,2;0,5
"457";7278;169;457;5;48;72;24;0,285714285714286;0,428571428571429
"458";7278;169;458;5;72;96;24;0,428571428571429;0,571428571428571
"459";7278;169;459;5;80;104;24;0,476190476190476;0,619047619047619
"460";7278;169;460;5;88;112;24;0,523809523809524;0,666666666666667
"461";7278;169;461;5;120;145;25;0,714285714285714;0,857142857142857
"462";7278;169;462;5;129;153;24;0,761904761904762;0,904761904761905
"463";7278;169;463;5;145;169;24;0,857142857142857;1
"464";7278;169;464;5;7;31;24;0,0476190476190476;0,19047619047619
"465";7278;169;465;5;64;88;24;0,380952380952381;0,523809523809524
"466";7278;169;466;5;39;64;25;0,238095238095238;0,380952380952381
"467";7278;169;467;5;15;39;24;0,0952380952380952;0,238095238095238
"468";7278;169;468;5;137;161;24;0,80952380952381;0,952380952380952
"469";7278;169;469;5;31;56;25;0,19047619047619;0,333333333333333
"470";7278;169;470;5;23;48;25;0,142857142857143;0,285714285714286
"471";7278;169;471;5;56;80;24;0,333333333333333;0,476190476190476
"472";7278;169;472;6;133;145;12;0,785714285714286;0,857142857142857
"473";7278;169;473;6;19;31;12;0,119047619047619;0,19047619047619
"474";7278;169;474;6;35;48;13;0,214285714285714;0,285714285714286
"475";7278;169;475;6;48;60;12;0,285714285714286;0,357142857142857
"476";7278;169;476;6;56;68;12;0,333333333333333;0,404761904761905
"477";7278;169;477;6;84;96;12;0,5;0,571428571428571
"478";7278;169;478;6;84;100;16;0,5;0,595238095238095
"479";7278;169;479;6;92;104;12;0,547619047619048;0,619047619047619
"480";7278;169;480;6;120;133;13;0,714285714285714;0,785714285714286
"481";7278;169;481;6;15;27;12;0,0952380952380952;0,166666666666667
"482";7278;169;482;6;31;44;13;0,19047619047619;0,261904761904762
"483";7278;169;483;6;31;48;17;0,19047619047619;0,285714285714286
"484";7278;169;484;6;60;72;12;0,357142857142857;0,428571428571429
"485";7278;169;485;6;76;88;12;0,452380952380952;0,523809523809524
"486";7278;169;486;6;80;92;12;0,476190476190476;0,547619047619048
"487";7278;169;487;6;80;96;16;0,476190476190476;0,571428571428571
"488";7278;169;488;6;27;39;12;0,166666666666667;0,238095238095238
"489";7278;169;489;6;149;161;12;0,880952380952381;0,952380952380952
"490";7278;169;490;6;48;64;16;0,285714285714286;0,380952380952381
"491";7278;169;491;6;52;64;12;0,30952380952381;0,380952380952381
"492";7278;169;492;6;112;124;12;0,666666666666667;0,738095238095238
"493";7278;169;493;6;112;129;17;0,666666666666667;0,761904761904762
"494";7278;169;494;6;112;133;21;0,666666666666667;0,785714285714286
"495";7278;169;495;6;116;129;13;0,69047619047619;0,761904761904762
"496";7278;169;496;6;129;141;12;0,761904761904762;0,833333333333333
"497";7278;169;497;6;153;165;12;0,904761904761905;0,976190476190476
"498";7278;169;498;6;157;169;12;0,928571428571429;1
"499";7278;169;499;6;72;84;12;0,428571428571429;0,5
"500";7278;169;500;6;88;100;12;0,523809523809524;0,595238095238095
"501";7278;169;501;6;145;157;12;0,857142857142857;0,928571428571429
"502";7278;169;502;6;44;56;12;0,261904761904762;0,333333333333333
"503";7278;169;503;6;23;35;12;0,142857142857143;0,214285714285714
"504";7278;169;504;6;124;137;13;0,738095238095238;0,80952380952381
"505";7278;169;505;6;124;141;17;0,738095238095238;0,833333333333333
"506";7278;169;506;6;149;165;16;0,880952380952381;0,976190476190476
"507";7278;169;507;6;39;52;13;0,238095238095238;0,30952380952381
"508";7278;169;508;6;23;39;16;0,142857142857143;0,238095238095238
"509";7278;169;509;6;137;149;12;0,80952380952381;0,880952380952381
"510";7278;169;510;6;129;145;16;0,761904761904762;0,857142857142857
"511";7278;169;511;6;64;76;12;0,380952380952381;0,452380952380952
"512";7278;169;512;6;141;153;12;0,833333333333333;0,904761904761905
"513";7278;169;513;6;11;23;12;0,0714285714285714;0,142857142857143
"514";7278;169;514;6;141;157;16;0,833333333333333;0,928571428571429
"515";7278;169;515;6;145;161;16;0,857142857142857;0,952380952380952
"516";7278;169;516;6;137;153;16;0,80952380952381;0,904761904761905
"517";7278;169;517;6;116;133;17;0,69047619047619;0,785714285714286
"518";7278;169;518;6;56;72;16;0,333333333333333;0,428571428571429
"519";7278;169;519;6;116;137;21;0,69047619047619;0,80952380952381
"520";7278;169;520;6;120;137;17;0,714285714285714;0,80952380952381
"521";7278;169;521;6;39;56;17;0,238095238095238;0,333333333333333
"522";7278;169;522;6;88;104;16;0,523809523809524;0,619047619047619
"523";7278;169;523;6;76;92;16;0,452380952380952;0,547619047619048
"524";7278;169;524;6;72;88;16;0,428571428571429;0,523809523809524
"525";7278;169;525;6;108;120;12;0,642857142857143;0,714285714285714
"526";7203;87;526;3;34;87;53;0,4;1
"527";7203;87;527;4;63;87;24;0,727272727272727;1
"528";7203;87;528;5;27;39;12;0,318181818181818;0,454545454545455
"529";7203;87;529;5;75;87;12;0,863636363636364;1
"530";7203;87;530;5;67;79;12;0,772727272727273;0,909090909090909
"531";7203;87;531;5;71;83;12;0,818181818181818;0,954545454545455
"532";7203;87;532;5;71;87;16;0,818181818181818;1
"533";7203;87;533;5;19;31;12;0,227272727272727;0,363636363636364
"534";7203;87;534;5;31;43;12;0,363636363636364;0,5
"535";7203;87;535;5;63;75;12;0,727272727272727;0,863636363636364
"536";7203;87;536;5;63;79;16;0,727272727272727;0,909090909090909
"537";7203;87;537;5;59;71;12;0,681818181818182;0,818181818181818
"538";7203;87;538;5;23;35;12;0,272727272727273;0,409090909090909
"539";7203;87;539;5;15;27;12;0,181818181818182;0,318181818181818
"540";7203;87;540;5;55;67;12;0,636363636363636;0,772727272727273
"541";7203;87;541;6;29;35;6;0,340909090909091;0,409090909090909
"542";7203;87;542;6;63;69;6;0,727272727272727;0,795454545454545
"543";7203;87;543;6;23;29;6;0,272727272727273;0,340909090909091
"544";7203;87;544;6;59;65;6;0,681818181818182;0,75
"545";7203;87;545;6;81;87;6;0,931818181818182;1
"546";7203;87;546;6;5;11;6;0,0681818181818182;0,136363636363636
"547";7203;87;547;6;21;27;6;0,25;0,318181818181818
"548";7203;87;548;6;65;71;6;0,75;0,818181818181818
"549";7203;87;549;6;55;61;6;0,636363636363636;0,704545454545455
"550";7203;87;550;6;77;83;6;0,886363636363636;0,954545454545455
"551";7203;87;551;6;35;41;6;0,409090909090909;0,477272727272727
"552";7203;87;552;6;75;81;6;0,863636363636364;0,931818181818182
"553";7203;87;553;6;67;73;6;0,772727272727273;0,840909090909091
"554";7203;87;554;6;73;79;6;0,840909090909091;0,909090909090909
"555";7203;87;555;6;25;31;6;0,295454545454545;0,363636363636364
"556";7203;87;556;6;27;33;6;0,318181818181818;0,386363636363636
"557";7203;87;557;6;71;77;6;0,818181818181818;0,886363636363636
"558";7203;87;558;6;65;73;8;0,75;0,840909090909091
"559";7203;87;559;6;53;59;6;0,613636363636364;0,681818181818182
"560";7203;87;560;6;53;61;8;0,613636363636364;0,704545454545455
"561";7203;87;561;6;55;63;8;0,636363636363636;0,727272727272727
"562";7203;87;562;6;79;85;6;0,909090909090909;0,977272727272727
"563";7203;87;563;6;77;85;8;0,886363636363636;0,977272727272727
"564";7203;87;564;6;79;87;8;0,909090909090909;1
"565";7203;87;565;6;19;25;6;0,227272727272727;0,295454545454545
"566";7203;87;566;6;71;79;8;0,818181818181818;0,909090909090909
"567";7203;87;567;6;77;87;10;0,886363636363636;1
"568";7203;87;568;6;75;83;8;0,863636363636364;0,954545454545455
"569";7203;87;569;6;31;37;6;0,363636363636364;0,431818181818182
"570";7203;87;570;6;61;67;6;0,704545454545455;0,772727272727273
"571";7203;87;571;6;69;75;6;0,795454545454545;0,863636363636364
"572";7203;87;572;6;33;39;6;0,386363636363636;0,454545454545455
"573";7203;87;573;6;57;63;6;0,659090909090909;0,727272727272727
"574";7203;87;574;6;23;31;8;0,272727272727273;0,363636363636364
"575";7203;87;575;6;75;85;10;0,863636363636364;0,977272727272727
"576";7203;87;576;6;3;9;6;0,0454545454545455;0,113636363636364
"577";7203;87;577;6;13;19;6;0,159090909090909;0,227272727272727
"578";7203;87;578;6;69;77;8;0,795454545454545;0,886363636363636
"579";7203;87;579;6;25;33;8;0,295454545454545;0,386363636363636
"580";7203;87;580;6;45;51;6;0,522727272727273;0,590909090909091
"581";7203;87;581;6;17;23;6;0,204545454545455;0,272727272727273
"582";7203;87;582;6;53;63;10;0,613636363636364;0,727272727272727
"583";7203;87;583;6;55;65;10;0,636363636363636;0,75
"584";7203;87;584;6;63;71;8;0,727272727272727;0,818181818181818
"585";7203;87;585;6;15;21;6;0,181818181818182;0,25
"586";7203;87;586;6;73;81;8;0,840909090909091;0,931818181818182
"587";7203;87;587;6;43;49;6;0,5;0,568181818181818
"588";484058;132;588;5;16;41;25;0,125;0,3125
"589";484058;132;589;5;24;49;25;0,1875;0,375
"590";484058;132;590;5;99;124;25;0,75;0,9375
"591";484058;132;591;6;23;35;12;0,181818181818182;0,272727272727273
"592";484058;132;592;6;96;108;12;0,727272727272727;0,818181818181818
"593";484058;132;593;6;27;39;12;0,212121212121212;0,303030303030303
"594";484058;132;594;6;104;116;12;0,787878787878788;0,878787878787879
"595";484058;132;595;6;100;112;12;0,757575757575758;0,848484848484849
"596";484058;132;596;6;100;116;16;0,757575757575758;0,878787878787879
"597";484058;132;597;6;100;120;20;0,757575757575758;0,909090909090909
"598";484058;132;598;6;104;120;16;0,787878787878788;0,909090909090909
"599";484058;132;599;6;108;120;12;0,818181818181818;0,909090909090909
"600";484058;132;600;6;23;39;16;0,181818181818182;0,303030303030303
"601";484058;132;601;6;19;31;12;0,151515151515152;0,242424242424242
"602";484058;132;602;6;31;43;12;0,242424242424242;0,333333333333333
"603";484058;132;603;6;7;19;12;0,0606060606060606;0,151515151515152
"604";484058;132;604;6;27;43;16;0,212121212121212;0,333333333333333
"605";484058;132;605;6;35;47;12;0,272727272727273;0,363636363636364
"606";49606;90;606;4;7;32;25;0,0909090909090909;0,363636363636364
"607";49606;90;607;5;11;24;13;0,136363636363636;0,272727272727273
"608";49606;90;608;5;24;36;12;0,272727272727273;0,409090909090909
"609";49606;90;609;5;53;65;12;0,590909090909091;0,727272727272727
"610";49606;90;610;5;16;28;12;0,181818181818182;0,318181818181818
"611";49606;90;611;5;44;57;13;0,5;0,636363636363636
"612";49606;90;612;5;20;32;12;0,227272727272727;0,363636363636364
"613";49606;90;613;5;69;82;13;0,772727272727273;0,909090909090909
"614";49606;90;614;5;57;69;12;0,636363636363636;0,772727272727273
"615";49606;90;615;5;36;49;13;0,409090909090909;0,545454545454545
"616";49606;90;616;5;7;20;13;0,0909090909090909;0,227272727272727
"617";49606;90;617;6;54;60;6;0,6;0,666666666666667
"618";49606;90;618;6;58;64;6;0,644444444444444;0,711111111111111
"619";49606;90;619;6;9;15;6;0,111111111111111;0,177777777777778
"620";49606;90;620;6;37;43;6;0,422222222222222;0,488888888888889
"621";49606;90;621;6;43;50;7;0,488888888888889;0,555555555555556
"622";49606;90;622;6;46;52;6;0,511111111111111;0,577777777777778
"623";49606;90;623;6;50;56;6;0,555555555555556;0,622222222222222
"624";49606;90;624;6;64;70;6;0,711111111111111;0,777777777777778
"625";49606;90;625;6;74;80;6;0,822222222222222;0,888888888888889
"626";49606;90;626;6;23;29;6;0,266666666666667;0,333333333333333
"627";49606;90;627;6;35;41;6;0,4;0,466666666666667
"628";49606;90;628;6;56;62;6;0,622222222222222;0,688888888888889
"629";49606;90;629;6;84;90;6;0,933333333333333;1
"630";49606;90;630;6;66;72;6;0,733333333333333;0,8
"631";49606;90;631;6;70;76;6;0,777777777777778;0,844444444444444
"632";49606;90;632;6;15;21;6;0,177777777777778;0,244444444444444
"633";49606;90;633;6;21;27;6;0,244444444444444;0,311111111111111
"634";49606;90;634;6;25;31;6;0,288888888888889;0,355555555555556
"635";49606;90;635;6;72;78;6;0,8;0,866666666666667
"636";49606;90;636;6;27;33;6;0,311111111111111;0,377777777777778
"637";49606;90;637;6;82;88;6;0,911111111111111;0,977777777777778
"638";49606;90;638;6;72;80;8;0,8;0,888888888888889
"639";49606;90;639;6;3;9;6;0,0444444444444444;0,111111111111111
"640";49606;90;640;6;54;62;8;0,6;0,688888888888889
"641";49606;90;641;6;60;66;6;0,666666666666667;0,733333333333333
"642";49606;90;642;6;52;58;6;0,577777777777778;0,644444444444444
"643";49606;90;643;6;56;64;8;0,622222222222222;0,711111111111111
"644";49606;90;644;6;23;31;8;0,266666666666667;0,355555555555556
"645";49606;90;645;6;1;7;6;0,0222222222222222;0,0888888888888889
"646";49606;90;646;6;80;86;6;0,888888888888889;0,955555555555556
"647";49606;90;647;6;25;33;8;0,288888888888889;0,377777777777778
"648";49606;90;648;6;33;39;6;0,377777777777778;0,444444444444444
"649";49606;90;649;6;29;35;6;0,333333333333333;0,4
"650";49606;90;650;6;68;74;6;0,755555555555556;0,822222222222222
"651";584098;13;651;3;1;7;6;0,142857142857143;0,571428571428571
"652";584098;13;652;3;3;9;6;0,285714285714286;0,714285714285714
"653";327948;28;653;3;11;24;13;0,428571428571429;0,857142857142857
"654";327948;28;654;3;16;28;12;0,571428571428571;1
"655";327948;28;655;4;11;18;7;0,428571428571429;0,642857142857143
"656";327948;28;656;4;18;24;6;0,642857142857143;0,857142857142857
"657";327948;28;657;4;22;28;6;0,785714285714286;1
"658";327948;28;658;4;9;16;7;0,357142857142857;0,571428571428571
"659";327948;28;659;4;20;26;6;0,714285714285714;0,928571428571429
"660";327948;28;660;4;20;28;8;0,714285714285714;1
"661";327948;28;661;4;7;14;7;0,285714285714286;0,5
"662";589515;19;662;3;7;19;12;0,4;1
"663";589515;19;663;3;3;15;12;0,2;0,8
"664";589515;19;664;3;3;19;16;0,2;1
"665";589515;19;665;4;5;11;6;0,3;0,6
"666";589515;19;666;4;3;9;6;0,2;0,5
"667";589515;19;667;4;5;13;8;0,3;0,7
"668";589515;19;668;4;5;15;10;0,3;0,8
"669";589515;19;669;4;5;17;12;0,3;0,9
"670";589515;19;670;4;5;19;14;0,3;1
"671";589515;19;671;4;1;7;6;0,1;0,4
"672";589515;19;672;4;3;11;8;0,2;0,6
"673";589515;19;673;4;3;13;10;0,2;0,7
"674";589515;19;674;4;3;15;12;0,2;0,8
"675";5730;127;675;4;79;127;48;0,625;1
"676";5730;127;676;4;63;111;48;0,5;0,875
"677";5730;127;677;5;79;103;24;0,625;0,8125
"678";5730;127;678;5;103;127;24;0,8125;1
"679";5730;127;679;5;95;119;24;0,75;0,9375
"680";5730;127;680;5;71;95;24;0,5625;0,75
"681";5730;127;681;5;87;111;24;0,6875;0,875
"682";5730;127;682;6;107;119;12;0,84375;0,9375
"683";5730;127;683;6;107;123;16;0,84375;0,96875
"684";5730;127;684;6;115;127;12;0,90625;1
"685";5730;127;685;6;55;67;12;0,4375;0,53125
"686";5730;127;686;6;111;123;12;0,875;0,96875
"687";5730;127;687;6;111;127;16;0,875;1
"688";5730;127;688;6;19;31;12;0,15625;0,25
"689";5730;127;689;6;107;127;20;0,84375;1
"690";5730;127;690;6;79;91;12;0,625;0,71875
"691";5730;127;691;6;87;99;12;0,6875;0,78125
"692";5730;127;692;6;83;95;12;0,65625;0,75
"693";5730;127;693;6;71;83;12;0,5625;0,65625
"694";5730;127;694;6;39;51;12;0,3125;0,40625
"695";5730;127;695;6;23;35;12;0,1875;0,28125
"696";5730;127;696;6;67;79;12;0,53125;0,625
"697";5730;127;697;6;99;111;12;0,78125;0,875
"698";5730;127;698;6;79;95;16;0,625;0,75
"699";5730;127;699;6;15;27;12;0,125;0,21875
"700";5730;127;700;6;35;47;12;0,28125;0,375
"701";5730;127;701;7;69;75;6;0,546875;0,59375
"702";5730;127;702;7;69;77;8;0,546875;0,609375
"703";5730;127;703;7;109;115;6;0,859375;0,90625
"704";5730;127;704;7;111;117;6;0,875;0,921875
"705";5730;127;705;7;117;123;6;0,921875;0,96875
"706";5730;127;706;7;23;29;6;0,1875;0,234375
"707";5730;127;707;7;25;31;6;0,203125;0,25
"708";5730;127;708;7;25;33;8;0,203125;0,265625
"709";5730;127;709;7;37;43;6;0,296875;0,34375
"710";5730;127;710;7;39;45;6;0,3125;0,359375
"711";5730;127;711;7;57;63;6;0,453125;0,5
"712";5730;127;712;7;57;65;8;0,453125;0,515625
"713";5730;127;713;7;59;65;6;0,46875;0,515625
"714";5730;127;714;7;71;77;6;0,5625;0,609375
"715";5730;127;715;7;73;79;6;0,578125;0,625
"716";5730;127;716;7;79;85;6;0,625;0,671875
"717";5730;127;717;7;93;99;6;0,734375;0,78125
"718";5730;127;718;7;99;105;6;0,78125;0,828125
"719";5730;127;719;7;109;117;8;0,859375;0,921875
"720";5730;127;720;7;109;119;10;0,859375;0,9375
"721";5730;127;721;7;109;121;12;0,859375;0,953125
"722";5730;127;722;7;111;119;8;0,875;0,9375
"723";5730;127;723;7;111;121;10;0,875;0,953125
"724";5730;127;724;7;113;119;6;0,890625;0,9375
"725";5730;127;725;7;113;121;8;0,890625;0,953125
"726";5730;127;726;7;119;125;6;0,9375;0,984375
"727";5730;127;727;7;75;81;6;0,59375;0,640625
"728";5730;127;728;7;83;89;6;0,65625;0,703125
"729";5730;127;729;7;85;91;6;0,671875;0,71875
"730";5730;127;730;7;107;113;6;0,84375;0,890625
"731";5730;127;731;7;23;31;8;0,1875;0,25
"732";5730;127;732;7;43;49;6;0,34375;0,390625
"733";5730;127;733;7;101;107;6;0,796875;0,84375
"734";5730;127;734;7;115;121;6;0,90625;0,953125
"735";5730;127;735;7;121;127;6;0,953125;1
"736";5730;127;736;7;21;27;6;0,171875;0,21875
"737";5730;127;737;7;21;29;8;0,171875;0,234375
"738";5730;127;738;7;27;33;6;0,21875;0,265625
"739";5730;127;739;7;35;41;6;0,28125;0,328125
"740";5730;127;740;7;37;45;8;0,296875;0,359375
"741";5730;127;741;7;117;125;8;0,921875;0,984375
"742";5730;127;742;7;87;93;6;0,6875;0,734375
"743";5730;127;743;7;35;43;8;0,28125;0,34375
"744";5730;127;744;7;119;127;8;0,9375;1
"745";5730;127;745;7;81;87;6;0,640625;0,6875
"746";5730;127;746;7;23;33;10;0,1875;0,265625
"747";5730;127;747;7;117;127;10;0,921875;1
"748";5730;127;748;7;111;123;12;0,875;0,96875
"749";5730;127;749;7;111;125;14;0,875;0,984375
"750";5730;127;750;7;113;123;10;0,890625;0,96875
"751";5730;127;751;7;113;125;12;0,890625;0,984375
"752";5730;127;752;7;113;127;14;0,890625;1
"753";5730;127;753;7;45;51;6;0,359375;0,40625
"754";5730;127;754;7;51;57;6;0,40625;0,453125
"755";5730;127;755;7;55;61;6;0,4375;0,484375
"756";5730;127;756;7;83;91;8;0,65625;0,71875
"757";5730;127;757;7;115;123;8;0,90625;0,96875
"758";5730;127;758;7;1;7;6;0,015625;0,0625
"759";5730;127;759;7;9;15;6;0,078125;0,125
"760";5730;127;760;7;19;25;6;0,15625;0,203125
"761";5730;127;761;7;89;95;6;0,703125;0,75
"762";5730;127;762;7;61;67;6;0,484375;0,53125
"763";5730;127;763;7;67;73;6;0,53125;0,578125
"764";5730;127;764;7;99;107;8;0,78125;0,84375
"765";5730;127;765;7;111;127;16;0,875;1
"766";5730;127;766;7;115;125;10;0,90625;0,984375
"767";5730;127;767;7;53;59;6;0,421875;0,46875
"768";5730;127;768;7;71;79;8;0,5625;0,625
"769";5730;127;769;7;81;89;8;0,640625;0,703125
"770";5730;127;770;7;107;115;8;0,84375;0,90625
"771";5730;127;771;7;109;123;14;0,859375;0,96875
"772";5730;127;772;7;109;125;16;0,859375;0,984375
"773";5730;127;773;7;109;127;18;0,859375;1
"774";5730;127;774;7;115;127;12;0,90625;1
"775";5730;127;775;7;41;47;6;0,328125;0,375
"776";5730;127;776;7;39;47;8;0,3125;0,375
"777";5730;127;777;7;87;95;8;0,6875;0,75
"778";5730;127;778;7;89;97;8;0,703125;0,765625
"779";5730;127;779;7;89;99;10;0,703125;0,78125
"780";5730;127;780;7;55;63;8;0,4375;0,5
"781";5730;127;781;7;85;93;8;0,671875;0,734375
"782";5730;127;782;7;79;87;8;0,625;0,6875
"783";5730;127;783;7;63;69;6;0,5;0,546875
"784";5730;127;784;7;59;67;8;0,46875;0,53125
"785";5730;127;785;7;35;45;10;0,28125;0,359375
"786";5730;127;786;7;7;13;6;0,0625;0,109375
"787";5730;127;787;7;107;117;10;0,84375;0,921875
"788";5730;127;788;7;3;9;6;0,03125;0,078125
"789";5730;127;789;7;77;83;6;0,609375;0,65625
"790";6056;203;790;4;101;152;51;0,5;0,75
"791";6056;203;791;4;84;135;51;0,416666666666667;0,666666666666667
"792";6056;203;792;4;67;118;51;0,333333333333333;0,583333333333333
"793";6056;203;793;5;154;179;25;0,76;0,88
"794";6056;203;794;5;130;154;24;0,64;0,76
"795";6056;203;795;5;15;40;25;0,08;0,2
"796";6056;203;796;5;170;195;25;0,84;0,96
"797";6056;203;797;5;179;203;24;0,88;1
"798";6056;203;798;5;81;105;24;0,4;0,52
"799";6056;203;799;5;138;162;24;0,68;0,8
"800";6056;203;800;5;56;81;25;0,28;0,4
"801";6056;203;801;5;146;170;24;0,72;0,84
"802";6056;203;802;5;89;113;24;0,44;0,56
"803";6056;203;803;5;113;138;25;0,56;0,68
"804";6056;203;804;5;105;130;25;0,52;0,64
"805";6056;203;805;5;162;187;25;0,8;0,92
"806";6056;203;806;6;7;19;12;0,0392156862745098;0,0980392156862745
"807";6056;203;807;6;103;115;12;0,509803921568627;0,568627450980392
"808";6056;203;808;6;107;119;12;0,529411764705882;0,588235294117647
"809";6056;203;809;6;135;147;12;0,666666666666667;0,725490196078431
"810";6056;203;810;6;179;191;12;0,882352941176471;0,941176470588235
"811";6056;203;811;6;143;155;12;0,705882352941177;0,764705882352941
"812";6056;203;812;6;131;143;12;0,647058823529412;0,705882352941177
"813";6056;203;813;6;163;175;12;0,803921568627451;0,862745098039216
"814";6056;203;814;6;183;195;12;0,901960784313726;0,96078431372549
"815";6056;203;815;6;159;171;12;0,784313725490196;0,843137254901961
"816";6056;203;816;6;187;199;12;0,92156862745098;0,980392156862745
"817";6056;203;817;6;127;139;12;0,627450980392157;0,686274509803922
"818";6056;203;818;6;175;187;12;0,862745098039216;0,92156862745098
"819";6056;203;819;6;27;39;12;0,137254901960784;0,196078431372549
"820";6056;203;820;6;79;91;12;0,392156862745098;0,450980392156863
"821";6056;203;821;6;19;31;12;0,0980392156862745;0,156862745098039
"822";6056;203;822;6;87;99;12;0,431372549019608;0,490196078431373
"823";6056;203;823;6;131;147;16;0,647058823529412;0,725490196078431
"824";6056;203;824;6;155;167;12;0,764705882352941;0,823529411764706
"825";6056;203;825;6;23;35;12;0,117647058823529;0,176470588235294
"826";6056;203;826;6;139;151;12;0,686274509803922;0,745098039215686
"827";6056;203;827;6;83;95;12;0,411764705882353;0,470588235294118
"828";6056;203;828;6;111;123;12;0,549019607843137;0,607843137254902
"829";6056;203;829;6;171;183;12;0,843137254901961;0,901960784313726
"830";6056;203;830;6;179;195;16;0,882352941176471;0,96078431372549
"831";6056;203;831;6;139;155;16;0,686274509803922;0,764705882352941
"832";6056;203;832;6;147;159;12;0,725490196078431;0,784313725490196
"833";6056;203;833;6;191;203;12;0,941176470588235;1
"834";6056;203;834;6;31;43;12;0,156862745098039;0,215686274509804
"835";6056;203;835;6;127;143;16;0,627450980392157;0,705882352941177
"836";6056;203;836;6;107;123;16;0,529411764705882;0,607843137254902
"837";6056;203;837;6;155;171;16;0,764705882352941;0,843137254901961
"838";6056;203;838;6;135;151;16;0,666666666666667;0,745098039215686
"839";6056;203;839;6;151;163;12;0,745098039215686;0,803921568627451
"840";6056;203;840;6;183;199;16;0,901960784313726;0,980392156862745
"841";6056;203;841;6;115;127;12;0,568627450980392;0,627450980392157
"842";6056;203;842;6;119;131;12;0,588235294117647;0,647058823529412
"843";6056;203;843;6;175;191;16;0,862745098039216;0,941176470588235
"844";487094;15;844;4;9;15;6;0,625;1
"845";487094;15;845;4;7;13;6;0,5;0,875
"846";9132;87;846;4;15;39;24;0,181818181818182;0,454545454545455
"847";9132;87;847;5;31;43;12;0,363636363636364;0,5
"848";9132;87;848;5;75;87;12;0,863636363636364;1
"849";9132;87;849;5;59;71;12;0,681818181818182;0,818181818181818
"850";9132;87;850;5;23;35;12;0,272727272727273;0,409090909090909
"851";9132;87;851;5;11;23;12;0,136363636363636;0,272727272727273
"852";9132;87;852;5;15;27;12;0,181818181818182;0,318181818181818
"853";9132;87;853;5;27;39;12;0,318181818181818;0,454545454545455
"854";9132;87;854;5;71;83;12;0,818181818181818;0,954545454545455
"855";9132;87;855;5;19;31;12;0,227272727272727;0,363636363636364
"856";9132;87;856;5;71;87;16;0,818181818181818;1
"857";9132;87;857;6;35;41;6;0,409090909090909;0,477272727272727
"858";9132;87;858;6;21;27;6;0,25;0,318181818181818
"859";9132;87;859;6;25;31;6;0,295454545454545;0,363636363636364
"860";9132;87;860;6;75;81;6;0,863636363636364;0,931818181818182
"861";9132;87;861;6;77;83;6;0,886363636363636;0,954545454545455
"862";9132;87;862;6;77;85;8;0,886363636363636;0,977272727272727
"863";9132;87;863;6;79;85;6;0,909090909090909;0,977272727272727
"864";9132;87;864;6;31;37;6;0,363636363636364;0,431818181818182
"865";9132;87;865;6;33;39;6;0,386363636363636;0,454545454545455
"866";9132;87;866;6;39;45;6;0,454545454545455;0,522727272727273
"867";9132;87;867;6;23;29;6;0,272727272727273;0,340909090909091
"868";9132;87;868;6;73;79;6;0,840909090909091;0,909090909090909
"869";9132;87;869;6;73;81;8;0,840909090909091;0,931818181818182
"870";9132;87;870;6;23;31;8;0,272727272727273;0,363636363636364
"871";9132;87;871;6;61;67;6;0,704545454545455;0,772727272727273
"872";9132;87;872;6;63;69;6;0,727272727272727;0,795454545454545
"873";9132;87;873;6;27;33;6;0,318181818181818;0,386363636363636
"874";9132;87;874;6;63;71;8;0,727272727272727;0,818181818181818
"875";9132;87;875;6;29;35;6;0,340909090909091;0,409090909090909
"876";9132;87;876;6;71;77;6;0,818181818181818;0,886363636363636
"877";9132;87;877;6;9;15;6;0,113636363636364;0,181818181818182
"878";9132;87;878;6;11;17;6;0,136363636363636;0,204545454545455
"879";9132;87;879;6;59;65;6;0,681818181818182;0,75
"880";9132;87;880;6;47;53;6;0,545454545454545;0,613636363636364
"881";9132;87;881;6;13;19;6;0,159090909090909;0,227272727272727
"882";9132;87;882;6;75;83;8;0,863636363636364;0,954545454545455
"883";9132;87;883;6;31;39;8;0,363636363636364;0,454545454545455
"884";9132;87;884;6;19;25;6;0,227272727272727;0,295454545454545
"885";9132;87;885;6;37;43;6;0,431818181818182;0,5
"886";9132;87;886;6;41;47;6;0,477272727272727;0,545454545454545
"887";9132;87;887;6;75;85;10;0,863636363636364;0,977272727272727
"888";9132;87;888;6;79;87;8;0,909090909090909;1
"889";9132;87;889;6;81;87;6;0,931818181818182;1
"890";9132;87;890;6;57;63;6;0,659090909090909;0,727272727272727
"891";9132;87;891;6;59;67;8;0,681818181818182;0,772727272727273
"892";9132;87;892;6;65;71;6;0,75;0,818181818181818
"893";9132;87;893;6;55;61;6;0,636363636363636;0,704545454545455
"894";9132;87;894;6;17;23;6;0,204545454545455;0,272727272727273
"895";9132;87;895;6;25;33;8;0,295454545454545;0,386363636363636
"896";9132;87;896;6;61;69;8;0,704545454545455;0,795454545454545
"897";9132;87;897;6;21;29;8;0,25;0,340909090909091
"898";9132;87;898;6;27;35;8;0,318181818181818;0,409090909090909
"899";9132;87;899;6;15;21;6;0,181818181818182;0,25
"900";9132;87;900;6;33;41;8;0,386363636363636;0,477272727272727
"901";13726;62;901;3;8;35;27;0,142857142857143;0,571428571428571
"902";13726;62;902;3;17;44;27;0,285714285714286;0,714285714285714
"903";13726;62;903;3;35;62;27;0,571428571428571;1
"904";13726;62;904;3;26;53;27;0,428571428571429;0,857142857142857
"905";13726;62;905;4;24;37;13;0,4;0,6
"906";13726;62;906;4;41;54;13;0,666666666666667;0,866666666666667
"907";13726;62;907;4;37;49;12;0,6;0,8
"908";13726;62;908;4;37;54;17;0,6;0,866666666666667
"909";13726;62;909;4;20;33;13;0,333333333333333;0,533333333333333
"910";13726;62;910;4;20;37;17;0,333333333333333;0,6
"911";13726;62;911;4;16;28;12;0,266666666666667;0,466666666666667
"912";13726;62;912;4;3;16;13;0,0666666666666667;0,266666666666667
"913";13726;62;913;4;28;41;13;0,466666666666667;0,666666666666667
"914";13726;62;914;4;12;24;12;0,2;0,4
"915";13726;62;915;4;16;33;17;0,266666666666667;0,533333333333333
"916";13726;62;916;5;5;11;6;0,0967741935483871;0,193548387096774
"917";13726;62;917;5;17;23;6;0,290322580645161;0,387096774193548
"918";13726;62;918;5;23;29;6;0,387096774193548;0,483870967741935
"919";13726;62;919;5;40;46;6;0,645161290322581;0,741935483870968
"920";13726;62;920;5;44;50;6;0,709677419354839;0,806451612903226
"921";13726;62;921;5;50;56;6;0,806451612903226;0,903225806451613
"922";13726;62;922;5;5;13;8;0,0967741935483871;0,225806451612903
"923";13726;62;923;5;5;15;10;0,0967741935483871;0,258064516129032
"924";13726;62;924;5;21;27;6;0,354838709677419;0,451612903225806
"925";13726;62;925;5;23;32;9;0,387096774193548;0,516129032258065
"926";13726;62;926;5;44;52;8;0,709677419354839;0,838709677419355
"927";13726;62;927;5;46;52;6;0,741935483870968;0,838709677419355
"928";13726;62;928;5;29;36;7;0,483870967741935;0,580645161290323
"929";13726;62;929;5;32;38;6;0,516129032258065;0,612903225806452
"930";13726;62;930;5;40;48;8;0,645161290322581;0,774193548387097
"931";13726;62;931;5;21;29;8;0,354838709677419;0,483870967741935
"932";13726;62;932;5;40;50;10;0,645161290322581;0,806451612903226
"933";13726;62;933;5;40;52;12;0,645161290322581;0,838709677419355
"934";13726;62;934;5;40;54;14;0,645161290322581;0,870967741935484
"935";13726;62;935;5;48;54;6;0,774193548387097;0,870967741935484
"936";13726;62;936;5;46;54;8;0,741935483870968;0,870967741935484
"937";13726;62;937;5;25;32;7;0,419354838709677;0,516129032258065
"938";13726;62;938;5;44;54;10;0,709677419354839;0,870967741935484
"939";13726;62;939;5;38;44;6;0,612903225806452;0,709677419354839
"940";13726;62;940;5;38;46;8;0,612903225806452;0,741935483870968
"941";13726;62;941;5;19;25;6;0,32258064516129;0,419354838709677
"942";13726;62;942;5;19;27;8;0,32258064516129;0,451612903225806
"943";13726;62;943;5;19;29;10;0,32258064516129;0,483870967741935
"944";13726;62;944;5;25;34;9;0,419354838709677;0,548387096774194
"945";13726;62;945;5;56;62;6;0,903225806451613;1
"946";13726;62;946;5;38;48;10;0,612903225806452;0,774193548387097
"947";13726;62;947;5;38;50;12;0,612903225806452;0,806451612903226
"948";13726;62;948;5;38;52;14;0,612903225806452;0,838709677419355
"949";13726;62;949;5;15;21;6;0,258064516129032;0,354838709677419
"950";13726;62;950;5;17;25;8;0,290322580645161;0,419354838709677
"951";13726;62;951;5;17;27;10;0,290322580645161;0,451612903225806
"952";13726;62;952;5;23;34;11;0,387096774193548;0,548387096774194
"953";13726;62;953;5;21;32;11;0,354838709677419;0,516129032258065
"954";13726;62;954;5;21;34;13;0,354838709677419;0,548387096774194
"955";13726;62;955;5;21;36;15;0,354838709677419;0,580645161290323
"956";13726;62;956;5;27;34;7;0,451612903225806;0,548387096774194
"957";13726;62;957;5;23;36;13;0,387096774193548;0,580645161290323
"958";13726;62;958;5;29;38;9;0,483870967741935;0,612903225806452
"959";13726;62;959;5;25;36;11;0,419354838709677;0,580645161290323
"960";13726;62;960;5;11;17;6;0,193548387096774;0,290322580645161
"961";13726;62;961;5;27;36;9;0,451612903225806;0,580645161290323
"962";13726;62;962;5;36;42;6;0,580645161290323;0,67741935483871
"963";13726;62;963;5;34;40;6;0,548387096774194;0,645161290322581
"964";172844;103;964;3;34;86;52;0,333333333333333;0,833333333333333
"965";172844;103;965;3;16;68;52;0,166666666666667;0,666666666666667
"966";172844;103;966;3;51;103;52;0,5;1
"967";172844;103;967;3;34;103;69;0,333333333333333;1
"968";172844;103;968;3;16;86;70;0,166666666666667;0,833333333333333
"969";172844;103;969;4;39;63;24;0,384615384615385;0,615384615384615
"970";172844;103;970;4;63;87;24;0,615384615384615;0,846153846153846
"971";172844;103;971;4;39;71;32;0,384615384615385;0,692307692307692
"972";172844;103;972;4;39;79;40;0,384615384615385;0,769230769230769
"973";172844;103;973;4;39;87;48;0,384615384615385;0,846153846153846
"974";172844;103;974;4;39;95;56;0,384615384615385;0,923076923076923
"975";172844;103;975;4;63;95;32;0,615384615384615;0,923076923076923
"976";172844;103;976;4;71;95;24;0,692307692307692;0,923076923076923
"977";172844;103;977;4;31;55;24;0,307692307692308;0,538461538461538
"978";172844;103;978;4;31;63;32;0,307692307692308;0,615384615384615
"979";172844;103;979;4;23;47;24;0,230769230769231;0,461538461538462
"980";172844;103;980;4;7;31;24;0,0769230769230769;0,307692307692308
"981";172844;103;981;4;31;71;40;0,307692307692308;0,692307692307692
"982";172844;103;982;4;31;79;48;0,307692307692308;0,769230769230769
"983";172844;103;983;4;31;87;56;0,307692307692308;0,846153846153846
"984";172844;103;984;4;15;39;24;0,153846153846154;0,384615384615385
"985";172844;103;985;4;31;95;64;0,307692307692308;0,923076923076923
"986";172844;103;986;5;39;51;12;0,384615384615385;0,5
"987";172844;103;987;5;39;55;16;0,384615384615385;0,538461538461538
"988";172844;103;988;5;39;59;20;0,384615384615385;0,576923076923077
"989";172844;103;989;5;39;63;24;0,384615384615385;0,615384615384615
"990";172844;103;990;5;39;67;28;0,384615384615385;0,653846153846154
"991";172844;103;991;5;67;79;12;0,653846153846154;0,769230769230769
"992";172844;103;992;5;67;83;16;0,653846153846154;0,807692307692308
"993";172844;103;993;5;71;83;12;0,692307692307692;0,807692307692308
"994";172844;103;994;5;71;87;16;0,692307692307692;0,846153846153846
"995";172844;103;995;5;7;19;12;0,0769230769230769;0,192307692307692
"996";172844;103;996;5;67;87;20;0,653846153846154;0,846153846153846
"997";172844;103;997;5;35;47;12;0,346153846153846;0,461538461538462
"998";172844;103;998;5;35;51;16;0,346153846153846;0,5
"999";172844;103;999;5;35;55;20;0,346153846153846;0,538461538461538
"1000";172844;103;1000;5;39;71;32;0,384615384615385;0,692307692307692
"1001";172844;103;1001;5;39;75;36;0,384615384615385;0,730769230769231
"1002";172844;103;1002;5;39;79;40;0,384615384615385;0,769230769230769
"1003";172844;103;1003;5;39;83;44;0,384615384615385;0,807692307692308
"1004";172844;103;1004;5;39;87;48;0,384615384615385;0,846153846153846
"1005";172844;103;1005;5;39;91;52;0,384615384615385;0,884615384615385
"1006";172844;103;1006;5;67;91;24;0,653846153846154;0,884615384615385
"1007";172844;103;1007;5;67;95;28;0,653846153846154;0,923076923076923
"1008";172844;103;1008;5;71;91;20;0,692307692307692;0,884615384615385
"1009";172844;103;1009;5;31;43;12;0,307692307692308;0,423076923076923
"1010";172844;103;1010;5;27;39;12;0,269230769230769;0,384615384615385
"1011";172844;103;1011;5;91;103;12;0,884615384615385;1
"1012";172844;103;1012;5;35;59;24;0,346153846153846;0,576923076923077
"1013";172844;103;1013;5;35;63;28;0,346153846153846;0,615384615384615
"1014";172844;103;1014;5;35;67;32;0,346153846153846;0,653846153846154
"1015";172844;103;1015;5;35;71;36;0,346153846153846;0,692307692307692
"1016";172844;103;1016;5;35;75;40;0,346153846153846;0,730769230769231
"1017";172844;103;1017;5;35;79;44;0,346153846153846;0,769230769230769
"1018";172844;103;1018;5;35;83;48;0,346153846153846;0,807692307692308
"1019";172844;103;1019;5;11;23;12;0,115384615384615;0,230769230769231
"1020";172844;103;1020;5;19;31;12;0,192307692307692;0,307692307692308
"1021";172844;103;1021;5;31;47;16;0,307692307692308;0,461538461538462
"1022";172844;103;1022;5;31;51;20;0,307692307692308;0,5
"1023";172844;103;1023;5;27;43;16;0,269230769230769;0,423076923076923
"1024";172844;103;1024;5;27;47;20;0,269230769230769;0,461538461538462
"1025";172844;103;1025;5;27;51;24;0,269230769230769;0,5
"1026";172844;103;1026;5;27;55;28;0,269230769230769;0,538461538461538
"1027";172844;103;1027;5;71;95;24;0,692307692307692;0,923076923076923
"1028";172844;103;1028;5;31;55;24;0,307692307692308;0,538461538461538
"1029";172844;103;1029;5;31;59;28;0,307692307692308;0,576923076923077
"1030";172844;103;1030;5;39;95;56;0,384615384615385;0,923076923076923
"1031";172844;103;1031;5;31;63;32;0,307692307692308;0,615384615384615
"1032";172844;103;1032;5;31;67;36;0,307692307692308;0,653846153846154
"1033";172844;103;1033;6;37;43;6;0,365384615384615;0,423076923076923
"1034";172844;103;1034;6;95;101;6;0,923076923076923;0,980769230769231
"1035";172844;103;1035;6;11;17;6;0,115384615384615;0,173076923076923
"1036";172844;103;1036;6;19;25;6;0,192307692307692;0,25
"1037";172844;103;1037;6;37;45;8;0,365384615384615;0,442307692307692
"1038";172844;103;1038;6;37;47;10;0,365384615384615;0,461538461538462
"1039";172844;103;1039;6;37;49;12;0,365384615384615;0,480769230769231
"1040";172844;103;1040;6;37;51;14;0,365384615384615;0,5
"1041";172844;103;1041;6;39;45;6;0,384615384615385;0,442307692307692
"1042";172844;103;1042;6;39;47;8;0,384615384615385;0,461538461538462
"1043";172844;103;1043;6;67;73;6;0,653846153846154;0,711538461538462
"1044";172844;103;1044;6;67;75;8;0,653846153846154;0,730769230769231
"1045";172844;103;1045;6;69;75;6;0,673076923076923;0,730769230769231
"1046";172844;103;1046;6;69;77;8;0,673076923076923;0,75
"1047";172844;103;1047;6;95;103;8;0,923076923076923;1
"1048";172844;103;1048;6;11;19;8;0,115384615384615;0,192307692307692
"1049";172844;103;1049;6;19;27;8;0,192307692307692;0,269230769230769
"1050";172844;103;1050;6;31;37;6;0,307692307692308;0,365384615384615
"1051";172844;103;1051;6;37;53;16;0,365384615384615;0,519230769230769
"1052";172844;103;1052;6;37;55;18;0,365384615384615;0,538461538461538
"1053";172844;103;1053;6;37;57;20;0,365384615384615;0,557692307692308
"1054";172844;103;1054;6;37;59;22;0,365384615384615;0,576923076923077
"1055";172844;103;1055;6;37;61;24;0,365384615384615;0,596153846153846
"1056";172844;103;1056;6;37;63;26;0,365384615384615;0,615384615384615
"1057";172844;103;1057;6;39;49;10;0,384615384615385;0,480769230769231
"1058";172844;103;1058;6;39;51;12;0,384615384615385;0,5
"1059";172844;103;1059;6;67;77;10;0,653846153846154;0,75
"1060";172844;103;1060;6;67;79;12;0,653846153846154;0,769230769230769
"1061";172844;103;1061;6;69;79;10;0,673076923076923;0,769230769230769
"1062";172844;103;1062;6;69;81;12;0,673076923076923;0,788461538461538
"1063";172844;103;1063;6;69;83;14;0,673076923076923;0,807692307692308
"1064";172844;103;1064;6;93;99;6;0,903846153846154;0,961538461538462
"1065";172844;103;1065;6;93;101;8;0,903846153846154;0,980769230769231
"1066";172844;103;1066;6;93;103;10;0,903846153846154;1
"1067";172844;103;1067;6;9;15;6;0,0961538461538462;0,153846153846154
"1068";172844;103;1068;6;9;17;8;0,0961538461538462;0,173076923076923
"1069";172844;103;1069;6;9;19;10;0,0961538461538462;0,192307692307692
"1070";172844;103;1070;6;39;53;14;0,384615384615385;0,519230769230769
"1071";172844;103;1071;6;39;55;16;0,384615384615385;0,538461538461538
"1072";172844;103;1072;6;39;57;18;0,384615384615385;0,557692307692308
"1073";172844;103;1073;6;39;59;20;0,384615384615385;0,576923076923077
"1074";172844;103;1074;6;39;61;22;0,384615384615385;0,596153846153846
"1075";172844;103;1075;6;39;63;24;0,384615384615385;0,615384615384615
"1076";172844;103;1076;6;39;65;26;0,384615384615385;0,634615384615385
"1077";172844;103;1077;6;67;81;14;0,653846153846154;0,788461538461538
"1078";172844;103;1078;6;67;83;16;0,653846153846154;0,807692307692308
"1079";172844;103;1079;6;67;85;18;0,653846153846154;0,826923076923077
"1080";172844;103;1080;6;67;87;20;0,653846153846154;0,846153846153846
"1081";172844;103;1081;6;67;89;22;0,653846153846154;0,865384615384615
"1082";172844;103;1082;6;67;91;24;0,653846153846154;0,884615384615385
"1083";172844;103;1083;6;29;35;6;0,288461538461538;0,346153846153846
"1084";172844;103;1084;6;27;33;6;0,269230769230769;0,326923076923077
"1085";172844;103;1085;6;27;35;8;0,269230769230769;0,346153846153846
"1086";172844;103;1086;6;27;37;10;0,269230769230769;0,365384615384615
"1087";172844;103;1087;6;29;37;8;0,288461538461538;0,365384615384615
"1088";172844;103;1088;6;33;39;6;0,326923076923077;0,384615384615385
"1089";172844;103;1089;6;69;85;16;0,673076923076923;0,826923076923077
"1090";172844;103;1090;6;69;87;18;0,673076923076923;0,846153846153846
"1091";172844;103;1091;6;31;39;8;0,307692307692308;0,384615384615385
"1092";172844;103;1092;6;29;39;10;0,288461538461538;0,384615384615385
"1093";172844;103;1093;6;33;41;8;0,326923076923077;0,403846153846154
"1094";172844;103;1094;6;33;43;10;0,326923076923077;0,423076923076923
"1095";172844;103;1095;6;33;45;12;0,326923076923077;0,442307692307692
"1096";172844;103;1096;6;33;47;14;0,326923076923077;0,461538461538462
"1097";172844;103;1097;6;33;49;16;0,326923076923077;0,480769230769231
"1098";172844;103;1098;6;33;51;18;0,326923076923077;0,5
"1099";172844;103;1099;6;31;41;10;0,307692307692308;0,403846153846154
"1100";172844;103;1100;6;69;89;20;0,673076923076923;0,865384615384615
"1101";172844;103;1101;6;69;91;22;0,673076923076923;0,884615384615385
"1102";172844;103;1102;6;69;93;24;0,673076923076923;0,903846153846154
"1103";172844;103;1103;6;37;65;28;0,365384615384615;0,634615384615385
"1104";172844;103;1104;6;37;67;30;0,365384615384615;0,653846153846154
"1105";172844;103;1105;6;29;41;12;0,288461538461538;0,403846153846154
"1106";172844;103;1106;6;31;43;12;0,307692307692308;0,423076923076923
"1107";172844;103;1107;6;39;67;28;0,384615384615385;0,653846153846154
"1108";172844;103;1108;6;39;69;30;0,384615384615385;0,673076923076923
"1109";172844;103;1109;6;67;93;26;0,653846153846154;0,903846153846154
"1110";488862;150;1110;4;49;100;51;0,333333333333333;0,666666666666667
"1111";488862;150;1111;4;100;150;50;0,666666666666667;1
"1112";488862;150;1112;4;66;116;50;0,444444444444444;0,777777777777778
"1113";488862;150;1113;5;58;83;25;0,388888888888889;0,555555555555556
"1114";488862;150;1114;5;16;41;25;0,111111111111111;0,277777777777778
"1115";488862;150;1115;5;66;91;25;0,444444444444444;0,611111111111111
"1116";488862;150;1116;5;74;100;26;0,5;0,666666666666667
"1117";488862;150;1117;5;100;125;25;0,666666666666667;0,833333333333333
"1118";488862;150;1118;5;108;133;25;0,722222222222222;0,888888888888889
"1119";488862;150;1119;5;41;66;25;0,277777777777778;0,444444444444444
"1120";488862;150;1120;5;33;58;25;0,222222222222222;0,388888888888889
"1121";488862;150;1121;5;125;150;25;0,833333333333333;1
"1122";488862;150;1122;5;116;142;26;0,777777777777778;0,944444444444444
"1123";488862;150;1123;5;49;74;25;0,333333333333333;0,5
"1124";488862;150;1124;5;83;108;25;0,555555555555556;0,722222222222222
"1125";488862;150;1125;6;23;36;13;0,162162162162162;0,243243243243243
"1126";488862;150;1126;6;32;44;12;0,216216216216216;0,297297297297297
"1127";488862;150;1127;6;40;52;12;0,27027027027027;0,351351351351351
"1128";488862;150;1128;6;44;56;12;0,297297297297297;0,378378378378378
"1129";488862;150;1129;6;48;60;12;0,324324324324324;0,405405405405405
"1130";488862;150;1130;6;60;72;12;0,405405405405405;0,486486486486487
"1131";488862;150;1131;6;105;117;12;0,702702702702703;0,783783783783784
"1132";488862;150;1132;6;36;48;12;0,243243243243243;0,324324324324324
"1133";488862;150;1133;6;64;77;13;0,432432432432432;0,513513513513513
"1134";488862;150;1134;6;77;89;12;0,513513513513513;0,594594594594595
"1135";488862;150;1135;6;81;93;12;0,540540540540541;0,621621621621622
"1136";488862;150;1136;6;85;97;12;0,567567567567568;0,648648648648649
"1137";488862;150;1137;6;85;101;16;0,567567567567568;0,675675675675676
"1138";488862;150;1138;6;109;121;12;0,72972972972973;0,810810810810811
"1139";488862;150;1139;6;134;146;12;0,891891891891892;0,972972972972973
"1140";488862;150;1140;6;72;85;13;0,486486486486487;0,567567567567568
"1141";488862;150;1141;6;113;126;13;0,756756756756757;0,837837837837838
"1142";488862;150;1142;6;68;81;13;0,459459459459459;0,540540540540541
"1143";488862;150;1143;6;89;101;12;0,594594594594595;0,675675675675676
"1144";488862;150;1144;6;97;109;12;0,648648648648649;0,72972972972973
"1145";488862;150;1145;6;121;134;13;0,810810810810811;0,891891891891892
"1146";488862;150;1146;6;101;113;12;0,675675675675676;0,756756756756757
"1147";488862;150;1147;6;52;64;12;0,351351351351351;0,432432432432432
"1148";488862;150;1148;6;138;150;12;0,918918918918919;1
"1149";488862;150;1149;6;117;130;13;0,783783783783784;0,864864864864865
"1150";488862;150;1150;6;117;134;17;0,783783783783784;0,891891891891892
"1151";488862;150;1151;6;134;150;16;0,891891891891892;1
"1152";488862;150;1152;6;126;138;12;0,837837837837838;0,918918918918919
"1153";488862;150;1153;6;93;105;12;0,621621621621622;0,702702702702703
"1154";488862;150;1154;6;64;81;17;0,432432432432432;0,540540540540541
"1155";488862;150;1155;6;11;23;12;0,0810810810810811;0,162162162162162
"1156";488862;150;1156;6;56;68;12;0,378378378378378;0,459459459459459
"1157";488862;150;1157;6;109;126;17;0,72972972972973;0,837837837837838
"1158";488862;150;1158;6;130;142;12;0,864864864864865;0,945945945945946
"1159";488862;150;1159;6;28;40;12;0,189189189189189;0,27027027027027
"1160";480;83;1160;3;33;83;50;0,4;1
"1161";480;83;1161;4;49;75;26;0,6;0,9
"1162";480;83;1162;4;49;83;34;0,6;1
"1163";480;83;1163;4;58;83;25;0,7;1
"1164";480;83;1164;5;31;43;12;0,380952380952381;0,523809523809524
"1165";480;83;1165;5;51;63;12;0,619047619047619;0,761904761904762
"1166";480;83;1166;5;59;71;12;0,714285714285714;0,857142857142857
"1167";480;83;1167;5;59;75;16;0,714285714285714;0,904761904761905
"1168";480;83;1168;5;63;75;12;0,761904761904762;0,904761904761905
"1169";480;83;1169;5;55;67;12;0,666666666666667;0,80952380952381
"1170";480;83;1170;5;59;79;20;0,714285714285714;0,952380952380952
"1171";480;83;1171;5;51;67;16;0,619047619047619;0,80952380952381
"1172";480;83;1172;5;51;71;20;0,619047619047619;0,857142857142857
"1173";480;83;1173;5;55;71;16;0,666666666666667;0,857142857142857
"1174";480;83;1174;5;55;75;20;0,666666666666667;0,904761904761905
"1175";480;83;1175;5;55;79;24;0,666666666666667;0,952380952380952
"1176";480;83;1176;5;55;83;28;0,666666666666667;1
"1177";480;83;1177;5;59;83;24;0,714285714285714;1
"1178";480;83;1178;5;63;79;16;0,761904761904762;0,952380952380952
"1179";480;83;1179;5;63;83;20;0,761904761904762;1
"1180";480;83;1180;5;71;83;12;0,857142857142857;1
"1181";480;83;1181;5;47;59;12;0,571428571428571;0,714285714285714
"1182";480;83;1182;5;47;63;16;0,571428571428571;0,761904761904762
"1183";480;83;1183;5;47;67;20;0,571428571428571;0,80952380952381
"1184";480;83;1184;5;47;71;24;0,571428571428571;0,857142857142857
"1185";480;83;1185;5;43;55;12;0,523809523809524;0,666666666666667
"1186";480;83;1186;5;51;75;24;0,619047619047619;0,904761904761905
"1187";480;83;1187;5;51;79;28;0,619047619047619;0,952380952380952
"1188";480;83;1188;5;51;83;32;0,619047619047619;1
"1189";480;83;1189;6;51;57;6;0,619047619047619;0,69047619047619
"1190";480;83;1190;6;51;59;8;0,619047619047619;0,714285714285714
"1191";480;83;1191;6;61;67;6;0,738095238095238;0,80952380952381
"1192";480;83;1192;6;75;81;6;0,904761904761905;0,976190476190476
"1193";480;83;1193;6;31;37;6;0,380952380952381;0,452380952380952
"1194";480;83;1194;6;49;55;6;0,595238095238095;0,666666666666667
"1195";480;83;1195;6;49;57;8;0,595238095238095;0,69047619047619
"1196";480;83;1196;6;49;59;10;0,595238095238095;0,714285714285714
"1197";480;83;1197;6;49;61;12;0,595238095238095;0,738095238095238
"1198";480;83;1198;6;51;61;10;0,619047619047619;0,738095238095238
"1199";480;83;1199;6;53;59;6;0,642857142857143;0,714285714285714
"1200";480;83;1200;6;57;63;6;0,69047619047619;0,761904761904762
"1201";480;83;1201;6;57;65;8;0,69047619047619;0,785714285714286
"1202";480;83;1202;6;57;67;10;0,69047619047619;0,80952380952381
"1203";480;83;1203;6;57;69;12;0,69047619047619;0,833333333333333
"1204";480;83;1204;6;57;71;14;0,69047619047619;0,857142857142857
"1205";480;83;1205;6;59;65;6;0,714285714285714;0,785714285714286
"1206";480;83;1206;6;59;67;8;0,714285714285714;0,80952380952381
"1207";480;83;1207;6;59;69;10;0,714285714285714;0,833333333333333
"1208";480;83;1208;6;59;71;12;0,714285714285714;0,857142857142857
"1209";480;83;1209;6;61;69;8;0,738095238095238;0,833333333333333
"1210";480;83;1210;6;61;71;10;0,738095238095238;0,857142857142857
"1211";480;83;1211;6;61;73;12;0,738095238095238;0,880952380952381
"1212";480;83;1212;6;73;79;6;0,880952380952381;0,952380952380952
"1213";480;83;1213;6;73;81;8;0,880952380952381;0,976190476190476
"1214";480;83;1214;6;73;83;10;0,880952380952381;1
"1215";480;83;1215;6;75;83;8;0,904761904761905;1
"1216";480;83;1216;6;53;61;8;0,642857142857143;0,738095238095238
"1217";480;83;1217;6;59;73;14;0,714285714285714;0,880952380952381
"1218";480;83;1218;6;59;75;16;0,714285714285714;0,904761904761905
"1219";480;83;1219;6;59;77;18;0,714285714285714;0,928571428571429
"1220";480;83;1220;6;59;79;20;0,714285714285714;0,952380952380952
"1221";480;83;1221;6;59;81;22;0,714285714285714;0,976190476190476
"1222";480;83;1222;6;47;53;6;0,571428571428571;0,642857142857143
"1223";480;83;1223;6;55;61;6;0,666666666666667;0,738095238095238
"1224";480;83;1224;6;61;75;14;0,738095238095238;0,904761904761905
"1225";480;83;1225;6;61;77;16;0,738095238095238;0,928571428571429
"1226";480;83;1226;6;61;79;18;0,738095238095238;0,952380952380952
"1227";480;83;1227;6;47;55;8;0,571428571428571;0,666666666666667
"1228";480;83;1228;6;33;39;6;0,404761904761905;0,476190476190476
"1229";480;83;1229;6;29;35;6;0,357142857142857;0,428571428571429
"1230";480;83;1230;6;33;41;8;0,404761904761905;0,5
"1231";480;83;1231;6;45;51;6;0,547619047619048;0,619047619047619
"1232";480;83;1232;6;35;41;6;0,428571428571429;0,5
"1233";480;83;1233;6;55;63;8;0,666666666666667;0,761904761904762
"1234";480;83;1234;6;53;63;10;0,642857142857143;0,761904761904762
"1235";480;83;1235;6;53;65;12;0,642857142857143;0,785714285714286
"1236";480;83;1236;6;53;67;14;0,642857142857143;0,80952380952381
"1237";480;83;1237;6;57;73;16;0,69047619047619;0,880952380952381
"1238";480;83;1238;6;7;13;6;0,0952380952380952;0,166666666666667
"1239";480;83;1239;6;51;63;12;0,619047619047619;0,761904761904762
"1240";480;83;1240;6;51;65;14;0,619047619047619;0,785714285714286
"1241";480;83;1241;6;51;67;16;0,619047619047619;0,80952380952381
"1242";480;83;1242;6;51;69;18;0,619047619047619;0,833333333333333
"1243";480;83;1243;6;51;71;20;0,619047619047619;0,857142857142857
"1244";480;83;1244;6;61;81;20;0,738095238095238;0,976190476190476
"1245";480;83;1245;6;61;83;22;0,738095238095238;1
"1246";480;83;1246;6;55;65;10;0,666666666666667;0,785714285714286
"1247";480;83;1247;6;57;75;18;0,69047619047619;0,904761904761905
"1248";480;83;1248;6;57;77;20;0,69047619047619;0,928571428571429
"1249";480;83;1249;6;57;79;22;0,69047619047619;0,952380952380952
"1250";480;83;1250;6;57;81;24;0,69047619047619;0,976190476190476
"1251";480;83;1251;6;57;83;26;0,69047619047619;1
"1252";480;83;1252;6;37;43;6;0,452380952380952;0,523809523809524
"1253";480;83;1253;6;49;63;14;0,595238095238095;0,761904761904762
"1254";480;83;1254;6;53;69;16;0,642857142857143;0,833333333333333
"1255";480;83;1255;6;53;71;18;0,642857142857143;0,857142857142857
"1256";480;83;1256;6;53;73;20;0,642857142857143;0,880952380952381
"1257";480;83;1257;6;55;67;12;0,666666666666667;0,80952380952381
"1258";480;83;1258;6;55;69;14;0,666666666666667;0,833333333333333
"1259";480;83;1259;6;55;71;16;0,666666666666667;0,857142857142857
"1260";480;83;1260;6;55;73;18;0,666666666666667;0,880952380952381
"1261";480;83;1261;6;47;57;10;0,571428571428571;0,69047619047619
"1262";480;83;1262;6;59;83;24;0,714285714285714;1
"1263";480;83;1263;6;21;27;6;0,261904761904762;0,333333333333333
"1264";480;83;1264;6;3;9;6;0,0476190476190476;0,119047619047619
"1265";480;83;1265;6;53;75;22;0,642857142857143;0,904761904761905
"1266";480;83;1266;6;53;77;24;0,642857142857143;0,928571428571429
"1267";480;83;1267;6;53;79;26;0,642857142857143;0,952380952380952
"1268";480;83;1268;6;53;81;28;0,642857142857143;0,976190476190476
"1269";480;83;1269;6;51;73;22;0,619047619047619;0,880952380952381
"1270";480;83;1270;6;53;83;30;0,642857142857143;1
"1271";480;83;1271;6;55;75;20;0,666666666666667;0,904761904761905
"1272";480;83;1272;6;47;59;12;0,571428571428571;0,714285714285714
"1273";3225;209;1273;5;177;201;24;0,846153846153846;0,961538461538462
"1274";3225;209;1274;5;169;193;24;0,807692307692308;0,923076923076923
"1275";3225;209;1275;5;169;201;32;0,807692307692308;0,961538461538462
"1276";3225;209;1276;5;185;209;24;0,884615384615385;1
"1277";3225;209;1277;5;136;161;25;0,653846153846154;0,769230769230769
"1278";3225;209;1278;5;112;136;24;0,538461538461538;0,653846153846154
"1279";3225;209;1279;6;169;181;12;0,807692307692308;0,865384615384615
"1280";3225;209;1280;6;120;132;12;0,576923076923077;0,634615384615385
"1281";3225;209;1281;6;197;209;12;0,942307692307692;1
"1282";3225;209;1282;6;96;108;12;0,461538461538462;0,519230769230769
"1283";3225;209;1283;6;116;128;12;0,557692307692308;0,615384615384615
"1284";3225;209;1284;6;68;80;12;0,326923076923077;0,384615384615385
"1285";3225;209;1285;6;72;84;12;0,346153846153846;0,403846153846154
"1286";3225;209;1286;6;104;116;12;0,5;0,557692307692308
"1287";3225;209;1287;6;124;136;12;0,596153846153846;0,653846153846154
"1288";3225;209;1288;6;193;205;12;0,923076923076923;0,980769230769231
"1289";3225;209;1289;6;165;177;12;0,788461538461538;0,846153846153846
"1290";3225;209;1290;6;43;56;13;0,211538461538462;0,269230769230769
"1291";3225;209;1291;6;47;60;13;0,230769230769231;0,288461538461538
"1292";3225;209;1292;6;76;88;12;0,365384615384615;0,423076923076923
"1293";3225;209;1293;6;100;112;12;0,480769230769231;0,538461538461538
"1294";3225;209;1294;6;140;152;12;0,673076923076923;0,730769230769231
"1295";3225;209;1295;6;185;197;12;0,884615384615385;0,942307692307692
"1296";3225;209;1296;6;92;104;12;0,442307692307692;0,5
"1297";3225;209;1297;6;173;185;12;0,826923076923077;0,884615384615385
"1298";3225;209;1298;6;144;156;12;0,692307692307692;0,75
"1299";3225;209;1299;6;80;92;12;0,384615384615385;0,442307692307692
"1300";3225;209;1300;6;120;136;16;0,576923076923077;0,653846153846154
"1301";3564;159;1301;4;79;127;48;0,5;0,8
"1302";3564;159;1302;4;31;79;48;0,2;0,5
"1303";3564;159;1303;5;79;103;24;0,5;0,65
"1304";3564;159;1304;6;43;55;12;0,275;0,35
"1305";3564;159;1305;6;95;107;12;0,6;0,675
"1306";3564;159;1306;6;99;111;12;0,625;0,7
"1307";3564;159;1307;6;3;15;12;0,025;0,1
"1308";3564;159;1308;6;31;43;12;0,2;0,275
"1309";3564;159;1309;6;63;75;12;0,4;0,475
"1310";3564;159;1310;6;35;47;12;0,225;0,3
"1311";3564;159;1311;6;107;119;12;0,675;0,75
"1312";3564;159;1312;6;147;159;12;0,925;1
"1313";3564;159;1313;6;75;87;12;0,475;0,55
"1314";3564;159;1314;6;59;71;12;0,375;0,45
"1315";3564;159;1315;6;79;91;12;0,5;0,575
"1316";3564;159;1316;6;103;115;12;0,65;0,725
"1317";16584;54;1317;3;26;54;28;0,5;1
"1318";16584;54;1318;3;17;45;28;0,333333333333333;0,833333333333333
"1319";16584;54;1319;4;20;33;13;0,384615384615385;0,615384615384615
"1320";16584;54;1320;4;3;16;13;0,0769230769230769;0,307692307692308
"1321";16584;54;1321;4;29;41;12;0,538461538461538;0,769230769230769
"1322";16584;54;1322;4;33;46;13;0,615384615384615;0,846153846153846
"1323";16584;54;1323;4;24;37;13;0,461538461538462;0,692307692307692
"1324";16584;54;1324;4;24;41;17;0,461538461538462;0,769230769230769
"1325";16584;54;1325;4;41;54;13;0,769230769230769;1
"1326";16584;54;1326;4;37;50;13;0,692307692307692;0,923076923076923
"1327";16584;54;1327;4;7;20;13;0,153846153846154;0,384615384615385
"1328";16584;54;1328;5;30;36;6;0,555555555555556;0,666666666666667
"1329";16584;54;1329;5;19;25;6;0,37037037037037;0,481481481481481
"1330";16584;54;1330;5;46;52;6;0,851851851851852;0,962962962962963
"1331";16584;54;1331;5;11;17;6;0,222222222222222;0,333333333333333
"1332";16584;54;1332;5;28;34;6;0,518518518518518;0,62962962962963
"1333";16584;54;1333;5;5;11;6;0,111111111111111;0,222222222222222
"1334";16584;54;1334;5;7;13;6;0,148148148148148;0,259259259259259
"1335";16584;54;1335;5;13;19;6;0,259259259259259;0,37037037037037
"1336";16584;54;1336;5;34;40;6;0,62962962962963;0,740740740740741
"1337";16584;54;1337;5;36;42;6;0,666666666666667;0,777777777777778
"1338";16584;54;1338;5;46;54;8;0,851851851851852;1
"1339";16584;54;1339;5;23;30;7;0,444444444444444;0,555555555555556
"1340";16584;54;1340;5;32;38;6;0,592592592592593;0,703703703703704
"1341";16584;54;1341;5;42;48;6;0,777777777777778;0,888888888888889
"1342";16584;54;1342;5;44;50;6;0,814814814814815;0,925925925925926
"1343";16584;54;1343;5;44;52;8;0,814814814814815;0,962962962962963
"1344";16584;54;1344;5;1;7;6;0,037037037037037;0,148148148148148
"1345";16584;54;1345;5;44;54;10;0,814814814814815;1
"1346";16584;54;1346;5;28;36;8;0,518518518518518;0,666666666666667
"1347";16584;54;1347;5;3;9;6;0,0740740740740741;0,185185185185185
"1348";16584;54;1348;5;21;28;7;0,407407407407407;0,518518518518518
"1349";16584;54;1349;5;9;15;6;0,185185185185185;0,296296296296296
"1350";16584;54;1350;5;34;42;8;0,62962962962963;0,777777777777778
"1351";16584;54;1351;5;38;44;6;0,703703703703704;0,814814814814815
"1352";16584;54;1352;5;7;15;8;0,148148148148148;0,296296296296296
"1353";16584;54;1353;5;11;19;8;0,222222222222222;0,37037037037037
"1354";16584;54;1354;5;25;32;7;0,481481481481481;0,592592592592593
"1355";16584;54;1355;5;9;17;8;0,185185185185185;0,333333333333333
"1356";16584;54;1356;5;21;30;9;0,407407407407407;0,555555555555556
"1357";16584;54;1357;5;30;38;8;0,555555555555556;0,703703703703704
"1358";22149;34;1358;4;8;21;13;0,25;0,625
"1359";22149;34;1359;4;3;16;13;0,125;0,5
"1360";22149;34;1360;4;21;34;13;0,625;1
"1361";22149;34;1361;4;16;30;14;0,5;0,875
"1362";22149;34;1362;5;15;22;7;0,470588235294118;0,647058823529412
"1363";22149;34;1363;5;7;13;6;0,235294117647059;0,411764705882353
"1364";22149;34;1364;5;28;34;6;0,823529411764706;1
"1365";22149;34;1365;5;13;20;7;0,411764705882353;0,588235294117647
"1366";22149;34;1366;5;9;15;6;0,294117647058824;0,470588235294118
"1367";22149;34;1367;5;24;30;6;0,705882352941177;0,882352941176471
"1368";22149;34;1368;5;20;26;6;0,588235294117647;0,764705882352941
"1369";22149;34;1369;5;26;32;6;0,764705882352941;0,941176470588235
"1370";22149;34;1370;5;11;18;7;0,352941176470588;0,529411764705882
"1371";22149;34;1371;5;26;34;8;0,764705882352941;1
"1372";22149;34;1372;5;22;28;6;0,647058823529412;0,823529411764706
"1373";22149;34;1373;5;5;11;6;0,176470588235294;0,352941176470588
"1374";528850;30;1374;3;17;30;13;0,571428571428571;1
"1375";528850;30;1375;4;5;11;6;0,2;0,4
"1376";528850;30;1376;4;22;28;6;0,733333333333333;0,933333333333333
"1377";528850;30;1377;4;3;9;6;0,133333333333333;0,333333333333333
"1378";528850;30;1378;4;13;20;7;0,466666666666667;0,666666666666667
"1379";528850;30;1379;4;20;26;6;0,666666666666667;0,866666666666667
"1380";528850;30;1380;4;20;28;8;0,666666666666667;0,933333333333333
"1381";528850;30;1381;4;20;30;10;0,666666666666667;1
"1382";528850;30;1382;4;16;22;6;0,533333333333333;0,733333333333333
"1383";528850;30;1383;4;3;11;8;0,133333333333333;0,4
"1384";528850;30;1384;4;18;24;6;0,6;0,8
"1385";528850;30;1385;4;1;7;6;0,0666666666666667;0,266666666666667
"1386";528850;30;1386;4;22;30;8;0,733333333333333;1
"1387";546760;32;1387;4;20;32;12;0,625;1
"1388";546760;32;1388;5;22;28;6;0,6875;0,875
"1389";546760;32;1389;5;24;30;6;0,75;0,9375
"1390";546760;32;1390;5;26;32;6;0,8125;1
"1391";546760;32;1391;5;3;9;6;0,125;0,3125
"1392";546760;32;1392;5;24;32;8;0,75;1
"1393";546760;32;1393;5;22;30;8;0,6875;0,9375
"1394";546760;32;1394;5;16;22;6;0,5;0,6875
"1395";546760;32;1395;5;22;32;10;0,6875;1
"1396";546760;32;1396;5;20;26;6;0,625;0,8125
"1397";551576;27;1397;3;11;23;12;0,428571428571429;0,857142857142857
"1398";551576;27;1398;3;15;27;12;0,571428571428571;1
"1399";551576;27;1399;3;7;19;12;0,285714285714286;0,714285714285714
"1400";551576;27;1400;3;11;27;16;0,428571428571429;1
"1401";551576;27;1401;3;3;15;12;0,142857142857143;0,571428571428571
"1402";551576;27;1402;4;19;25;6;0,714285714285714;0,928571428571429
"1403";551576;27;1403;4;19;27;8;0,714285714285714;1
"1404";551576;27;1404;4;21;27;6;0,785714285714286;1
"1405";551576;27;1405;4;3;9;6;0,142857142857143;0,357142857142857
"1406";551576;27;1406;4;3;11;8;0,142857142857143;0,428571428571429
"1407";551576;27;1407;4;5;11;6;0,214285714285714;0,428571428571429
"1408";551576;27;1408;4;13;19;6;0,5;0,714285714285714
"1409";551576;27;1409;4;11;17;6;0,428571428571429;0,642857142857143
"1410";551576;27;1410;4;11;19;8;0,428571428571429;0,714285714285714
"1411";551576;27;1411;4;7;13;6;0,285714285714286;0,5
"1412";551576;27;1412;4;13;21;8;0,5;0,785714285714286
"1413";551576;27;1413;4;17;23;6;0,642857142857143;0,857142857142857
"1414";551576;27;1414;4;17;25;8;0,642857142857143;0,928571428571429
"1415";551576;27;1415;4;17;27;10;0,642857142857143;1
"1416";551576;27;1416;4;13;23;10;0,5;0,857142857142857
"1417";551576;27;1417;4;13;25;12;0,5;0,928571428571429
"1418";551576;27;1418;4;1;7;6;0,0714285714285714;0,285714285714286
"1419";175;101;1419;4;76;101;25;0,75;1
"1420";175;101;1420;4;33;59;26;0,333333333333333;0,583333333333333
"1421";175;101;1421;4;67;92;25;0,666666666666667;0,916666666666667
"1422";175;101;1422;5;36;48;12;0,36;0,48
"1423";175;101;1423;5;72;85;13;0,72;0,84
"1424";175;101;1424;5;77;89;12;0,76;0,88
"1425";175;101;1425;5;48;60;12;0,48;0,6
"1426";175;101;1426;5;44;56;12;0,44;0,56
"1427";175;101;1427;5;40;52;12;0,4;0,52
"1428";175;101;1428;5;81;93;12;0,8;0,92
"1429";175;101;1429;5;85;97;12;0,84;0,96
"1430";175;101;1430;5;32;44;12;0,32;0,44
"1431";175;101;1431;5;81;97;16;0,8;0,96
"1432";175;101;1432;5;89;101;12;0,88;1
"1433";175;101;1433;5;77;93;16;0,76;0,92
"1434";175;101;1434;5;19;32;13;0,2;0,32
"1435";175;101;1435;5;40;56;16;0,4;0,56
"1436";175;101;1436;5;68;81;13;0,68;0,8
"1437";175;101;1437;5;28;40;12;0,28;0,4
"1438";175;101;1438;6;43;49;6;0,431372549019608;0,490196078431373
"1439";175;101;1439;6;65;71;6;0,647058823529412;0,705882352941177
"1440";175;101;1440;6;81;87;6;0,803921568627451;0,862745098039216
"1441";175;101;1441;6;1;7;6;0,0196078431372549;0,0784313725490196
"1442";175;101;1442;6;1;9;8;0,0196078431372549;0,0980392156862745
"1443";175;101;1443;6;37;43;6;0,372549019607843;0,431372549019608
"1444";175;101;1444;6;39;45;6;0,392156862745098;0,450980392156863
"1445";175;101;1445;6;77;83;6;0,764705882352941;0,823529411764706
"1446";175;101;1446;6;83;89;6;0,823529411764706;0,882352941176471
"1447";175;101;1447;6;83;91;8;0,823529411764706;0,901960784313726
"1448";175;101;1448;6;67;73;6;0,666666666666667;0,725490196078431
"1449";175;101;1449;6;29;35;6;0,294117647058824;0,352941176470588
"1450";175;101;1450;6;3;9;6;0,0392156862745098;0,0980392156862745
"1451";175;101;1451;6;63;69;6;0,627450980392157;0,686274509803922
"1452";175;101;1452;6;81;89;8;0,803921568627451;0,882352941176471
"1453";175;101;1453;6;85;91;6;0,843137254901961;0,901960784313726
"1454";175;101;1454;6;95;101;6;0,941176470588235;1
"1455";175;101;1455;6;79;85;6;0,784313725490196;0,843137254901961
"1456";175;101;1456;6;85;93;8;0,843137254901961;0,92156862745098
"1457";175;101;1457;6;73;79;6;0,725490196078431;0,784313725490196
"1458";175;101;1458;6;81;91;10;0,803921568627451;0,901960784313726
"1459";175;101;1459;6;75;81;6;0,745098039215686;0,803921568627451
"1460";175;101;1460;6;43;51;8;0,431372549019608;0,509803921568627
"1461";175;101;1461;6;1;11;10;0,0196078431372549;0,117647058823529
"1462";175;101;1462;6;3;11;8;0,0392156862745098;0,117647058823529
"1463";175;101;1463;6;89;95;6;0,882352941176471;0,941176470588235
"1464";175;101;1464;6;35;41;6;0,352941176470588;0,411764705882353
"1465";175;101;1465;6;79;87;8;0,784313725490196;0,862745098039216
"1466";175;101;1466;6;87;93;6;0,862745098039216;0,92156862745098
"1467";175;101;1467;6;87;95;8;0,862745098039216;0,941176470588235
"1468";175;101;1468;6;21;27;6;0,215686274509804;0,274509803921569
"1469";175;101;1469;6;41;47;6;0,411764705882353;0,470588235294118
"1470";175;101;1470;6;83;93;10;0,823529411764706;0,92156862745098
"1471";175;101;1471;6;69;75;6;0,686274509803922;0,745098039215686
"1472";175;101;1472;6;23;29;6;0,235294117647059;0,294117647058824
"1473";175;101;1473;6;93;99;6;0,92156862745098;0,980392156862745
"1474";175;101;1474;6;49;55;6;0,490196078431373;0,549019607843137
"1475";175;101;1475;6;91;97;6;0,901960784313726;0,96078431372549
"1476";175;101;1476;6;77;85;8;0,764705882352941;0,843137254901961
"1477";175;101;1477;6;33;39;6;0,333333333333333;0,392156862745098
"1478";175;101;1478;6;89;97;8;0,882352941176471;0,96078431372549
"1479";175;101;1479;6;19;25;6;0,196078431372549;0,254901960784314
"1480";175;101;1480;6;79;89;10;0,784313725490196;0,882352941176471
"1481";175;101;1481;6;45;51;6;0,450980392156863;0,509803921568627
"1482";175;101;1482;6;75;83;8;0,745098039215686;0,823529411764706
"1483";175;101;1483;6;25;31;6;0,254901960784314;0,313725490196078
"1484";175;101;1484;6;65;73;8;0,647058823529412;0,725490196078431
"1485";175;101;1485;6;77;87;10;0,764705882352941;0,862745098039216
"1486";175;101;1486;6;77;89;12;0,764705882352941;0,882352941176471
"1487";175;101;1487;6;13;19;6;0,137254901960784;0,196078431372549
"1488";175;101;1488;6;41;49;8;0,411764705882353;0,490196078431373
"1489";175;101;1489;6;53;59;6;0,529411764705882;0,588235294117647
"1490";175;101;1490;6;27;33;6;0,274509803921569;0,333333333333333
"1491";175;101;1491;6;59;65;6;0,588235294117647;0,647058823529412
"1492";175;101;1492;6;73;81;8;0,725490196078431;0,803921568627451
"1493";175;101;1493;6;63;71;8;0,627450980392157;0,705882352941177
"1494";175;101;1494;6;63;73;10;0,627450980392157;0,725490196078431
"1495";175;101;1495;6;37;45;8;0,372549019607843;0,450980392156863
"1496";4031;39;1496;4;27;39;12;0,7;1
"1497";4031;39;1497;4;23;35;12;0,6;0,9
"1498";4031;39;1498;5;27;33;6;0,7;0,85
"1499";4031;39;1499;5;29;35;6;0,75;0,9
"1500";4031;39;1500;5;11;17;6;0,3;0,45
"1501";4031;39;1501;5;33;39;6;0,85;1
"1502";4031;39;1502;5;31;37;6;0,8;0,95
"1503";4031;39;1503;5;9;15;6;0,25;0,4
"1504";4031;39;1504;5;25;31;6;0,65;0,8
"1505";4031;39;1505;5;5;11;6;0,15;0,3
"1506";4031;39;1506;5;23;29;6;0,6;0,75
"1507";4031;39;1507;5;7;13;6;0,2;0,35
"1508";584795;60;1508;3;8;34;26;0,142857142857143;0,571428571428571
"1509";584795;60;1509;4;11;23;12;0,2;0,4
"1510";584795;60;1510;4;15;27;12;0,266666666666667;0,466666666666667
"1511";584795;60;1511;4;7;19;12;0,133333333333333;0,333333333333333
"1512";584795;60;1512;5;15;21;6;0,266666666666667;0,366666666666667
"1513";584795;60;1513;5;50;56;6;0,833333333333333;0,933333333333333
"1514";584795;60;1514;5;44;50;6;0,733333333333333;0,833333333333333
"1515";584795;60;1515;5;7;13;6;0,133333333333333;0,233333333333333
"1516";584795;60;1516;5;1;7;6;0,0333333333333333;0,133333333333333
"1517";584795;60;1517;5;42;48;6;0,7;0,8
"1518";584795;60;1518;5;46;52;6;0,766666666666667;0,866666666666667
"1519";584795;60;1519;5;34;40;6;0,566666666666667;0,666666666666667
"1520";584795;60;1520;5;40;46;6;0,666666666666667;0,766666666666667
"1521";584795;60;1521;5;3;9;6;0,0666666666666667;0,166666666666667
"1522";584795;60;1522;5;48;54;6;0,8;0,9
"1523";585079;121;1523;3;69;121;52;0,571428571428571;1
"1524";585079;121;1524;4;97;121;24;0,8;1
"1525";585079;121;1525;4;15;40;25;0,133333333333333;0,333333333333333
"1526";585079;121;1526;4;88;113;25;0,733333333333333;0,933333333333333
"1527";585079;121;1527;4;23;48;25;0,2;0,4
"1528";585079;121;1528;5;72;84;12;0,6;0,7
"1529";585079;121;1529;5;101;113;12;0,833333333333333;0,933333333333333
"1530";585079;121;1530;5;101;117;16;0,833333333333333;0,966666666666667
"1531";585079;121;1531;5;105;117;12;0,866666666666667;0,966666666666667
"1532";585079;121;1532;5;105;121;16;0,866666666666667;1
"1533";585079;121;1533;5;68;80;12;0,566666666666667;0,666666666666667
"1534";585079;121;1534;5;76;88;12;0,633333333333333;0,733333333333333
"1535";585079;121;1535;5;23;36;13;0,2;0,3
"1536";585079;121;1536;5;93;105;12;0,766666666666667;0,866666666666667
"1537";585079;121;1537;5;97;109;12;0,8;0,9
"1538";585079;121;1538;5;64;76;12;0,533333333333333;0,633333333333333
"1539";585079;121;1539;5;97;113;16;0,8;0,933333333333333
"1540";585079;121;1540;5;27;40;13;0,233333333333333;0,333333333333333
"1541";585079;121;1541;5;15;27;12;0,133333333333333;0,233333333333333
"1542";585079;121;1542;6;3;9;6;0,0327868852459016;0,0819672131147541
"1543";585079;121;1543;6;3;11;8;0,0327868852459016;0,0983606557377049
"1544";585079;121;1544;6;35;41;6;0,295081967213115;0,344262295081967
"1545";585079;121;1545;6;75;81;6;0,622950819672131;0,672131147540984
"1546";585079;121;1546;6;75;83;8;0,622950819672131;0,688524590163934
"1547";585079;121;1547;6;83;89;6;0,688524590163934;0,737704918032787
"1548";585079;121;1548;6;105;111;6;0,868852459016393;0,918032786885246
"1549";585079;121;1549;6;73;79;6;0,60655737704918;0,655737704918033
"1550";585079;121;1550;6;73;81;8;0,60655737704918;0,672131147540984
"1551";585079;121;1551;6;93;99;6;0,770491803278688;0,819672131147541
"1552";585079;121;1552;6;93;101;8;0,770491803278688;0,836065573770492
"1553";585079;121;1553;6;85;91;6;0,704918032786885;0,754098360655738
"1554";585079;121;1554;6;107;113;6;0,885245901639344;0,934426229508197
"1555";585079;121;1555;6;111;117;6;0,918032786885246;0,967213114754098
"1556";585079;121;1556;6;103;109;6;0,852459016393443;0,901639344262295
"1557";585079;121;1557;6;103;111;8;0,852459016393443;0,918032786885246
"1558";585079;121;1558;6;5;11;6;0,0491803278688525;0,0983606557377049
"1559";585079;121;1559;6;99;105;6;0,819672131147541;0,868852459016393
"1560";585079;121;1560;6;63;69;6;0,524590163934426;0,573770491803279
"1561";585079;121;1561;6;115;121;6;0,950819672131147;1
"1562";585079;121;1562;6;83;91;8;0,688524590163934;0,754098360655738
"1563";585079;121;1563;6;109;115;6;0,901639344262295;0,950819672131147
"1564";585079;121;1564;6;15;21;6;0,131147540983607;0,180327868852459
"1565";585079;121;1565;6;101;107;6;0,836065573770492;0,885245901639344
"1566";585079;121;1566;6;105;113;8;0,868852459016393;0,934426229508197
"1567";585079;121;1567;6;7;13;6;0,0655737704918033;0,114754098360656
"1568";585079;121;1568;6;105;115;10;0,868852459016393;0,950819672131147
"1569";585079;121;1569;6;107;115;8;0,885245901639344;0,950819672131147
"1570";585079;121;1570;6;107;117;10;0,885245901639344;0,967213114754098
"1571";585079;121;1571;6;53;59;6;0,442622950819672;0,491803278688525
"1572";585079;121;1572;6;103;113;10;0,852459016393443;0,934426229508197
"1573";585079;121;1573;6;33;39;6;0,278688524590164;0,327868852459016
"1574";585079;121;1574;6;33;41;8;0,278688524590164;0,344262295081967
"1575";585079;121;1575;6;95;101;6;0,786885245901639;0,836065573770492
"1576";585079;121;1576;6;17;23;6;0,147540983606557;0,19672131147541
"1577";585079;121;1577;6;81;87;6;0,672131147540984;0,721311475409836
"1578";585079;121;1578;6;99;107;8;0,819672131147541;0,885245901639344
"1579";585079;121;1579;6;61;67;6;0,508196721311475;0,557377049180328
"1580";585079;121;1580;6;61;69;8;0,508196721311475;0,573770491803279
"1581";585079;121;1581;6;91;97;6;0,754098360655738;0,80327868852459
"1582";585079;121;1582;6;91;99;8;0,754098360655738;0,819672131147541
"1583";585079;121;1583;6;85;93;8;0,704918032786885;0,770491803278688
"1584";585079;121;1584;6;99;109;10;0,819672131147541;0,901639344262295
"1585";585079;121;1585;6;69;75;6;0,573770491803279;0,622950819672131
"1586";585079;121;1586;6;97;103;6;0,80327868852459;0,852459016393443
"1587";585079;121;1587;6;41;47;6;0,344262295081967;0,39344262295082
"1588";585079;121;1588;6;51;57;6;0,426229508196721;0,475409836065574
"1589";585079;121;1589;6;103;115;12;0,852459016393443;0,950819672131147
"1590";585079;121;1590;6;109;117;8;0,901639344262295;0,967213114754098
"1591";585079;121;1591;6;21;27;6;0,180327868852459;0,229508196721311
"1592";585079;121;1592;6;101;109;8;0,836065573770492;0,901639344262295
"1593";585079;121;1593;6;49;55;6;0,409836065573771;0,459016393442623
"1594";585079;121;1594;6;69;77;8;0,573770491803279;0,639344262295082
"1595";585079;121;1595;6;87;93;6;0,721311475409836;0,770491803278688
"1596";585079;121;1596;6;51;59;8;0,426229508196721;0,491803278688525
"1597";585079;121;1597;6;101;111;10;0,836065573770492;0,918032786885246
"1598";585079;121;1598;6;101;113;12;0,836065573770492;0,934426229508197
"1599";585079;121;1599;6;101;115;14;0,836065573770492;0,950819672131147
"1600";585079;121;1600;6;95;103;8;0,786885245901639;0,852459016393443
"1601";585079;121;1601;6;77;83;6;0,639344262295082;0,688524590163934
"1602";585079;121;1602;6;31;37;6;0,262295081967213;0,311475409836066
"1603";585079;121;1603;6;65;71;6;0,540983606557377;0,590163934426229
"1604";585079;121;1604;6;81;89;8;0,672131147540984;0,737704918032787
"1605";585079;121;1605;6;103;117;14;0,852459016393443;0,967213114754098
"1606";585079;121;1606;6;1;7;6;0,0163934426229508;0,0655737704918033
"1607";4495;167;1607;4;117;167;50;0,7;1
"1608";4495;167;1608;5;119;143;24;0,714285714285714;0,857142857142857
"1609";4495;167;1609;5;135;159;24;0,80952380952381;0,952380952380952
"1610";4495;167;1610;5;127;151;24;0,761904761904762;0,904761904761905
"1611";4495;167;1611;5;127;159;32;0,761904761904762;0,952380952380952
"1612";4495;167;1612;5;47;71;24;0,285714285714286;0,428571428571429
"1613";4495;167;1613;6;127;139;12;0,761904761904762;0,833333333333333
"1614";4495;167;1614;6;151;163;12;0,904761904761905;0,976190476190476
"1615";4495;167;1615;6;139;151;12;0,833333333333333;0,904761904761905
"1616";4495;167;1616;6;139;155;16;0,833333333333333;0,928571428571429
"1617";4495;167;1617;6;143;155;12;0,857142857142857;0,928571428571429
"1618";4495;167;1618;6;87;99;12;0,523809523809524;0,595238095238095
"1619";4495;167;1619;6;123;135;12;0,738095238095238;0,80952380952381
"1620";4495;167;1620;6;123;139;16;0,738095238095238;0,833333333333333
"1621";4495;167;1621;6;143;159;16;0,857142857142857;0,952380952380952
"1622";4495;167;1622;6;119;131;12;0,714285714285714;0,785714285714286
"1623";4495;167;1623;6;147;159;12;0,880952380952381;0,952380952380952
"1624";4495;167;1624;6;7;19;12;0,0476190476190476;0,119047619047619
"1625";4495;167;1625;6;155;167;12;0,928571428571429;1
"1626";4495;167;1626;6;115;127;12;0,69047619047619;0,761904761904762
"1627";4495;167;1627;6;119;135;16;0,714285714285714;0,80952380952381
"1628";4495;167;1628;6;131;143;12;0,785714285714286;0,857142857142857
"1629";4495;167;1629;6;131;147;16;0,785714285714286;0,880952380952381
"1630";4495;167;1630;6;135;147;12;0,80952380952381;0,880952380952381
"1631";4495;167;1631;6;3;15;12;0,0238095238095238;0,0952380952380952
"1632";4495;167;1632;6;71;83;12;0,428571428571429;0,5
"1633";4495;167;1633;6;119;139;20;0,714285714285714;0,833333333333333
"1634";4495;167;1634;6;27;39;12;0,166666666666667;0,238095238095238
"1635";5455;89;1635;3;35;89;54;0,4;1
"1636";5455;89;1636;4;40;64;24;0,454545454545455;0,727272727272727
"1637";5455;89;1637;4;64;89;25;0,727272727272727;1
"1638";5455;89;1638;4;48;73;25;0,545454545454545;0,818181818181818
"1639";5455;89;1639;5;64;77;13;0,727272727272727;0,863636363636364
"1640";5455;89;1640;5;36;48;12;0,409090909090909;0,545454545454545
"1641";5455;89;1641;5;32;44;12;0,363636363636364;0,5
"1642";5455;89;1642;5;40;52;12;0,454545454545455;0,590909090909091
"1643";5455;89;1643;5;56;69;13;0,636363636363636;0,772727272727273
"1644";5455;89;1644;5;48;60;12;0,545454545454545;0,681818181818182
"1645";5455;89;1645;5;73;85;12;0,818181818181818;0,954545454545455
"1646";5455;89;1646;5;60;73;13;0,681818181818182;0,818181818181818
"1647";5455;89;1647;5;52;64;12;0,590909090909091;0,727272727272727
"1648";5455;89;1648;5;44;56;12;0,5;0,636363636363636
"1649";5455;89;1649;5;69;81;12;0,772727272727273;0,909090909090909
"1650";5455;89;1650;5;15;28;13;0,181818181818182;0,318181818181818
"1651";5455;89;1651;6;63;69;6;0,711111111111111;0,777777777777778
"1652";5455;89;1652;6;31;37;6;0,355555555555556;0,422222222222222
"1653";5455;89;1653;6;39;45;6;0,444444444444444;0,511111111111111
"1654";5455;89;1654;6;45;51;6;0,511111111111111;0,577777777777778
"1655";5455;89;1655;6;41;47;6;0,466666666666667;0,533333333333333
"1656";5455;89;1656;6;55;61;6;0,622222222222222;0,688888888888889
"1657";5455;89;1657;6;25;31;6;0,288888888888889;0,355555555555556
"1658";5455;89;1658;6;57;63;6;0,644444444444444;0,711111111111111
"1659";5455;89;1659;6;73;79;6;0,822222222222222;0,888888888888889
"1660";5455;89;1660;6;15;21;6;0,177777777777778;0,244444444444444
"1661";5455;89;1661;6;23;29;6;0,266666666666667;0,333333333333333
"1662";5455;89;1662;6;29;35;6;0,333333333333333;0,4
"1663";5455;89;1663;6;21;27;6;0,244444444444444;0,311111111111111
"1664";5455;89;1664;6;79;85;6;0,888888888888889;0,955555555555556
"1665";5455;89;1665;6;37;43;6;0,422222222222222;0,488888888888889
"1666";5455;89;1666;6;71;77;6;0,8;0,866666666666667
"1667";5455;89;1667;6;83;89;6;0,933333333333333;1
"1668";5455;89;1668;6;19;25;6;0,222222222222222;0,288888888888889
"1669";5455;89;1669;6;3;9;6;0,0444444444444444;0,111111111111111
"1670";5455;89;1670;6;33;39;6;0,377777777777778;0,444444444444444
"1671";5455;89;1671;6;75;81;6;0,844444444444444;0,911111111111111
"1672";5455;89;1672;6;5;11;6;0,0666666666666667;0,133333333333333
"1673";5455;89;1673;6;17;23;6;0,2;0,266666666666667
"1674";5455;89;1674;6;73;81;8;0,822222222222222;0,911111111111111
"1675";5455;89;1675;6;53;59;6;0,6;0,666666666666667
"1676";5455;89;1676;6;53;61;8;0,6;0,688888888888889
"1677";5455;89;1677;6;13;19;6;0,155555555555556;0,222222222222222
"1678";5455;89;1678;6;55;63;8;0,622222222222222;0,711111111111111
"1679";5455;89;1679;6;39;47;8;0,444444444444444;0,533333333333333
"1680";5455;89;1680;6;47;53;6;0,533333333333333;0,6
"1681";5455;89;1681;6;81;87;6;0,911111111111111;0,977777777777778
"1682";5455;89;1682;6;35;41;6;0,4;0,466666666666667
"1683";5455;89;1683;6;79;87;8;0,888888888888889;0,977777777777778
"1684";5455;89;1684;6;61;67;6;0,688888888888889;0,755555555555556
"1685";585779;40;1685;4;24;36;12;0,6;0,9
"1686";585779;40;1686;4;3;15;12;0,1;0,4
"1687";585779;40;1687;4;7;20;13;0,2;0,5
"1688";585779;40;1688;4;28;40;12;0,7;1
"1689";585779;40;1689;5;9;15;6;0,25;0,4
"1690";585779;40;1690;5;28;34;6;0,7;0,85
"1691";585779;40;1691;5;30;36;6;0,75;0,9
"1692";585779;40;1692;5;26;32;6;0,65;0,8
"1693";585779;40;1693;5;7;13;6;0,2;0,35
"1694";585779;40;1694;5;7;15;8;0,2;0,4
"1695";585779;40;1695;5;22;28;6;0,55;0,7
"1696";585779;40;1696;5;28;36;8;0,7;0,9
"1697";585779;40;1697;5;32;38;6;0,8;0,95
"1698";585779;40;1698;5;11;17;6;0,3;0,45
"1699";585779;40;1699;5;3;9;6;0,1;0,25
"1700";585779;40;1700;5;34;40;6;0,85;1
"1701";585779;40;1701;5;30;38;8;0,75;0,95
"1702";585779;40;1702;5;24;30;6;0,6;0,75
"1703";585779;40;1703;5;1;7;6;0,05;0,2
"1704";585779;40;1704;5;9;17;8;0,25;0,45
"1705";585779;40;1705;5;26;34;8;0,65;0,85
"1706";586397;21;1706;4;3;9;6;0,181818181818182;0,454545454545455
"1707";586397;21;1707;4;13;19;6;0,636363636363636;0,909090909090909
"1708";586397;21;1708;4;1;7;6;0,0909090909090909;0,363636363636364
"1709";586397;21;1709;4;9;15;6;0,454545454545455;0,727272727272727
"1710";586397;21;1710;4;1;9;8;0,0909090909090909;0,454545454545455
"1711";586805;26;1711;3;12;26;14;0,5;1
"1712";586805;26;1712;4;11;18;7;0,461538461538462;0,692307692307692
"1713";586805;26;1713;4;11;20;9;0,461538461538462;0,769230769230769
"1714";586805;26;1714;4;11;22;11;0,461538461538462;0,846153846153846
"1715";586805;26;1715;4;11;24;13;0,461538461538462;0,923076923076923
"1716";586805;26;1716;4;11;26;15;0,461538461538462;1
"1717";586805;26;1717;4;3;9;6;0,153846153846154;0,384615384615385
"1718";587198;20;1718;3;3;16;13;0,2;0,8
"1719";587198;20;1719;3;3;20;17;0,2;1
"1720";587198;20;1720;4;1;7;6;0,1;0,4
"1721";587198;20;1721;4;1;10;9;0,1;0,5
"1722";587198;20;1722;4;1;12;11;0,1;0,6
"1723";587198;20;1723;4;1;14;13;0,1;0,7
"1724";587198;20;1724;4;1;16;15;0,1;0,8
"1725";587198;20;1725;4;1;18;17;0,1;0,9
"1726";587198;20;1726;4;1;20;19;0,1;1
"1727";587204;19;1727;3;3;15;12;0,2;0,8
"1728";587204;19;1728;3;3;19;16;0,2;1
"1729";587204;19;1729;3;7;19;12;0,4;1
"1730";587204;19;1730;4;1;7;6;0,1;0,4
"1731";587204;19;1731;4;1;9;8;0,1;0,5
"1732";587204;19;1732;4;5;11;6;0,3;0,6
"1733";587204;19;1733;4;7;13;6;0,4;0,7
"1734";587204;19;1734;4;7;15;8;0,4;0,8
"1735";587204;19;1735;4;1;11;10;0,1;0,6
"1736";587204;19;1736;4;1;13;12;0,1;0,7
"1737";587204;19;1737;4;5;13;8;0,3;0,7
"1738";587204;19;1738;4;5;15;10;0,3;0,8
"1739";587204;19;1739;4;5;17;12;0,3;0,9
"1740";587204;19;1740;4;7;17;10;0,4;0,9
"1741";587204;19;1741;4;7;19;12;0,4;1
"1742";587204;19;1742;4;5;19;14;0,3;1
"1743";587204;19;1743;4;1;15;14;0,1;0,8
"1744";587204;19;1744;4;1;17;16;0,1;0,9
"1745";587204;19;1745;4;1;19;18;0,1;1
"1746";587571;22;1746;3;4;17;13;0,2;0,8
"1747";587571;22;1747;3;4;22;18;0,2;1
"1748";587571;22;1748;3;8;22;14;0,4;1
"1749";587571;22;1749;4;5;12;7;0,272727272727273;0,545454545454545
"1750";587571;22;1750;4;5;14;9;0,272727272727273;0,636363636363636
"1751";587571;22;1751;4;7;14;7;0,363636363636364;0,636363636363636
"1752";587571;22;1752;4;9;16;7;0,454545454545455;0,727272727272727
"1753";587571;22;1753;4;9;18;9;0,454545454545455;0,818181818181818
"1754";587571;22;1754;4;3;9;6;0,181818181818182;0,454545454545455
"1755";587571;22;1755;4;3;12;9;0,181818181818182;0,545454545454545
"1756";587571;22;1756;4;3;14;11;0,181818181818182;0,636363636363636
"1757";587571;22;1757;4;3;16;13;0,181818181818182;0,727272727272727
"1758";587571;22;1758;4;5;16;11;0,272727272727273;0,727272727272727
"1759";587571;22;1759;4;5;18;13;0,272727272727273;0,818181818181818
"1760";587571;22;1760;4;7;16;9;0,363636363636364;0,727272727272727
"1761";587571;22;1761;4;7;18;11;0,363636363636364;0,818181818181818
"1762";587571;22;1762;4;7;20;13;0,363636363636364;0,909090909090909
"1763";587571;22;1763;4;5;20;15;0,272727272727273;0,909090909090909
"1764";587571;22;1764;4;5;22;17;0,272727272727273;1
"1765";587571;22;1765;4;7;22;15;0,363636363636364;1
"1766";587571;22;1766;4;9;20;11;0,454545454545455;0,909090909090909
"1767";587571;22;1767;4;9;22;13;0,454545454545455;1
"1768";587571;22;1768;4;1;7;6;0,0909090909090909;0,363636363636364
"1769";588202;18;1769;4;1;7;6;0,111111111111111;0,444444444444444
"1770";588202;18;1770;4;1;10;9;0,111111111111111;0,555555555555556
"1771";588202;18;1771;4;10;16;6;0,555555555555556;0,888888888888889
"1772";588202;18;1772;4;10;18;8;0,555555555555556;1
"1773";588202;18;1773;4;1;12;11;0,111111111111111;0,666666666666667
"1774";588411;17;1774;3;4;17;13;0,25;1
"1775";588411;17;1775;4;1;7;6;0,111111111111111;0,444444444444444
"1776";588411;17;1776;4;3;9;6;0,222222222222222;0,555555555555556
"1777";588411;17;1777;4;1;9;8;0,111111111111111;0,555555555555556
"1778";588411;17;1778;4;1;11;10;0,111111111111111;0,666666666666667
"1779";588411;17;1779;4;1;13;12;0,111111111111111;0,777777777777778
"1780";588411;17;1780;4;1;15;14;0,111111111111111;0,888888888888889
"1781";588411;17;1781;4;3;11;8;0,222222222222222;0,666666666666667
"1782";588411;17;1782;4;3;13;10;0,222222222222222;0,777777777777778
"1783";588411;17;1783;4;3;15;12;0,222222222222222;0,888888888888889
"1784";588411;17;1784;4;1;17;16;0,111111111111111;1
"1785";588411;17;1785;4;3;17;14;0,222222222222222;1
"1786";588935;17;1786;3;4;17;13;0,25;1
"1787";588935;17;1787;4;9;15;6;0,555555555555556;0,888888888888889
"1788";588935;17;1788;4;9;17;8;0,555555555555556;1
"1789";588935;17;1789;4;7;13;6;0,444444444444444;0,777777777777778
"1790";588935;17;1790;4;7;15;8;0,444444444444444;0,888888888888889
"1791";588935;17;1791;4;7;17;10;0,444444444444444;1
"1792";589091;13;1792;3;1;7;6;0,142857142857143;0,571428571428571
"1793";589091;13;1793;3;1;9;8;0,142857142857143;0,714285714285714
"1794";589091;13;1794;3;1;11;10;0,142857142857143;0,857142857142857
"1795";589091;13;1795;3;1;13;12;0,142857142857143;1
"1796";596700;15;1796;3;3;15;12;0,25;1
"1797";596700;15;1797;4;3;9;6;0,25;0,625
"1798";596700;15;1798;4;5;11;6;0,375;0,75
"1799";596700;15;1799;4;7;13;6;0,5;0,875
"1800";596700;15;1800;4;1;7;6;0,125;0,5
"1801";38;145;1801;4;80;129;49;0,555555555555556;0,888888888888889
"1802";38;145;1802;4;48;96;48;0,333333333333333;0,666666666666667
"1803";38;145;1803;4;64;113;49;0,444444444444444;0,777777777777778
"1804";38;145;1804;4;96;145;49;0,666666666666667;1
"1805";38;145;1805;5;88;113;25;0,611111111111111;0,777777777777778
"1806";38;145;1806;5;88;121;33;0,611111111111111;0,833333333333333
"1807";38;145;1807;5;72;96;24;0,5;0,666666666666667
"1808";38;145;1808;5;96;121;25;0,666666666666667;0,833333333333333
"1809";38;145;1809;5;64;88;24;0,444444444444444;0,611111111111111
"1810";38;145;1810;5;80;104;24;0,555555555555556;0,722222222222222
"1811";38;145;1811;5;80;113;33;0,555555555555556;0,777777777777778
"1812";38;145;1812;5;48;72;24;0,333333333333333;0,5
"1813";38;145;1813;5;56;80;24;0,388888888888889;0,555555555555556
"1814";38;145;1814;6;72;84;12;0,5;0,583333333333333
"1815";38;145;1815;6;27;40;13;0,194444444444444;0,277777777777778
"1816";38;145;1816;6;64;76;12;0,444444444444444;0,527777777777778
"1817";38;145;1817;6;88;100;12;0,611111111111111;0,694444444444444
"1818";38;145;1818;6;92;104;12;0,638888888888889;0,722222222222222
"1819";38;145;1819;6;108;121;13;0,75;0,833333333333333
"1820";38;145;1820;6;60;72;12;0,416666666666667;0,5
"1821";38;145;1821;6;60;76;16;0,416666666666667;0,527777777777778
"1822";38;145;1822;6;76;88;12;0,527777777777778;0,611111111111111
"1823";38;145;1823;6;84;96;12;0,583333333333333;0,666666666666667
"1824";38;145;1824;6;88;104;16;0,611111111111111;0,722222222222222
"1825";38;145;1825;6;113;125;12;0,777777777777778;0,861111111111111
"1826";38;145;1826;6;56;68;12;0,388888888888889;0,472222222222222
"1827";38;145;1827;6;104;117;13;0,722222222222222;0,805555555555556
"1828";38;145;1828;6;72;88;16;0,5;0,611111111111111
"1829";38;145;1829;6;121;133;12;0,833333333333333;0,916666666666667
"1830";38;145;1830;6;48;60;12;0,333333333333333;0,416666666666667
"1831";38;145;1831;6;100;113;13;0,694444444444444;0,777777777777778
"1832";38;145;1832;6;100;117;17;0,694444444444444;0,805555555555556
"1833";38;145;1833;6;104;121;17;0,722222222222222;0,833333333333333
"1834";38;145;1834;6;52;64;12;0,361111111111111;0,444444444444444
"1835";38;145;1835;6;80;92;12;0,555555555555556;0,638888888888889
"1836";38;145;1836;6;23;36;13;0,166666666666667;0,25
"1837";38;145;1837;6;68;80;12;0,472222222222222;0,555555555555556
"1838";38;145;1838;6;64;80;16;0,444444444444444;0,555555555555556
"1839";38;145;1839;6;56;72;16;0,388888888888889;0,5
"1840";155;163;1840;4;32;81;49;0,2;0,5
"1841";155;163;1841;4;48;97;49;0,3;0,6
"1842";155;163;1842;4;65;114;49;0,4;0,7
"1843";155;163;1843;4;15;65;50;0,1;0,4
"1844";155;163;1844;5;97;122;25;0,6;0,75
"1845";155;163;1845;5;106;130;24;0,65;0,8
"1846";155;163;1846;5;138;163;25;0,85;1
"1847";155;163;1847;5;89;114;25;0,55;0,7
"1848";155;163;1848;5;65;89;24;0,4;0,55
"1849";155;163;1849;5;40;65;25;0,25;0,4
"1850";155;163;1850;5;97;130;33;0,6;0,8
"1851";155;163;1851;5;48;73;25;0,3;0,45
"1852";155;163;1852;6;87;99;12;0,536585365853659;0,609756097560976
"1853";155;163;1853;6;111;123;12;0,682926829268293;0,75609756097561
"1854";155;163;1854;6;139;151;12;0,853658536585366;0,926829268292683
"1855";155;163;1855;6;35;47;12;0,219512195121951;0,292682926829268
"1856";155;163;1856;6;47;59;12;0,292682926829268;0,365853658536585
"1857";155;163;1857;6;47;63;16;0,292682926829268;0,390243902439024
"1858";155;163;1858;6;51;63;12;0,317073170731707;0,390243902439024
"1859";155;163;1859;6;55;67;12;0,341463414634146;0,414634146341463
"1860";155;163;1860;6;103;115;12;0,634146341463415;0,707317073170732
"1861";155;163;1861;6;143;155;12;0,878048780487805;0,951219512195122
"1862";155;163;1862;6;143;159;16;0,878048780487805;0,975609756097561
"1863";155;163;1863;6;151;163;12;0,926829268292683;1
"1864";155;163;1864;6;51;67;16;0,317073170731707;0,414634146341463
"1865";155;163;1865;6;103;119;16;0,634146341463415;0,731707317073171
"1866";155;163;1866;6;107;119;12;0,658536585365854;0,731707317073171
"1867";155;163;1867;6;107;123;16;0,658536585365854;0,75609756097561
"1868";155;163;1868;6;107;127;20;0,658536585365854;0,780487804878049
"1869";155;163;1869;6;147;159;12;0,902439024390244;0,975609756097561
"1870";155;163;1870;6;147;163;16;0,902439024390244;1
"1871";155;163;1871;6;11;23;12;0,0731707317073171;0,146341463414634
"1872";155;163;1872;6;95;107;12;0,585365853658537;0,658536585365854
"1873";155;163;1873;6;139;155;16;0,853658536585366;0,951219512195122
"1874";155;163;1874;6;143;163;20;0,878048780487805;1
"1875";155;163;1875;6;99;111;12;0,609756097560976;0,682926829268293
"1876";155;163;1876;6;99;115;16;0,609756097560976;0,707317073170732
"1877";155;163;1877;6;99;119;20;0,609756097560976;0,731707317073171
"1878";155;163;1878;6;139;159;20;0,853658536585366;0,975609756097561
"1879";155;163;1879;6;111;127;16;0,682926829268293;0,780487804878049
"1880";155;163;1880;6;119;131;12;0,731707317073171;0,804878048780488
"1881";155;163;1881;6;103;123;20;0,634146341463415;0,75609756097561
"1882";155;163;1882;6;15;27;12;0,0975609756097561;0,170731707317073
"1883";155;163;1883;6;67;79;12;0,414634146341463;0,48780487804878
"1884";155;163;1884;6;115;127;12;0,707317073170732;0,780487804878049
"1885";155;163;1885;6;79;91;12;0,48780487804878;0,560975609756098
"1886";155;163;1886;6;79;95;16;0,48780487804878;0,585365853658537
"1887";155;163;1887;6;83;95;12;0,51219512195122;0,585365853658537
"1888";155;163;1888;6;111;131;20;0,682926829268293;0,804878048780488
"1889";155;163;1889;6;91;103;12;0,560975609756098;0,634146341463415
"1890";155;163;1890;6;115;131;16;0,707317073170732;0,804878048780488
"1891";155;163;1891;6;135;147;12;0,829268292682927;0,902439024390244
"1892";155;163;1892;6;31;43;12;0,195121951219512;0,268292682926829
"1893";155;163;1893;6;139;163;24;0,853658536585366;1
"1894";155;163;1894;6;47;67;20;0,292682926829268;0,414634146341463
"1895";155;163;1895;6;23;35;12;0,146341463414634;0,219512195121951
"1896";155;163;1896;6;87;103;16;0,536585365853659;0,634146341463415
"1897";155;163;1897;6;99;123;24;0,609756097560976;0,75609756097561
"1898";360;123;1898;3;70;123;53;0,571428571428571;1
"1899";360;123;1899;3;52;105;53;0,428571428571429;0,857142857142857
"1900";360;123;1900;4;98;123;25;0,8;1
"1901";360;123;1901;4;90;115;25;0,733333333333333;0,933333333333333
"1902";360;123;1902;4;57;82;25;0,466666666666667;0,666666666666667
"1903";360;123;1903;4;65;90;25;0,533333333333333;0,733333333333333
"1904";360;123;1904;4;73;98;25;0,6;0,8
"1905";360;123;1905;4;82;106;24;0,666666666666667;0,866666666666667
"1906";360;123;1906;4;49;73;24;0,4;0,6
"1907";360;123;1907;4;40;65;25;0,333333333333333;0,533333333333333
"1908";360;123;1908;4;90;123;33;0,733333333333333;1
"1909";360;123;1909;4;7;32;25;0,0666666666666667;0,266666666666667
"1910";360;123;1910;5;51;63;12;0,419354838709677;0,516129032258065
"1911";360;123;1911;5;71;83;12;0,580645161290323;0,67741935483871
"1912";360;123;1912;5;47;59;12;0,387096774193548;0,483870967741935
"1913";360;123;1913;5;59;71;12;0,483870967741935;0,580645161290323
"1914";360;123;1914;5;95;107;12;0,774193548387097;0,870967741935484
"1915";360;123;1915;5;99;111;12;0,806451612903226;0,903225806451613
"1916";360;123;1916;5;99;115;16;0,806451612903226;0,935483870967742
"1917";360;123;1917;5;99;119;20;0,806451612903226;0,967741935483871
"1918";360;123;1918;5;103;115;12;0,838709677419355;0,935483870967742
"1919";360;123;1919;5;103;119;16;0,838709677419355;0,967741935483871
"1920";360;123;1920;5;107;119;12;0,870967741935484;0,967741935483871
"1921";360;123;1921;5;111;123;12;0,903225806451613;1
"1922";360;123;1922;5;91;103;12;0,741935483870968;0,838709677419355
"1923";360;123;1923;5;67;79;12;0,548387096774194;0,645161290322581
"1924";360;123;1924;5;91;107;16;0,741935483870968;0,870967741935484
"1925";360;123;1925;5;95;111;16;0,774193548387097;0,903225806451613
"1926";360;123;1926;5;107;123;16;0,870967741935484;1
"1927";360;123;1927;5;23;35;12;0,193548387096774;0,290322580645161
"1928";360;123;1928;5;55;67;12;0,451612903225806;0,548387096774194
"1929";360;123;1929;5;55;71;16;0,451612903225806;0,580645161290323
"1930";360;123;1930;5;91;111;20;0,741935483870968;0,903225806451613
"1931";360;123;1931;5;87;99;12;0,709677419354839;0,806451612903226
"1932";360;123;1932;5;83;95;12;0,67741935483871;0,774193548387097
"1933";360;123;1933;5;83;99;16;0,67741935483871;0,806451612903226
"1934";360;123;1934;5;19;31;12;0,161290322580645;0,258064516129032
"1935";360;123;1935;5;103;123;20;0,838709677419355;1
"1936";360;123;1936;5;27;39;12;0,225806451612903;0,32258064516129
"1937";360;123;1937;5;39;51;12;0,32258064516129;0,419354838709677
"1938";360;123;1938;5;63;75;12;0,516129032258065;0,612903225806452
"1939";360;123;1939;5;43;55;12;0,354838709677419;0,451612903225806
"1940";360;123;1940;5;87;103;16;0,709677419354839;0,838709677419355
"1941";360;123;1941;5;87;107;20;0,709677419354839;0,870967741935484
"1942";360;123;1942;6;17;23;6;0,145161290322581;0,193548387096774
"1943";360;123;1943;6;93;99;6;0,758064516129032;0,806451612903226
"1944";360;123;1944;6;103;109;6;0,838709677419355;0,887096774193548
"1945";360;123;1945;6;19;25;6;0,161290322580645;0,209677419354839
"1946";360;123;1946;6;33;39;6;0,274193548387097;0,32258064516129
"1947";360;123;1947;6;55;61;6;0,451612903225806;0,5
"1948";360;123;1948;6;55;63;8;0,451612903225806;0,516129032258065
"1949";360;123;1949;6;57;63;6;0,467741935483871;0,516129032258065
"1950";360;123;1950;6;65;71;6;0,532258064516129;0,580645161290323
"1951";360;123;1951;6;75;81;6;0,612903225806452;0,661290322580645
"1952";360;123;1952;6;95;101;6;0,774193548387097;0,82258064516129
"1953";360;123;1953;6;101;107;6;0,82258064516129;0,870967741935484
"1954";360;123;1954;6;103;111;8;0,838709677419355;0,903225806451613
"1955";360;123;1955;6;103;113;10;0,838709677419355;0,919354838709677
"1956";360;123;1956;6;105;111;6;0,854838709677419;0,903225806451613
"1957";360;123;1957;6;107;113;6;0,870967741935484;0,919354838709677
"1958";360;123;1958;6;109;115;6;0,887096774193548;0,935483870967742
"1959";360;123;1959;6;111;117;6;0,903225806451613;0,951612903225806
"1960";360;123;1960;6;113;119;6;0,919354838709677;0,967741935483871
"1961";360;123;1961;6;117;123;6;0,951612903225806;1
"1962";360;123;1962;6;15;21;6;0,129032258064516;0,17741935483871
"1963";360;123;1963;6;53;59;6;0,435483870967742;0,483870967741935
"1964";360;123;1964;6;59;65;6;0,483870967741935;0,532258064516129
"1965";360;123;1965;6;59;67;8;0,483870967741935;0,548387096774194
"1966";360;123;1966;6;61;67;6;0,5;0,548387096774194
"1967";360;123;1967;6;67;73;6;0,548387096774194;0,596774193548387
"1968";360;123;1968;6;69;75;6;0,564516129032258;0,612903225806452
"1969";360;123;1969;6;99;105;6;0,806451612903226;0,854838709677419
"1970";360;123;1970;6;99;107;8;0,806451612903226;0,870967741935484
"1971";360;123;1971;6;99;109;10;0,806451612903226;0,887096774193548
"1972";360;123;1972;6;103;115;12;0,838709677419355;0,935483870967742
"1973";360;123;1973;6;103;117;14;0,838709677419355;0,951612903225806
"1974";360;123;1974;6;107;115;8;0,870967741935484;0,935483870967742
"1975";360;123;1975;6;51;57;6;0,419354838709677;0,467741935483871
"1976";360;123;1976;6;51;59;8;0,419354838709677;0,483870967741935
"1977";360;123;1977;6;81;87;6;0,661290322580645;0,709677419354839
"1978";360;123;1978;6;97;103;6;0,790322580645161;0,838709677419355
"1979";360;123;1979;6;31;37;6;0,258064516129032;0,306451612903226
"1980";360;123;1980;6;73;79;6;0,596774193548387;0,645161290322581
"1981";360;123;1981;6;89;95;6;0,725806451612903;0,774193548387097
"1982";360;123;1982;6;93;101;8;0,758064516129032;0,82258064516129
"1983";360;123;1983;6;61;69;8;0,5;0,564516129032258
"1984";360;123;1984;6;63;69;6;0,516129032258065;0,564516129032258
"1985";360;123;1985;6;97;105;8;0,790322580645161;0,854838709677419
"1986";360;123;1986;6;97;107;10;0,790322580645161;0,870967741935484
"1987";360;123;1987;6;105;113;8;0,854838709677419;0,919354838709677
"1988";360;123;1988;6;105;115;10;0,854838709677419;0,935483870967742
"1989";360;123;1989;6;113;121;8;0,919354838709677;0,983870967741935
"1990";360;123;1990;6;113;123;10;0,919354838709677;1
"1991";360;123;1991;6;115;121;6;0,935483870967742;0,983870967741935
"1992";360;123;1992;6;115;123;8;0,935483870967742;1
"1993";360;123;1993;6;5;11;6;0,0483870967741935;0,0967741935483871
"1994";360;123;1994;6;71;77;6;0,580645161290323;0,629032258064516
"1995";360;123;1995;6;71;79;8;0,580645161290323;0,645161290322581
"1996";360;123;1996;6;89;97;8;0,725806451612903;0,790322580645161
"1997";360;123;1997;6;25;31;6;0,209677419354839;0,258064516129032
"1998";360;123;1998;6;27;33;6;0,225806451612903;0,274193548387097
"1999";360;123;1999;6;45;51;6;0,370967741935484;0,419354838709677
"2000";360;123;2000;6;49;55;6;0,403225806451613;0,451612903225806
"2001";360;123;2001;6;95;103;8;0,774193548387097;0,838709677419355
"2002";360;123;2002;6;101;109;8;0,82258064516129;0,887096774193548
"2003";360;123;2003;6;101;111;10;0,82258064516129;0,903225806451613
"2004";360;123;2004;6;105;117;12;0,854838709677419;0,951612903225806
"2005";360;123;2005;6;105;119;14;0,854838709677419;0,967741935483871
"2006";360;123;2006;6;109;117;8;0,887096774193548;0,951612903225806
"2007";360;123;2007;6;109;119;10;0,887096774193548;0,967741935483871
"2008";360;123;2008;6;109;121;12;0,887096774193548;0,983870967741935
"2009";360;123;2009;6;83;89;6;0,67741935483871;0,725806451612903
"2010";360;123;2010;6;107;117;10;0,870967741935484;0,951612903225806
"2011";360;123;2011;6;41;47;6;0,338709677419355;0,387096774193548
"2012";360;123;2012;6;77;83;6;0,629032258064516;0,67741935483871
"2013";360;123;2013;6;89;99;10;0,725806451612903;0,806451612903226
"2014";360;123;2014;6;91;97;6;0,741935483870968;0,790322580645161
"2015";360;123;2015;6;91;99;8;0,741935483870968;0,806451612903226
"2016";360;123;2016;6;111;119;8;0,903225806451613;0,967741935483871
"2017";360;123;2017;6;107;119;12;0,870967741935484;0,967741935483871
"2018";360;123;2018;6;21;27;6;0,17741935483871;0,225806451612903
"2019";360;123;2019;6;29;35;6;0,241935483870968;0,290322580645161
"2020";360;123;2020;6;75;83;8;0,612903225806452;0,67741935483871
"2021";360;123;2021;6;7;13;6;0,0645161290322581;0,112903225806452
"2022";360;123;2022;6;43;49;6;0,354838709677419;0,403225806451613
"2023";360;123;2023;6;43;51;8;0,354838709677419;0,419354838709677
"2024";360;123;2024;6;71;81;10;0,580645161290323;0,661290322580645
"2025";360;123;2025;6;73;81;8;0,596774193548387;0,661290322580645
"2026";360;123;2026;6;73;83;10;0,596774193548387;0,67741935483871
"2027";360;123;2027;6;31;39;8;0,258064516129032;0,32258064516129
"2028";360;123;2028;6;13;19;6;0,112903225806452;0,161290322580645
"2029";360;123;2029;6;67;75;8;0,548387096774194;0,612903225806452
"2030";360;123;2030;6;23;29;6;0,193548387096774;0,241935483870968
"2031";360;123;2031;6;91;101;10;0,741935483870968;0,82258064516129
"2032";360;123;2032;6;57;65;8;0,467741935483871;0,532258064516129
"2033";360;123;2033;6;111;121;10;0,903225806451613;0,983870967741935
"2034";360;123;2034;6;111;123;12;0,903225806451613;1
"2035";360;123;2035;6;35;41;6;0,290322580645161;0,338709677419355
"2036";360;123;2036;6;63;71;8;0,516129032258065;0,580645161290323
"2037";360;123;2037;6;69;77;8;0,564516129032258;0,629032258064516
"2038";360;123;2038;6;93;103;10;0,758064516129032;0,838709677419355
"2039";360;123;2039;6;39;45;6;0,32258064516129;0,370967741935484
"2040";360;123;2040;6;89;101;12;0,725806451612903;0,82258064516129
"2041";360;123;2041;6;3;9;6;0,032258064516129;0,0806451612903226
"2042";360;123;2042;6;101;113;12;0,82258064516129;0,919354838709677
"2043";360;123;2043;6;101;115;14;0,82258064516129;0,935483870967742
"2044";360;123;2044;6;107;121;14;0,870967741935484;0,983870967741935
"2045";360;123;2045;6;47;53;6;0,387096774193548;0,435483870967742
"2046";360;123;2046;6;109;123;14;0,887096774193548;1
"2047";360;123;2047;6;95;105;10;0,774193548387097;0,854838709677419
"2048";360;123;2048;6;59;69;10;0,483870967741935;0,564516129032258
"2049";360;123;2049;6;93;105;12;0,758064516129032;0,854838709677419
"2050";360;123;2050;6;47;55;8;0,387096774193548;0,451612903225806
"2051";433;157;2051;4;34;87;53;0,222222222222222;0,555555555555556
"2052";433;157;2052;5;41;66;25;0,263157894736842;0,421052631578947
"2053";433;157;2053;5;66;90;24;0,421052631578947;0,578947368421053
"2054";433;157;2054;5;57;82;25;0,368421052631579;0,526315789473684
"2055";433;157;2055;5;74;99;25;0,473684210526316;0,631578947368421
"2056";433;157;2056;5;49;74;25;0,315789473684211;0,473684210526316
"2057";433;157;2057;5;16;41;25;0,105263157894737;0,263157894736842
"2058";433;157;2058;5;99;124;25;0,631578947368421;0,789473684210526
"2059";433;157;2059;5;124;149;25;0,789473684210526;0,947368421052632
"2060";433;157;2060;5;132;157;25;0,842105263157895;1
"2061";433;157;2061;5;90;115;25;0,578947368421053;0,736842105263158
"2062";433;157;2062;5;57;90;33;0,368421052631579;0,578947368421053
"2063";433;157;2063;6;108;121;13;0,692307692307692;0,769230769230769
"2064";433;157;2064;6;72;84;12;0,461538461538462;0,538461538461538
"2065";433;157;2065;6;100;112;12;0,641025641025641;0,717948717948718
"2066";433;157;2066;6;104;116;12;0,666666666666667;0,743589743589744
"2067";433;157;2067;6;48;60;12;0,307692307692308;0,384615384615385
"2068";433;157;2068;6;60;72;12;0,384615384615385;0,461538461538462
"2069";433;157;2069;6;64;76;12;0,41025641025641;0,487179487179487
"2070";433;157;2070;6;68;80;12;0,435897435897436;0,512820512820513
"2071";433;157;2071;6;145;157;12;0,923076923076923;1
"2072";433;157;2072;6;19;31;12;0,128205128205128;0,205128205128205
"2073";433;157;2073;6;80;92;12;0,512820512820513;0,58974358974359
"2074";433;157;2074;6;141;153;12;0,897435897435897;0,974358974358974
"2075";433;157;2075;6;31;44;13;0,205128205128205;0,282051282051282
"2076";433;157;2076;6;64;80;16;0,41025641025641;0,512820512820513
"2077";433;157;2077;6;137;149;12;0,871794871794872;0,948717948717949
"2078";433;157;2078;6;92;104;12;0,58974358974359;0,666666666666667
"2079";433;157;2079;6;96;108;12;0,615384615384615;0,692307692307692
"2080";433;157;2080;6;112;125;13;0,717948717948718;0,794871794871795
"2081";433;157;2081;6;52;64;12;0,333333333333333;0,41025641025641
"2082";433;157;2082;6;72;88;16;0,461538461538462;0,564102564102564
"2083";433;157;2083;6;76;88;12;0,487179487179487;0,564102564102564
"2084";433;157;2084;6;76;92;16;0,487179487179487;0,58974358974359
"2085";433;157;2085;6;60;76;16;0,384615384615385;0,487179487179487
"2086";433;157;2086;6;7;19;12;0,0512820512820513;0,128205128205128
"2087";433;157;2087;6;27;40;13;0,179487179487179;0,256410256410256
"2088";433;157;2088;6;84;96;12;0,538461538461538;0,615384615384615
"2089";433;157;2089;6;141;157;16;0,897435897435897;1
"2090";433;157;2090;6;104;121;17;0,666666666666667;0,769230769230769
"2091";433;157;2091;6;133;145;12;0,846153846153846;0,923076923076923
"2092";433;157;2092;6;11;23;12;0,0769230769230769;0,153846153846154
"2093";433;157;2093;6;125;137;12;0,794871794871795;0,871794871794872
"2094";433;157;2094;6;133;149;16;0,846153846153846;0,948717948717949
"2095";433;157;2095;6;129;141;12;0,82051282051282;0,897435897435897
"2096";433;157;2096;6;137;153;16;0,871794871794872;0,974358974358974
"2097";433;157;2097;6;15;27;12;0,102564102564103;0,179487179487179
"2098";433;157;2098;6;88;100;12;0,564102564102564;0,641025641025641
"2099";433;157;2099;6;121;133;12;0,769230769230769;0,846153846153846
"2100";433;157;2100;6;60;80;20;0,384615384615385;0,512820512820513
"2101";475;129;2101;3;32;129;97;0,25;1
"2102";475;129;2102;4;15;64;49;0,125;0,5
"2103";475;129;2103;4;80;129;49;0,625;1
"2104";475;129;2104;4;64;113;49;0,5;0,875
"2105";475;129;2105;4;48;96;48;0,375;0,75
"2106";475;129;2106;4;32;80;48;0,25;0,625
"2107";475;129;2107;4;64;129;65;0,5;1
"2108";475;129;2108;5;64;88;24;0,5;0,6875
"2109";475;129;2109;5;72;96;24;0,5625;0,75
"2110";475;129;2110;5;72;105;33;0,5625;0,8125
"2111";475;129;2111;5;96;121;25;0,75;0,9375
"2112";475;129;2112;5;96;129;33;0,75;1
"2113";475;129;2113;5;105;129;24;0,8125;1
"2114";475;129;2114;5;23;48;25;0,1875;0,375
"2115";475;129;2115;5;80;105;25;0,625;0,8125
"2116";475;129;2116;5;80;113;33;0,625;0,875
"2117";475;129;2117;5;40;64;24;0,3125;0,5
"2118";475;129;2118;5;88;113;25;0,6875;0,875
"2119";475;129;2119;5;32;56;24;0,25;0,4375
"2120";475;129;2120;5;15;40;25;0,125;0,3125
"2121";475;129;2121;5;88;121;33;0,6875;0,9375
"2122";475;129;2122;5;48;72;24;0,375;0,5625
"2123";475;129;2123;5;88;129;41;0,6875;1
"2124";475;129;2124;5;64;96;32;0,5;0,75
"2125";475;129;2125;5;64;105;41;0,5;0,8125
"2126";475;129;2126;5;7;32;25;0,0625;0,25
"2127";475;129;2127;5;56;80;24;0,4375;0,625
"2128";475;129;2128;5;80;121;41;0,625;0,9375
"2129";475;129;2129;5;80;129;49;0,625;1
"2130";475;129;2130;6;44;56;12;0,34375;0,4375
"2131";475;129;2131;6;72;84;12;0,5625;0,65625
"2132";475;129;2132;6;80;92;12;0,625;0,71875
"2133";475;129;2133;6;80;96;16;0,625;0,75
"2134";475;129;2134;6;84;96;12;0,65625;0,75
"2135";475;129;2135;6;84;101;17;0,65625;0,78125
"2136";475;129;2136;6;105;117;12;0,8125;0,90625
"2137";475;129;2137;6;109;121;12;0,84375;0,9375
"2138";475;129;2138;6;48;60;12;0,375;0,46875
"2139";475;129;2139;6;56;68;12;0,4375;0,53125
"2140";475;129;2140;6;72;88;16;0,5625;0,6875
"2141";475;129;2141;6;88;101;13;0,6875;0,78125
"2142";475;129;2142;6;105;121;16;0,8125;0,9375
"2143";475;129;2143;6;105;125;20;0,8125;0,96875
"2144";475;129;2144;6;52;64;12;0,40625;0,5
"2145";475;129;2145;6;11;23;12;0,09375;0,1875
"2146";475;129;2146;6;7;19;12;0,0625;0,15625
"2147";475;129;2147;6;60;72;12;0,46875;0,5625
"2148";475;129;2148;6;88;105;17;0,6875;0,8125
"2149";475;129;2149;6;92;105;13;0,71875;0,8125
"2150";475;129;2150;6;109;125;16;0,84375;0,96875
"2151";475;129;2151;6;109;129;20;0,84375;1
"2152";475;129;2152;6;52;68;16;0,40625;0,53125
"2153";475;129;2153;6;68;80;12;0,53125;0,625
"2154";475;129;2154;6;23;36;13;0,1875;0,28125
"2155";475;129;2155;6;36;48;12;0,28125;0,375
"2156";475;129;2156;6;113;125;12;0,875;0,96875
"2157";475;129;2157;6;44;60;16;0,34375;0,46875
"2158";475;129;2158;6;84;105;21;0,65625;0,8125
"2159";475;129;2159;6;15;27;12;0,125;0,21875
"2160";475;129;2160;6;72;92;20;0,5625;0,71875
"2161";475;129;2161;6;84;109;25;0,65625;0,84375
"2162";475;129;2162;6;101;113;12;0,78125;0,875
"2163";475;129;2163;6;101;117;16;0,78125;0,90625
"2164";475;129;2164;6;101;121;20;0,78125;0,9375
"2165";475;129;2165;6;101;125;24;0,78125;0,96875
"2166";475;129;2166;6;113;129;16;0,875;1
"2167";475;129;2167;6;40;52;12;0,3125;0,40625
"2168";475;129;2168;6;76;88;12;0,59375;0,6875
"2169";475;129;2169;6;80;101;21;0,625;0,78125
"2170";475;129;2170;6;88;109;21;0,6875;0,84375
"2171";475;129;2171;6;92;109;17;0,71875;0,84375
"2172";475;129;2172;6;105;129;24;0,8125;1
"2173";475;129;2173;6;27;40;13;0,21875;0,3125
"2174";475;129;2174;6;32;44;12;0,25;0,34375
"2175";475;129;2175;6;72;96;24;0,5625;0,75
"2176";475;129;2176;6;68;84;16;0,53125;0,65625
"2177";475;129;2177;6;19;32;13;0,15625;0,25
"2178";475;129;2178;6;88;113;25;0,6875;0,875
"2179";475;129;2179;6;11;27;16;0,09375;0,21875
"2180";475;129;2180;6;3;15;12;0,03125;0,125
"2181";475;129;2181;6;76;92;16;0,59375;0,71875
"2182";475;129;2182;6;80;105;25;0,625;0,8125
"2183";475;129;2183;6;92;113;21;0,71875;0,875
"2184";475;129;2184;6;92;117;25;0,71875;0,90625
"2185";475;129;2185;6;48;64;16;0,375;0,5
"2186";475;129;2186;6;101;129;28;0,78125;1
"2187";475;129;2187;6;68;88;20;0,53125;0,6875
"2188";475;129;2188;6;96;109;13;0,75;0,84375
"2189";76;45;2189;3;8;36;28;0,2;0,8
"2190";76;45;2190;4;3;16;13;0,0909090909090909;0,363636363636364
"2191";76;45;2191;4;24;37;13;0,545454545454545;0,818181818181818
"2192";76;45;2192;4;7;20;13;0,181818181818182;0,454545454545455
"2193";76;45;2193;4;7;24;17;0,181818181818182;0,545454545454545
"2194";76;45;2194;4;16;28;12;0,363636363636364;0,636363636363636
"2195";76;45;2195;4;16;32;16;0,363636363636364;0,727272727272727
"2196";76;45;2196;4;12;24;12;0,272727272727273;0,545454545454545
"2197";76;45;2197;4;3;20;17;0,0909090909090909;0,454545454545455
"2198";76;45;2198;4;12;28;16;0,272727272727273;0,636363636363636
"2199";76;45;2199;4;20;32;12;0,454545454545455;0,727272727272727
"2200";76;45;2200;5;9;15;6;0,217391304347826;0,347826086956522
"2201";76;45;2201;5;23;29;6;0,521739130434783;0,652173913043478
"2202";76;45;2202;5;17;23;6;0,391304347826087;0,521739130434783
"2203";76;45;2203;5;25;31;6;0,565217391304348;0,695652173913043
"2204";76;45;2204;5;3;9;6;0,0869565217391304;0,217391304347826
"2205";76;45;2205;5;3;11;8;0,0869565217391304;0,260869565217391
"2206";76;45;2206;5;7;13;6;0,173913043478261;0,304347826086957
"2207";76;45;2207;5;7;15;8;0,173913043478261;0,347826086956522
"2208";76;45;2208;5;11;17;6;0,260869565217391;0,391304347826087
"2209";76;45;2209;5;15;21;6;0,347826086956522;0,478260869565217
"2210";76;45;2210;5;27;33;6;0,608695652173913;0,739130434782609
"2211";76;45;2211;5;3;13;10;0,0869565217391304;0,304347826086957
"2212";76;45;2212;5;3;15;12;0,0869565217391304;0,347826086956522
"2213";76;45;2213;5;3;17;14;0,0869565217391304;0,391304347826087
"2214";76;45;2214;5;7;17;10;0,173913043478261;0,391304347826087
"2215";76;45;2215;5;9;17;8;0,217391304347826;0,391304347826087
"2216";76;45;2216;5;23;31;8;0,521739130434783;0,695652173913043
"2217";76;45;2217;5;25;33;8;0,565217391304348;0,739130434782609
"2218";76;45;2218;5;27;35;8;0,608695652173913;0,782608695652174
"2219";76;45;2219;5;13;19;6;0,304347826086957;0,434782608695652
"2220";76;45;2220;5;13;21;8;0,304347826086957;0,478260869565217
"2221";76;45;2221;5;1;7;6;0,0434782608695652;0,173913043478261
"2222";76;45;2222;5;1;9;8;0,0434782608695652;0,217391304347826
"2223";76;45;2223;5;5;11;6;0,130434782608696;0,260869565217391
"2224";76;45;2224;5;5;13;8;0,130434782608696;0,304347826086957
"2225";76;45;2225;5;5;15;10;0,130434782608696;0,347826086956522
"2226";76;45;2226;5;11;19;8;0,260869565217391;0,434782608695652
"2227";76;45;2227;5;11;21;10;0,260869565217391;0,478260869565217
"2228";76;45;2228;5;25;35;10;0,565217391304348;0,782608695652174
"2229";76;45;2229;5;29;35;6;0,652173913043478;0,782608695652174
"2230";76;45;2230;5;9;19;10;0,217391304347826;0,434782608695652
"2231";76;45;2231;5;23;33;10;0,521739130434783;0,739130434782609
"2232";76;45;2232;5;23;35;12;0,521739130434783;0,782608695652174
"2233";76;45;2233;5;21;27;6;0,478260869565217;0,608695652173913
"2234";76;45;2234;5;35;41;6;0,782608695652174;0,91304347826087
"2235";76;45;2235;5;5;17;12;0,130434782608696;0,391304347826087
"2236";76;45;2236;5;7;19;12;0,173913043478261;0,434782608695652
"2237";93;163;2237;3;65;163;98;0,4;1
"2238";93;163;2238;4;81;130;49;0,5;0,8
"2239";93;163;2239;4;97;147;50;0,6;0,9
"2240";93;163;2240;4;114;163;49;0,7;1
"2241";93;163;2241;4;65;114;49;0,4;0,7
"2242";93;163;2242;4;48;97;49;0,3;0,6
"2243";93;163;2243;4;81;147;66;0,5;0,9
"2244";93;163;2244;5;89;114;25;0,55;0,7
"2245";93;163;2245;5;97;122;25;0,6;0,75
"2246";93;163;2246;5;81;106;25;0,5;0,65
"2247";93;163;2247;5;81;114;33;0,5;0,7
"2248";93;163;2248;5;81;122;41;0,5;0,75
"2249";93;163;2249;5;89;122;33;0,55;0,75
"2250";93;163;2250;5;130;155;25;0,8;0,95
"2251";93;163;2251;5;130;163;33;0,8;1
"2252";93;163;2252;5;138;163;25;0,85;1
"2253";93;163;2253;5;65;89;24;0,4;0,55
"2254";93;163;2254;5;56;81;25;0,35;0,5
"2255";93;163;2255;5;122;147;25;0,75;0,9
"2256";93;163;2256;5;114;138;24;0,7;0,85
"2257";93;163;2257;5;106;130;24;0,65;0,8
"2258";93;163;2258;5;122;155;33;0,75;0,95
"2259";93;163;2259;5;97;130;33;0,6;0,8
"2260";93;163;2260;5;122;163;41;0,75;1
"2261";93;163;2261;5;73;97;24;0,45;0,6
"2262";93;163;2262;5;48;73;25;0,3;0,45
"2263";93;163;2263;5;73;106;33;0,45;0,65
"2264";93;163;2264;5;106;138;32;0,65;0,85
"2265";93;163;2265;5;106;147;41;0,65;0,9
"2266";93;163;2266;5;114;147;33;0,7;0,9
"2267";93;163;2267;6;103;115;12;0,634146341463415;0,707317073170732
"2268";93;163;2268;6;115;127;12;0,707317073170732;0,780487804878049
"2269";93;163;2269;6;139;151;12;0,853658536585366;0,926829268292683
"2270";93;163;2270;6;27;39;12;0,170731707317073;0,24390243902439
"2271";93;163;2271;6;83;95;12;0,51219512195122;0,585365853658537
"2272";93;163;2272;6;83;99;16;0,51219512195122;0,609756097560976
"2273";93;163;2273;6;83;103;20;0,51219512195122;0,634146341463415
"2274";93;163;2274;6;87;99;12;0,536585365853659;0,609756097560976
"2275";93;163;2275;6;87;103;16;0,536585365853659;0,634146341463415
"2276";93;163;2276;6;95;107;12;0,585365853658537;0,658536585365854
"2277";93;163;2277;6;99;111;12;0,609756097560976;0,682926829268293
"2278";93;163;2278;6;111;123;12;0,682926829268293;0,75609756097561
"2279";93;163;2279;6;127;139;12;0,780487804878049;0,853658536585366
"2280";93;163;2280;6;127;143;16;0,780487804878049;0,878048780487805
"2281";93;163;2281;6;131;143;12;0,804878048780488;0,878048780487805
"2282";93;163;2282;6;135;147;12;0,829268292682927;0,902439024390244
"2283";93;163;2283;6;139;155;16;0,853658536585366;0,951219512195122
"2284";93;163;2284;6;143;155;12;0,878048780487805;0,951219512195122
"2285";93;163;2285;6;147;159;12;0,902439024390244;0,975609756097561
"2286";93;163;2286;6;151;163;12;0,926829268292683;1
"2287";93;163;2287;6;79;91;12;0,48780487804878;0,560975609756098
"2288";93;163;2288;6;79;95;16;0,48780487804878;0,585365853658537
"2289";93;163;2289;6;87;107;20;0,536585365853659;0,658536585365854
"2290";93;163;2290;6;87;111;24;0,536585365853659;0,682926829268293
"2291";93;163;2291;6;91;103;12;0,560975609756098;0,634146341463415
"2292";93;163;2292;6;91;107;16;0,560975609756098;0,658536585365854
"2293";93;163;2293;6;91;111;20;0,560975609756098;0,682926829268293
"2294";93;163;2294;6;91;115;24;0,560975609756098;0,707317073170732
"2295";93;163;2295;6;91;119;28;0,560975609756098;0,731707317073171
"2296";93;163;2296;6;91;123;32;0,560975609756098;0,75609756097561
"2297";93;163;2297;6;95;111;16;0,585365853658537;0,682926829268293
"2298";93;163;2298;6;95;115;20;0,585365853658537;0,707317073170732
"2299";93;163;2299;6;95;119;24;0,585365853658537;0,731707317073171
"2300";93;163;2300;6;95;123;28;0,585365853658537;0,75609756097561
"2301";93;163;2301;6;95;127;32;0,585365853658537;0,780487804878049
"2302";93;163;2302;6;99;115;16;0,609756097560976;0,707317073170732
"2303";93;163;2303;6;99;119;20;0,609756097560976;0,731707317073171
"2304";93;163;2304;6;99;123;24;0,609756097560976;0,75609756097561
"2305";93;163;2305;6;99;127;28;0,609756097560976;0,780487804878049
"2306";93;163;2306;6;107;119;12;0,658536585365854;0,731707317073171
"2307";93;163;2307;6;107;123;16;0,658536585365854;0,75609756097561
"2308";93;163;2308;6;107;127;20;0,658536585365854;0,780487804878049
"2309";93;163;2309;6;111;127;16;0,682926829268293;0,780487804878049
"2310";93;163;2310;6;131;147;16;0,804878048780488;0,902439024390244
"2311";93;163;2311;6;131;151;20;0,804878048780488;0,926829268292683
"2312";93;163;2312;6;131;155;24;0,804878048780488;0,951219512195122
"2313";93;163;2313;6;131;159;28;0,804878048780488;0,975609756097561
"2314";93;163;2314;6;135;151;16;0,829268292682927;0,926829268292683
"2315";93;163;2315;6;135;155;20;0,829268292682927;0,951219512195122
"2316";93;163;2316;6;135;159;24;0,829268292682927;0,975609756097561
"2317";93;163;2317;6;139;159;20;0,853658536585366;0,975609756097561
"2318";93;163;2318;6;143;159;16;0,878048780487805;0,975609756097561
"2319";93;163;2319;6;147;163;16;0,902439024390244;1
"2320";93;163;2320;6;71;83;12;0,439024390243902;0,51219512195122
"2321";93;163;2321;6;79;99;20;0,48780487804878;0,609756097560976
"2322";93;163;2322;6;79;103;24;0,48780487804878;0,634146341463415
"2323";93;163;2323;6;103;119;16;0,634146341463415;0,731707317073171
"2324";93;163;2324;6;103;123;20;0,634146341463415;0,75609756097561
"2325";93;163;2325;6;143;163;20;0,878048780487805;1
"2326";93;163;2326;6;31;43;12;0,195121951219512;0,268292682926829
"2327";93;163;2327;6;135;163;28;0,829268292682927;1
"2328";93;163;2328;6;139;163;24;0,853658536585366;1
"2329";93;163;2329;6;59;71;12;0,365853658536585;0,439024390243902
"2330";93;163;2330;6;131;163;32;0,804878048780488;1
"2331";93;163;2331;6;123;135;12;0,75609756097561;0,829268292682927
"2332";93;163;2332;6;127;147;20;0,780487804878049;0,902439024390244
"2333";93;163;2333;6;127;151;24;0,780487804878049;0,926829268292683
"2334";93;163;2334;6;127;155;28;0,780487804878049;0,951219512195122
"2335";93;163;2335;6;75;87;12;0,463414634146341;0,536585365853659
"2336";93;163;2336;6;87;115;28;0,536585365853659;0,707317073170732
"2337";93;163;2337;6;103;127;24;0,634146341463415;0,780487804878049
"2338";93;163;2338;6;119;131;12;0,731707317073171;0,804878048780488
"2339";93;163;2339;6;75;91;16;0,463414634146341;0,560975609756098
"2340";93;163;2340;6;83;107;24;0,51219512195122;0,658536585365854
"2341";93;163;2341;6;83;111;28;0,51219512195122;0,682926829268293
"2342";93;163;2342;6;83;115;32;0,51219512195122;0,707317073170732
"2343";93;163;2343;6;127;159;32;0,780487804878049;0,975609756097561
"2344";93;163;2344;6;127;163;36;0,780487804878049;1
"2345";93;163;2345;6;123;139;16;0,75609756097561;0,853658536585366
"2346";93;163;2346;6;123;143;20;0,75609756097561;0,878048780487805
"2347";93;163;2347;6;123;147;24;0,75609756097561;0,902439024390244
"2348";93;163;2348;6;123;151;28;0,75609756097561;0,926829268292683
"2349";93;163;2349;6;23;35;12;0,146341463414634;0,219512195121951
"2350";93;163;2350;6;43;55;12;0,268292682926829;0,341463414634146
"2351";625;162;2351;4;113;162;49;0,7;1
"2352";625;162;2352;4;97;146;49;0,6;0,9
"2353";625;162;2353;4;97;162;65;0,6;1
"2354";625;162;2354;5;105;129;24;0,65;0,8
"2355";625;162;2355;5;97;121;24;0,6;0,75
"2356";625;162;2356;5;105;138;33;0,65;0,85
"2357";625;162;2357;5;129;154;25;0,8;0,95
"2358";625;162;2358;5;138;162;24;0,85;1
"2359";625;162;2359;5;89;113;24;0,55;0,7
"2360";625;162;2360;5;113;138;25;0,7;0,85
"2361";625;162;2361;5;113;146;33;0,7;0,9
"2362";625;162;2362;5;121;146;25;0,75;0,9
"2363";625;162;2363;5;121;154;33;0,75;0,95
"2364";625;162;2364;5;121;162;41;0,75;1
"2365";625;162;2365;5;97;129;32;0,6;0,8
"2366";625;162;2366;5;48;72;24;0,3;0,45
"2367";625;162;2367;5;129;162;33;0,8;1
"2368";625;162;2368;5;97;138;41;0,6;0,85
"2369";625;162;2369;5;105;146;41;0,65;0,9
"2370";625;162;2370;6;113;125;12;0,7;0,775
"2371";625;162;2371;6;121;133;12;0,75;0,825
"2372";625;162;2372;6;138;150;12;0,85;0,925
"2373";625;162;2373;6;138;154;16;0,85;0,95
"2374";625;162;2374;6;146;158;12;0,9;0,975
"2375";625;162;2375;6;113;129;16;0,7;0,8
"2376";625;162;2376;6;113;133;20;0,7;0,825
"2377";625;162;2377;6;113;138;25;0,7;0,85
"2378";625;162;2378;6;117;129;12;0,725;0,8
"2379";625;162;2379;6;117;133;16;0,725;0,825
"2380";625;162;2380;6;121;138;17;0,75;0,85
"2381";625;162;2381;6;121;142;21;0,75;0,875
"2382";625;162;2382;6;125;138;13;0,775;0,85
"2383";625;162;2383;6;142;154;12;0,875;0,95
"2384";625;162;2384;6;133;146;13;0,825;0,9
"2385";625;162;2385;6;133;150;17;0,825;0,925
"2386";625;162;2386;6;150;162;12;0,925;1
"2387";625;162;2387;6;101;113;12;0,625;0,7
"2388";625;162;2388;6;101;117;16;0,625;0,725
"2389";625;162;2389;6;105;117;12;0,65;0,725
"2390";625;162;2390;6;129;142;13;0,8;0,875
"2391";625;162;2391;6;129;146;17;0,8;0,9
"2392";625;162;2392;6;142;158;16;0,875;0,975
"2393";625;162;2393;6;146;162;16;0,9;1
"2394";625;162;2394;6;60;72;12;0,375;0,45
"2395";625;162;2395;6;125;142;17;0,775;0,875
"2396";625;162;2396;6;138;158;20;0,85;0,975
"2397";625;162;2397;6;138;162;24;0,85;1
"2398";625;162;2398;6;142;162;20;0,875;1
"2399";625;162;2399;6;101;121;20;0,625;0,75
"2400";625;162;2400;6;109;121;12;0,675;0,75
"2401";625;162;2401;6;32;44;12;0,2;0,275
"2402";625;162;2402;6;105;121;16;0,65;0,75
"2403";625;162;2403;6;56;68;12;0,35;0,425
"2404";625;162;2404;6;56;72;16;0,35;0,45
"2405";625;162;2405;6;117;138;21;0,725;0,85
"2406";625;162;2406;6;52;64;12;0,325;0,4
"2407";625;162;2407;6;101;125;24;0,625;0,775
"2408";625;162;2408;6;133;154;21;0,825;0,95
"2409";625;162;2409;6;133;158;25;0,825;0,975
"2410";625;162;2410;6;101;129;28;0,625;0,8
"2411";625;162;2411;6;11;23;12;0,075;0,15
"2412";625;162;2412;6;40;52;12;0,25;0,325
"2413";625;162;2413;6;125;146;21;0,775;0,9
"2414";625;162;2414;6;105;125;20;0,65;0,775
"2415";625;162;2415;6;109;125;16;0,675;0,775
"2416";625;162;2416;6;48;60;12;0,3;0,375
"2417";625;162;2417;6;125;150;25;0,775;0,925
"2418";625;162;2418;6;125;154;29;0,775;0,95
"2419";625;162;2419;6;105;129;24;0,65;0,8
"2420";625;162;2420;6;109;129;20;0,675;0,8
"2421";625;162;2421;6;101;133;32;0,625;0,825
"2422";625;162;2422;6;3;15;12;0,025;0,1
"2423";625;162;2423;6;105;133;28;0,65;0,825
"2424";625;162;2424;6;133;162;29;0,825;1
"2425";625;162;2425;6;52;68;16;0,325;0,425
"2426";625;162;2426;6;44;56;12;0,275;0,35
"2427";625;162;2427;6;109;133;24;0,675;0,825
"2428";625;162;2428;6;129;150;21;0,8;0,925
"2429";625;162;2429;6;129;154;25;0,8;0,95
"2430";625;162;2430;6;129;158;29;0,8;0,975
"2431";51;124;2431;3;53;106;53;0,428571428571429;0,857142857142857
"2432";51;124;2432;3;70;124;54;0,571428571428571;1
"2433";51;124;2433;4;91;116;25;0,733333333333333;0,933333333333333
"2434";51;124;2434;4;91;124;33;0,733333333333333;1
"2435";51;124;2435;4;74;99;25;0,6;0,8
"2436";51;124;2436;4;66;91;25;0,533333333333333;0,733333333333333
"2437";51;124;2437;4;82;107;25;0,666666666666667;0,866666666666667
"2438";51;124;2438;4;82;116;34;0,666666666666667;0,933333333333333
"2439";51;124;2439;4;74;107;33;0,6;0,866666666666667
"2440";51;124;2440;4;74;116;42;0,6;0,933333333333333
"2441";51;124;2441;4;66;99;33;0,533333333333333;0,8
"2442";51;124;2442;4;57;82;25;0,466666666666667;0,666666666666667
"2443";51;124;2443;4;99;124;25;0,8;1
"2444";51;124;2444;5;104;116;12;0,838709677419355;0,935483870967742
"2445";51;124;2445;5;104;120;16;0,838709677419355;0,967741935483871
"2446";51;124;2446;5;43;55;12;0,354838709677419;0,451612903225806
"2447";51;124;2447;5;84;96;12;0,67741935483871;0,774193548387097
"2448";51;124;2448;5;72;84;12;0,580645161290323;0,67741935483871
"2449";51;124;2449;5;88;100;12;0,709677419354839;0,806451612903226
"2450";51;124;2450;5;88;104;16;0,709677419354839;0,838709677419355
"2451";51;124;2451;5;112;124;12;0,903225806451613;1
"2452";51;124;2452;5;64;76;12;0,516129032258065;0,612903225806452
"2453";51;124;2453;5;68;80;12;0,548387096774194;0,645161290322581
"2454";51;124;2454;5;88;108;20;0,709677419354839;0,870967741935484
"2455";51;124;2455;5;88;112;24;0,709677419354839;0,903225806451613
"2456";51;124;2456;5;96;108;12;0,774193548387097;0,870967741935484
"2457";51;124;2457;5;100;112;12;0,806451612903226;0,903225806451613
"2458";51;124;2458;5;39;51;12;0,32258064516129;0,419354838709677
"2459";51;124;2459;5;39;55;16;0,32258064516129;0,451612903225806
"2460";51;124;2460;5;96;112;16;0,774193548387097;0,903225806451613
"2461";51;124;2461;5;72;88;16;0,580645161290323;0,709677419354839
"2462";51;124;2462;5;96;116;20;0,774193548387097;0,935483870967742
"2463";51;124;2463;5;35;47;12;0,290322580645161;0,387096774193548
"2464";51;124;2464;5;76;88;12;0,612903225806452;0,709677419354839
"2465";51;124;2465;5;68;84;16;0,548387096774194;0,67741935483871
"2466";51;124;2466;5;108;120;12;0,870967741935484;0,967741935483871
"2467";51;124;2467;5;92;104;12;0,741935483870968;0,838709677419355
"2468";51;124;2468;6;41;47;6;0,338709677419355;0,387096774193548
"2469";51;124;2469;6;45;51;6;0,370967741935484;0,419354838709677
"2470";51;124;2470;6;108;114;6;0,870967741935484;0,919354838709677
"2471";51;124;2471;6;43;49;6;0,354838709677419;0,403225806451613
"2472";51;124;2472;6;68;74;6;0,548387096774194;0,596774193548387
"2473";51;124;2473;6;76;82;6;0,612903225806452;0,661290322580645
"2474";51;124;2474;6;76;84;8;0,612903225806452;0,67741935483871
"2475";51;124;2475;6;78;84;6;0,629032258064516;0,67741935483871
"2476";51;124;2476;6;102;108;6;0,82258064516129;0,870967741935484
"2477";51;124;2477;6;104;110;6;0,838709677419355;0,887096774193548
"2478";51;124;2478;6;104;112;8;0,838709677419355;0,903225806451613
"2479";51;124;2479;6;114;120;6;0,919354838709677;0,967741935483871
"2480";51;124;2480;6;116;122;6;0,935483870967742;0,983870967741935
"2481";51;124;2481;6;116;124;8;0,935483870967742;1
"2482";51;124;2482;6;118;124;6;0,951612903225806;1
"2483";51;124;2483;6;37;43;6;0,306451612903226;0,354838709677419
"2484";51;124;2484;6;43;51;8;0,354838709677419;0,419354838709677
"2485";51;124;2485;6;47;53;6;0,387096774193548;0,435483870967742
"2486";51;124;2486;6;74;80;6;0,596774193548387;0,645161290322581
"2487";51;124;2487;6;74;82;8;0,596774193548387;0,661290322580645
"2488";51;124;2488;6;74;84;10;0,596774193548387;0,67741935483871
"2489";51;124;2489;6;88;94;6;0,709677419354839;0,758064516129032
"2490";51;124;2490;6;88;96;8;0,709677419354839;0,774193548387097
"2491";51;124;2491;6;90;96;6;0,725806451612903;0,774193548387097
"2492";51;124;2492;6;100;106;6;0,806451612903226;0,854838709677419
"2493";51;124;2493;6;37;45;8;0,306451612903226;0,370967741935484
"2494";51;124;2494;6;100;108;8;0,806451612903226;0,870967741935484
"2495";51;124;2495;6;104;114;10;0,838709677419355;0,919354838709677
"2496";51;124;2496;6;106;112;6;0,854838709677419;0,903225806451613
"2497";51;124;2497;6;114;122;8;0,919354838709677;0,983870967741935
"2498";51;124;2498;6;114;124;10;0,919354838709677;1
"2499";51;124;2499;6;3;9;6;0,032258064516129;0,0806451612903226
"2500";51;124;2500;6;35;41;6;0,290322580645161;0,338709677419355
"2501";51;124;2501;6;39;45;6;0,32258064516129;0,370967741935484
"2502";51;124;2502;6;106;114;8;0,854838709677419;0,919354838709677
"2503";51;124;2503;6;78;86;8;0,629032258064516;0,693548387096774
"2504";51;124;2504;6;35;43;8;0,290322580645161;0,354838709677419
"2505";51;124;2505;6;35;45;10;0,290322580645161;0,370967741935484
"2506";51;124;2506;6;74;86;12;0,596774193548387;0,693548387096774
"2507";51;124;2507;6;74;88;14;0,596774193548387;0,709677419354839
"2508";51;124;2508;6;102;110;8;0,82258064516129;0,887096774193548
"2509";51;124;2509;6;102;112;10;0,82258064516129;0,903225806451613
"2510";51;124;2510;6;102;114;12;0,82258064516129;0,919354838709677
"2511";51;124;2511;6;1;7;6;0,0161290322580645;0,0645161290322581
"2512";51;124;2512;6;43;53;10;0,354838709677419;0,435483870967742
"2513";51;124;2513;6;45;53;8;0,370967741935484;0,435483870967742
"2514";51;124;2514;6;100;110;10;0,806451612903226;0,887096774193548
"2515";51;124;2515;6;68;76;8;0,548387096774194;0,612903225806452
"2516";51;124;2516;6;68;78;10;0,548387096774194;0,629032258064516
"2517";51;124;2517;6;70;76;6;0,564516129032258;0,612903225806452
"2518";51;124;2518;6;37;47;10;0,306451612903226;0,387096774193548
"2519";51;124;2519;6;37;49;12;0,306451612903226;0,403225806451613
"2520";51;124;2520;6;37;51;14;0,306451612903226;0,419354838709677
"2521";51;124;2521;6;104;116;12;0,838709677419355;0,935483870967742
"2522";51;124;2522;6;110;116;6;0,887096774193548;0,935483870967742
"2523";51;124;2523;6;98;104;6;0,790322580645161;0,838709677419355
"2524";51;124;2524;6;64;70;6;0,516129032258065;0,564516129032258
"2525";51;124;2525;6;64;72;8;0,516129032258065;0,580645161290323
"2526";51;124;2526;6;72;78;6;0,580645161290323;0,629032258064516
"2527";51;124;2527;6;106;116;10;0,854838709677419;0,935483870967742
"2528";51;124;2528;6;11;17;6;0,0967741935483871;0,145161290322581
"2529";51;124;2529;6;98;106;8;0,790322580645161;0,854838709677419
"2530";51;124;2530;6;98;108;10;0,790322580645161;0,870967741935484
"2531";51;124;2531;6;70;78;8;0,564516129032258;0,629032258064516
"2532";51;124;2532;6;70;80;10;0,564516129032258;0,645161290322581
"2533";51;124;2533;6;76;86;10;0,612903225806452;0,693548387096774
"2534";51;124;2534;6;76;88;12;0,612903225806452;0,709677419354839
"2535";51;124;2535;6;41;49;8;0,338709677419355;0,403225806451613
"2536";51;124;2536;6;96;102;6;0,774193548387097;0,82258064516129
"2537";51;124;2537;6;100;112;12;0,806451612903226;0,903225806451613
"2538";51;124;2538;6;100;114;14;0,806451612903226;0,919354838709677
"2539";51;124;2539;6;108;116;8;0,870967741935484;0,935483870967742
"2540";51;124;2540;6;86;92;6;0,693548387096774;0,741935483870968
"2541";51;124;2541;6;80;86;6;0,645161290322581;0,693548387096774
"2542";51;124;2542;6;98;110;12;0,790322580645161;0,887096774193548
"2543";51;124;2543;6;90;98;8;0,725806451612903;0,790322580645161
"2544";51;124;2544;6;88;98;10;0,709677419354839;0,790322580645161
"2545";51;124;2545;6;13;19;6;0,112903225806452;0,161290322580645
"2546";51;124;2546;6;110;118;8;0,887096774193548;0,951612903225806
"2547";232;124;2547;4;91;116;25;0,733333333333333;0,933333333333333
"2548";232;124;2548;4;49;74;25;0,4;0,6
"2549";232;124;2549;4;57;82;25;0,466666666666667;0,666666666666667
"2550";232;124;2550;4;41;66;25;0,333333333333333;0,533333333333333
"2551";232;124;2551;4;32;57;25;0,266666666666667;0,466666666666667
"2552";232;124;2552;4;24;49;25;0,2;0,4
"2553";232;124;2553;4;82;107;25;0,666666666666667;0,866666666666667
"2554";232;124;2554;4;66;91;25;0,533333333333333;0,733333333333333
"2555";232;124;2555;5;47;59;12;0,387096774193548;0,483870967741935
"2556";232;124;2556;5;47;64;17;0,387096774193548;0,516129032258065
"2557";232;124;2557;5;51;64;13;0,419354838709677;0,516129032258065
"2558";232;124;2558;5;55;68;13;0,451612903225806;0,548387096774194
"2559";232;124;2559;5;43;55;12;0,354838709677419;0,451612903225806
"2560";232;124;2560;5;43;59;16;0,354838709677419;0,483870967741935
"2561";232;124;2561;5;43;64;21;0,354838709677419;0,516129032258065
"2562";232;124;2562;5;43;68;25;0,354838709677419;0,548387096774194
"2563";232;124;2563;5;43;72;29;0,354838709677419;0,580645161290323
"2564";232;124;2564;5;51;68;17;0,419354838709677;0,548387096774194
"2565";232;124;2565;5;51;72;21;0,419354838709677;0,580645161290323
"2566";232;124;2566;5;55;72;17;0,451612903225806;0,580645161290323
"2567";232;124;2567;5;59;72;13;0,483870967741935;0,580645161290323
"2568";232;124;2568;5;72;84;12;0,580645161290323;0,67741935483871
"2569";232;124;2569;5;112;124;12;0,903225806451613;1
"2570";232;124;2570;5;47;68;21;0,387096774193548;0,548387096774194
"2571";232;124;2571;5;47;72;25;0,387096774193548;0,580645161290323
"2572";232;124;2572;5;35;47;12;0,290322580645161;0,387096774193548
"2573";232;124;2573;5;96;108;12;0,774193548387097;0,870967741935484
"2574";232;124;2574;5;76;88;12;0,612903225806452;0,709677419354839
"2575";232;124;2575;5;88;100;12;0,709677419354839;0,806451612903226
"2576";232;124;2576;5;39;51;12;0,32258064516129;0,419354838709677
"2577";232;124;2577;5;39;55;16;0,32258064516129;0,451612903225806
"2578";232;124;2578;5;108;120;12;0,870967741935484;0,967741935483871
"2579";232;124;2579;5;92;104;12;0,741935483870968;0,838709677419355
"2580";232;124;2580;6;49;55;6;0,403225806451613;0,451612903225806
"2581";232;124;2581;6;49;57;8;0,403225806451613;0,467741935483871
"2582";232;124;2582;6;49;59;10;0,403225806451613;0,483870967741935
"2583";232;124;2583;6;49;62;13;0,403225806451613;0,5
"2584";232;124;2584;6;49;64;15;0,403225806451613;0,516129032258065
"2585";232;124;2585;6;51;57;6;0,419354838709677;0,467741935483871
"2586";232;124;2586;6;51;59;8;0,419354838709677;0,483870967741935
"2587";232;124;2587;6;53;59;6;0,435483870967742;0,483870967741935
"2588";232;124;2588;6;53;62;9;0,435483870967742;0,5
"2589";232;124;2589;6;55;62;7;0,451612903225806;0,5
"2590";232;124;2590;6;55;64;9;0,451612903225806;0,516129032258065
"2591";232;124;2591;6;57;64;7;0,467741935483871;0,516129032258065
"2592";232;124;2592;6;57;66;9;0,467741935483871;0,532258064516129
"2593";232;124;2593;6;59;66;7;0,483870967741935;0,532258064516129
"2594";232;124;2594;6;59;68;9;0,483870967741935;0,548387096774194
"2595";232;124;2595;6;59;70;11;0,483870967741935;0,564516129032258
"2596";232;124;2596;6;62;68;6;0,5;0,548387096774194
"2597";232;124;2597;6;62;70;8;0,5;0,564516129032258
"2598";232;124;2598;6;68;74;6;0,548387096774194;0,596774193548387
"2599";232;124;2599;6;102;108;6;0,82258064516129;0,870967741935484
"2600";232;124;2600;6;114;120;6;0,919354838709677;0,967741935483871
"2601";232;124;2601;6;114;122;8;0,919354838709677;0,983870967741935
"2602";232;124;2602;6;114;124;10;0,919354838709677;1
"2603";232;124;2603;6;116;122;6;0,935483870967742;0,983870967741935
"2604";232;124;2604;6;116;124;8;0,935483870967742;1
"2605";232;124;2605;6;118;124;6;0,951612903225806;1
"2606";232;124;2606;6;51;62;11;0,419354838709677;0,5
"2607";232;124;2607;6;51;64;13;0,419354838709677;0,516129032258065
"2608";232;124;2608;6;51;66;15;0,419354838709677;0,532258064516129
"2609";232;124;2609;6;51;68;17;0,419354838709677;0,548387096774194
"2610";232;124;2610;6;51;70;19;0,419354838709677;0,564516129032258
"2611";232;124;2611;6;51;72;21;0,419354838709677;0,580645161290323
"2612";232;124;2612;6;53;64;11;0,435483870967742;0,516129032258065
"2613";232;124;2613;6;53;66;13;0,435483870967742;0,532258064516129
"2614";232;124;2614;6;53;68;15;0,435483870967742;0,548387096774194
"2615";232;124;2615;6;55;66;11;0,451612903225806;0,532258064516129
"2616";232;124;2616;6;55;68;13;0,451612903225806;0,548387096774194
"2617";232;124;2617;6;55;70;15;0,451612903225806;0,564516129032258
"2618";232;124;2618;6;55;72;17;0,451612903225806;0,580645161290323
"2619";232;124;2619;6;57;68;11;0,467741935483871;0,548387096774194
"2620";232;124;2620;6;57;70;13;0,467741935483871;0,564516129032258
"2621";232;124;2621;6;59;72;13;0,483870967741935;0,580645161290323
"2622";232;124;2622;6;66;72;6;0,532258064516129;0,580645161290323
"2623";232;124;2623;6;64;70;6;0,516129032258065;0,564516129032258
"2624";232;124;2624;6;66;74;8;0,532258064516129;0,596774193548387
"2625";232;124;2625;6;76;82;6;0,612903225806452;0,661290322580645
"2626";232;124;2626;6;53;70;17;0,435483870967742;0,564516129032258
"2627";232;124;2627;6;55;74;19;0,451612903225806;0,596774193548387
"2628";232;124;2628;6;57;72;15;0,467741935483871;0,580645161290323
"2629";232;124;2629;6;57;74;17;0,467741935483871;0,596774193548387
"2630";232;124;2630;6;59;74;15;0,483870967741935;0,596774193548387
"2631";232;124;2631;6;62;72;10;0,5;0,580645161290323
"2632";232;124;2632;6;62;74;12;0,5;0,596774193548387
"2633";232;124;2633;6;64;72;8;0,516129032258065;0,580645161290323
"2634";232;124;2634;6;64;74;10;0,516129032258065;0,596774193548387
"2635";232;124;2635;6;104;110;6;0,838709677419355;0,887096774193548
"2636";232;124;2636;6;94;100;6;0,758064516129032;0,806451612903226
"2637";232;124;2637;6;35;41;6;0,290322580645161;0,338709677419355
"2638";232;124;2638;6;80;86;6;0,645161290322581;0,693548387096774
"2639";232;124;2639;6;80;88;8;0,645161290322581;0,709677419354839
"2640";232;124;2640;6;82;88;6;0,661290322580645;0,709677419354839
"2641";232;124;2641;6;90;96;6;0,725806451612903;0,774193548387097
"2642";232;124;2642;6;78;84;6;0,629032258064516;0,67741935483871
"2643";232;124;2643;6;49;66;17;0,403225806451613;0,532258064516129
"2644";232;124;2644;6;49;68;19;0,403225806451613;0,548387096774194
"2645";232;124;2645;6;49;70;21;0,403225806451613;0,564516129032258
"2646";232;124;2646;6;102;110;8;0,82258064516129;0,887096774193548
"2647";232;124;2647;6;108;114;6;0,870967741935484;0,919354838709677
"2648";232;124;2648;6;51;74;23;0,419354838709677;0,596774193548387
"2649";232;124;2649;6;53;72;19;0,435483870967742;0,580645161290323
"2650";232;124;2650;6;92;98;6;0,741935483870968;0,790322580645161
"2651";232;124;2651;6;88;94;6;0,709677419354839;0,758064516129032
"2652";232;124;2652;6;41;47;6;0,338709677419355;0,387096774193548
"2653";232;124;2653;6;47;53;6;0,387096774193548;0,435483870967742
"2654";232;124;2654;6;45;51;6;0,370967741935484;0,419354838709677
"2655";232;124;2655;6;110;116;6;0,887096774193548;0,935483870967742
"2656";232;124;2656;6;100;106;6;0,806451612903226;0,854838709677419
"2657";232;124;2657;6;100;108;8;0,806451612903226;0,870967741935484
"2658";232;124;2658;6;33;39;6;0,274193548387097;0,32258064516129
"2659";232;124;2659;6;21;27;6;0,17741935483871;0,225806451612903
"2660";232;124;2660;6;53;74;21;0,435483870967742;0,596774193548387
"2661";232;124;2661;6;39;45;6;0,32258064516129;0,370967741935484
"2662";232;124;2662;6;49;72;23;0,403225806451613;0,580645161290323
"2663";232;124;2663;6;49;74;25;0,403225806451613;0,596774193548387
"2664";232;124;2664;6;92;100;8;0,741935483870968;0,806451612903226
"2665";232;124;2665;6;7;13;6;0,0645161290322581;0,112903225806452
"2666";232;124;2666;6;45;53;8;0,370967741935484;0,435483870967742
"2667";232;124;2667;6;112;118;6;0,903225806451613;0,951612903225806
"2668";232;124;2668;6;5;11;6;0,0483870967741935;0,0967741935483871
"2669";232;124;2669;6;37;43;6;0,306451612903226;0,354838709677419
"2670";232;124;2670;6;47;55;8;0,387096774193548;0,451612903225806
"2671";5580;144;2671;5;120;144;24;0,833333333333333;1
"2672";5580;144;2672;5;112;136;24;0,777777777777778;0,944444444444444
"2673";5580;144;2673;5;47;72;25;0,333333333333333;0,5
"2674";5580;144;2674;5;72;96;24;0,5;0,666666666666667
"2675";5580;144;2675;5;104;128;24;0,722222222222222;0,888888888888889
"2676";5580;144;2676;5;63;88;25;0,444444444444444;0,611111111111111
"2677";5580;144;2677;6;128;140;12;0,888888888888889;0,972222222222222
"2678";5580;144;2678;6;108;120;12;0,75;0,833333333333333
"2679";5580;144;2679;6;112;124;12;0,777777777777778;0,861111111111111
"2680";5580;144;2680;6;124;136;12;0,861111111111111;0,944444444444444
"2681";5580;144;2681;6;72;84;12;0,5;0,583333333333333
"2682";5580;144;2682;6;84;96;12;0,583333333333333;0,666666666666667
"2683";5580;144;2683;6;96;108;12;0,666666666666667;0,75
"2684";5580;144;2684;6;76;88;12;0,527777777777778;0,611111111111111
"2685";5580;144;2685;6;59;72;13;0,416666666666667;0,5
"2686";5580;144;2686;6;120;132;12;0,833333333333333;0,916666666666667
"2687";5580;144;2687;6;104;116;12;0,722222222222222;0,805555555555556
"2688";5580;144;2688;6;132;144;12;0,916666666666667;1
"2689";5580;144;2689;6;100;112;12;0,694444444444444;0,777777777777778
"2690";5580;144;2690;6;43;55;12;0,305555555555556;0,388888888888889
"2691";5580;144;2691;6;88;100;12;0,611111111111111;0,694444444444444
"2692";5580;144;2692;6;80;92;12;0,555555555555556;0,638888888888889
"2693";5580;144;2693;6;116;128;12;0,805555555555556;0,888888888888889
"2694";3927;113;2694;3;48;97;49;0,428571428571429;0,857142857142857
"2695";3927;113;2695;3;64;113;49;0,571428571428571;1
"2696";3927;113;2696;3;32;80;48;0,285714285714286;0,714285714285714
"2697";3927;113;2697;4;40;64;24;0,357142857142857;0,571428571428571
"2698";3927;113;2698;4;72;97;25;0,642857142857143;0,857142857142857
"2699";3927;113;2699;4;40;72;32;0,357142857142857;0,642857142857143
"2700";3927;113;2700;4;48;72;24;0,428571428571429;0,642857142857143
"2701";3927;113;2701;4;32;56;24;0,285714285714286;0,5
"2702";3927;113;2702;4;32;64;32;0,285714285714286;0,571428571428571
"2703";3927;113;2703;4;32;72;40;0,285714285714286;0,642857142857143
"2704";3927;113;2704;4;48;80;32;0,428571428571429;0,714285714285714
"2705";3927;113;2705;4;64;89;25;0,571428571428571;0,785714285714286
"2706";3927;113;2706;4;23;48;25;0,214285714285714;0,428571428571429
"2707";3927;113;2707;4;23;56;33;0,214285714285714;0,5
"2708";3927;113;2708;5;28;40;12;0,25;0,357142857142857
"2709";3927;113;2709;5;44;56;12;0,392857142857143;0,5
"2710";3927;113;2710;5;72;84;12;0,642857142857143;0,75
"2711";3927;113;2711;5;44;60;16;0,392857142857143;0,535714285714286
"2712";3927;113;2712;5;44;64;20;0,392857142857143;0,571428571428571
"2713";3927;113;2713;5;52;64;12;0,464285714285714;0,571428571428571
"2714";3927;113;2714;5;56;68;12;0,5;0,607142857142857
"2715";3927;113;2715;5;76;89;13;0,678571428571429;0,785714285714286
"2716";3927;113;2716;5;84;97;13;0,75;0,857142857142857
"2717";3927;113;2717;5;40;52;12;0,357142857142857;0,464285714285714
"2718";3927;113;2718;5;52;68;16;0,464285714285714;0,607142857142857
"2719";3927;113;2719;5;72;89;17;0,642857142857143;0,785714285714286
"2720";3927;113;2720;5;72;93;21;0,642857142857143;0,821428571428571
"2721";3927;113;2721;5;72;97;25;0,642857142857143;0,857142857142857
"2722";3927;113;2722;5;76;93;17;0,678571428571429;0,821428571428571
"2723";3927;113;2723;5;76;97;21;0,678571428571429;0,857142857142857
"2724";3927;113;2724;5;80;93;13;0,714285714285714;0,821428571428571
"2725";3927;113;2725;5;80;97;17;0,714285714285714;0,857142857142857
"2726";3927;113;2726;5;89;101;12;0,785714285714286;0,892857142857143
"2727";3927;113;2727;5;101;113;12;0,892857142857143;1
"2728";3927;113;2728;5;36;48;12;0,321428571428571;0,428571428571429
"2729";3927;113;2729;5;23;36;13;0,214285714285714;0,321428571428571
"2730";3927;113;2730;5;28;44;16;0,25;0,392857142857143
"2731";3927;113;2731;5;32;44;12;0,285714285714286;0,392857142857143
"2732";3927;113;2732;5;40;56;16;0,357142857142857;0,5
"2733";3927;113;2733;5;44;68;24;0,392857142857143;0,607142857142857
"2734";3927;113;2734;5;68;80;12;0,607142857142857;0,714285714285714
"2735";3927;113;2735;5;68;84;16;0,607142857142857;0,75
"2736";3927;113;2736;5;68;89;21;0,607142857142857;0,785714285714286
"2737";3927;113;2737;5;68;93;25;0,607142857142857;0,821428571428571
"2738";3927;113;2738;5;68;97;29;0,607142857142857;0,857142857142857
"2739";3927;113;2739;5;40;60;20;0,357142857142857;0,535714285714286
"2740";3927;113;2740;5;40;64;24;0,357142857142857;0,571428571428571
"2741";3927;113;2741;5;40;68;28;0,357142857142857;0,607142857142857
"2742";3927;113;2742;5;36;52;16;0,321428571428571;0,464285714285714
"2743";3927;113;2743;5;23;40;17;0,214285714285714;0,357142857142857
"2744";3927;113;2744;5;60;72;12;0,535714285714286;0,642857142857143
"2745";3927;113;2745;5;36;56;20;0,321428571428571;0,5
"2746";3927;113;2746;5;36;60;24;0,321428571428571;0,535714285714286
"2747";3927;113;2747;6;29;35;6;0,263157894736842;0,315789473684211
"2748";3927;113;2748;6;43;49;6;0,385964912280702;0,43859649122807
"2749";3927;113;2749;6;61;67;6;0,543859649122807;0,596491228070175
"2750";3927;113;2750;6;71;77;6;0,631578947368421;0,684210526315789
"2751";3927;113;2751;6;73;79;6;0,649122807017544;0,701754385964912
"2752";3927;113;2752;6;73;81;8;0,649122807017544;0,719298245614035
"2753";3927;113;2753;6;79;85;6;0,701754385964912;0,754385964912281
"2754";3927;113;2754;6;29;37;8;0,263157894736842;0,333333333333333
"2755";3927;113;2755;6;29;39;10;0,263157894736842;0,350877192982456
"2756";3927;113;2756;6;31;37;6;0,280701754385965;0,333333333333333
"2757";3927;113;2757;6;33;39;6;0,298245614035088;0,350877192982456
"2758";3927;113;2758;6;35;41;6;0,315789473684211;0,368421052631579
"2759";3927;113;2759;6;43;51;8;0,385964912280702;0,456140350877193
"2760";3927;113;2760;6;43;53;10;0,385964912280702;0,473684210526316
"2761";3927;113;2761;6;43;55;12;0,385964912280702;0,491228070175439
"2762";3927;113;2762;6;45;51;6;0,403508771929825;0,456140350877193
"2763";3927;113;2763;6;45;53;8;0,403508771929825;0,473684210526316
"2764";3927;113;2764;6;53;59;6;0,473684210526316;0,526315789473684
"2765";3927;113;2765;6;53;61;8;0,473684210526316;0,543859649122807
"2766";3927;113;2766;6;55;61;6;0,491228070175439;0,543859649122807
"2767";3927;113;2767;6;55;63;8;0,491228070175439;0,56140350877193
"2768";3927;113;2768;6;57;63;6;0,508771929824561;0,56140350877193
"2769";3927;113;2769;6;57;65;8;0,508771929824561;0,578947368421053
"2770";3927;113;2770;6;57;67;10;0,508771929824561;0,596491228070175
"2771";3927;113;2771;6;63;69;6;0,56140350877193;0,614035087719298
"2772";3927;113;2772;6;71;79;8;0,631578947368421;0,701754385964912
"2773";3927;113;2773;6;71;81;10;0,631578947368421;0,719298245614035
"2774";3927;113;2774;6;79;87;8;0,701754385964912;0,771929824561403
"2775";3927;113;2775;6;81;87;6;0,719298245614035;0,771929824561403
"2776";3927;113;2776;6;81;89;8;0,719298245614035;0,789473684210526
"2777";3927;113;2777;6;81;91;10;0,719298245614035;0,807017543859649
"2778";3927;113;2778;6;81;93;12;0,719298245614035;0,824561403508772
"2779";3927;113;2779;6;83;89;6;0,736842105263158;0,789473684210526
"2780";3927;113;2780;6;83;91;8;0,736842105263158;0,807017543859649
"2781";3927;113;2781;6;85;91;6;0,754385964912281;0,807017543859649
"2782";3927;113;2782;6;85;93;8;0,754385964912281;0,824561403508772
"2783";3927;113;2783;6;89;95;6;0,789473684210526;0,842105263157895
"2784";3927;113;2784;6;89;97;8;0,789473684210526;0,859649122807018
"2785";3927;113;2785;6;91;97;6;0,807017543859649;0,859649122807018
"2786";3927;113;2786;6;91;99;8;0,807017543859649;0,87719298245614
"2787";3927;113;2787;6;101;107;6;0,894736842105263;0,947368421052632
"2788";3927;113;2788;6;29;41;12;0,263157894736842;0,368421052631579
"2789";3927;113;2789;6;31;39;8;0,280701754385965;0,350877192982456
"2790";3927;113;2790;6;31;41;10;0,280701754385965;0,368421052631579
"2791";3927;113;2791;6;33;41;8;0,298245614035088;0,368421052631579
"2792";3927;113;2792;6;33;43;10;0,298245614035088;0,385964912280702
"2793";3927;113;2793;6;37;43;6;0,333333333333333;0,385964912280702
"2794";3927;113;2794;6;39;45;6;0,350877192982456;0,403508771929825
"2795";3927;113;2795;6;45;55;10;0,403508771929825;0,491228070175439
"2796";3927;113;2796;6;53;63;10;0,473684210526316;0,56140350877193
"2797";3927;113;2797;6;53;65;12;0,473684210526316;0,578947368421053
"2798";3927;113;2798;6;53;67;14;0,473684210526316;0,596491228070175
"2799";3927;113;2799;6;53;69;16;0,473684210526316;0,614035087719298
"2800";3927;113;2800;6;55;65;10;0,491228070175439;0,578947368421053
"2801";3927;113;2801;6;55;67;12;0,491228070175439;0,596491228070175
"2802";3927;113;2802;6;55;69;14;0,491228070175439;0,614035087719298
"2803";3927;113;2803;6;61;69;8;0,543859649122807;0,614035087719298
"2804";3927;113;2804;6;73;83;10;0,649122807017544;0,736842105263158
"2805";3927;113;2805;6;73;85;12;0,649122807017544;0,754385964912281
"2806";3927;113;2806;6;73;87;14;0,649122807017544;0,771929824561403
"2807";3927;113;2807;6;73;89;16;0,649122807017544;0,789473684210526
"2808";3927;113;2808;6;73;91;18;0,649122807017544;0,807017543859649
"2809";3927;113;2809;6;73;93;20;0,649122807017544;0,824561403508772
"2810";3927;113;2810;6;79;89;10;0,701754385964912;0,789473684210526
"2811";3927;113;2811;6;79;91;12;0,701754385964912;0,807017543859649
"2812";3927;113;2812;6;85;95;10;0,754385964912281;0,842105263157895
"2813";3927;113;2813;6;89;99;10;0,789473684210526;0,87719298245614
"2814";3927;113;2814;6;23;29;6;0,210526315789474;0,263157894736842
"2815";3927;113;2815;6;35;43;8;0,315789473684211;0,385964912280702
"2816";3927;113;2816;6;39;47;8;0,350877192982456;0,421052631578947
"2817";3927;113;2817;6;39;49;10;0,350877192982456;0,43859649122807
"2818";3927;113;2818;6;41;47;6;0,368421052631579;0,421052631578947
"2819";3927;113;2819;6;41;49;8;0,368421052631579;0,43859649122807
"2820";3927;113;2820;6;71;83;12;0,631578947368421;0,736842105263158
"2821";3927;113;2821;6;83;93;10;0,736842105263158;0,824561403508772
"2822";3927;113;2822;6;43;57;14;0,385964912280702;0,508771929824561
"2823";3927;113;2823;6;43;59;16;0,385964912280702;0,526315789473684
"2824";3927;113;2824;6;59;65;6;0,526315789473684;0,578947368421053
"2825";3927;113;2825;6;59;67;8;0,526315789473684;0,596491228070175
"2826";3927;113;2826;6;43;61;18;0,385964912280702;0,543859649122807
"2827";3927;113;2827;6;71;85;14;0,631578947368421;0,754385964912281
"2828";3927;113;2828;6;71;87;16;0,631578947368421;0,771929824561403
"2829";3927;113;2829;6;83;95;12;0,736842105263158;0,842105263157895
"2830";3927;113;2830;6;83;97;14;0,736842105263158;0,859649122807018
"2831";3927;113;2831;6;83;99;16;0,736842105263158;0,87719298245614
"2832";3927;113;2832;6;101;109;8;0,894736842105263;0,964912280701754
"2833";3927;113;2833;6;21;27;6;0,192982456140351;0,245614035087719
"2834";3927;113;2834;6;43;63;20;0,385964912280702;0,56140350877193
"2835";3927;113;2835;6;43;65;22;0,385964912280702;0,578947368421053
"2836";3927;113;2836;6;45;57;12;0,403508771929825;0,508771929824561
"2837";3927;113;2837;6;45;59;14;0,403508771929825;0,526315789473684
"2838";3927;113;2838;6;45;61;16;0,403508771929825;0,543859649122807
"2839";3927;113;2839;6;45;63;18;0,403508771929825;0,56140350877193
"2840";3927;113;2840;6;45;65;20;0,403508771929825;0,578947368421053
"2841";3927;113;2841;6;71;89;18;0,631578947368421;0,789473684210526
"2842";3927;113;2842;6;71;91;20;0,631578947368421;0,807017543859649
"2843";3927;113;2843;6;71;93;22;0,631578947368421;0,824561403508772
"2844";3927;113;2844;6;85;97;12;0,754385964912281;0,859649122807018
"2845";3927;113;2845;6;85;99;14;0,754385964912281;0,87719298245614
"2846";3927;113;2846;6;99;105;6;0,87719298245614;0,929824561403509
"2847";3927;113;2847;6;101;111;10;0,894736842105263;0,982456140350877
"2848";3927;113;2848;6;101;113;12;0,894736842105263;1
"2849";3927;113;2849;6;15;21;6;0,140350877192982;0,192982456140351
"2850";3927;113;2850;6;41;51;10;0,368421052631579;0,456140350877193
"2851";3927;113;2851;6;99;107;8;0,87719298245614;0,947368421052632
"2852";3927;113;2852;6;99;109;10;0,87719298245614;0,964912280701754
"2853";3927;113;2853;6;99;111;12;0,87719298245614;0,982456140350877
"2854";3927;113;2854;6;25;31;6;0,228070175438596;0,280701754385965
"2855";3927;113;2855;6;27;33;6;0,245614035087719;0,298245614035088
"2856";3927;113;2856;6;39;51;12;0,350877192982456;0,456140350877193
"2857";3927;113;2857;6;43;67;24;0,385964912280702;0,596491228070175
"2858";3927;113;2858;6;79;93;14;0,701754385964912;0,824561403508772
"2859";3927;113;2859;6;81;95;14;0,719298245614035;0,842105263157895
"2860";3927;113;2860;6;71;95;24;0,631578947368421;0,842105263157895
"2861";3927;113;2861;6;71;97;26;0,631578947368421;0,859649122807018
"2862";3927;113;2862;6;71;99;28;0,631578947368421;0,87719298245614
"2863";3927;113;2863;6;1;7;6;0,0175438596491228;0,0701754385964912
"2864";3927;113;2864;6;79;95;16;0,701754385964912;0,842105263157895
"2865";3927;113;2865;6;79;97;18;0,701754385964912;0,859649122807018
"2866";3927;113;2866;6;73;95;22;0,649122807017544;0,842105263157895
"2867";3927;113;2867;6;73;97;24;0,649122807017544;0,859649122807018
"2868";3927;113;2868;6;73;99;26;0,649122807017544;0,87719298245614
"2869";3927;113;2869;6;79;99;20;0,701754385964912;0,87719298245614
"2870";3927;113;2870;6;81;97;16;0,719298245614035;0,859649122807018
"2871";3927;113;2871;6;81;99;18;0,719298245614035;0,87719298245614
"2872";3927;113;2872;6;39;53;14;0,350877192982456;0,473684210526316
"2873";3927;113;2873;6;39;55;16;0,350877192982456;0,491228070175439
"2874";3927;113;2874;6;27;35;8;0,245614035087719;0,315789473684211
"2875";3927;113;2875;6;27;37;10;0,245614035087719;0,333333333333333
"2876";3927;113;2876;6;41;53;12;0,368421052631579;0,473684210526316
"2877";3927;113;2877;6;29;43;14;0,263157894736842;0,385964912280702
"2878";3927;113;2878;6;23;31;8;0,210526315789474;0,280701754385965
"2879";3927;113;2879;6;41;55;14;0,368421052631579;0,491228070175439
"2880";3927;113;2880;6;41;57;16;0,368421052631579;0,508771929824561
"2881";3927;113;2881;6;41;59;18;0,368421052631579;0,526315789473684
"2882";3927;113;2882;6;99;113;14;0,87719298245614;1
"2883";767;255;2883;3;63;255;192;0,25;1
"2884";767;255;2884;4;95;191;96;0,375;0,75
"2885";767;255;2885;4;127;223;96;0,5;0,875
"2886";767;255;2886;4;159;255;96;0,625;1
"2887";767;255;2887;5;143;191;48;0,5625;0,75
"2888";767;255;2888;5;175;223;48;0,6875;0,875
"2889";767;255;2889;5;175;239;64;0,6875;0,9375
"2890";767;255;2890;5;191;239;48;0,75;0,9375
"2891";767;255;2891;5;95;143;48;0,375;0,5625
"2892";767;255;2892;5;159;207;48;0,625;0,8125
"2893";767;255;2893;5;127;175;48;0,5;0,6875
"2894";767;255;2894;5;127;191;64;0,5;0,75
"2895";767;255;2895;5;79;127;48;0,3125;0,5
"2896";767;255;2896;5;111;159;48;0,4375;0,625
"2897";767;255;2897;5;31;79;48;0,125;0,3125
"2898";767;255;2898;5;159;223;64;0,625;0,875
"2899";767;255;2899;5;143;207;64;0,5625;0,8125
"2900";767;255;2900;5;47;95;48;0,1875;0,375
"2901";767;255;2901;5;191;255;64;0,75;1
"2902";767;255;2902;6;119;143;24;0,46875;0,5625
"2903";767;255;2903;6;151;175;24;0,59375;0,6875
"2904";767;255;2904;6;159;183;24;0,625;0,71875
"2905";767;255;2905;6;159;191;32;0,625;0,75
"2906";767;255;2906;6;175;199;24;0,6875;0,78125
"2907";767;255;2907;6;175;207;32;0,6875;0,8125
"2908";767;255;2908;6;215;239;24;0,84375;0,9375
"2909";767;255;2909;6;215;247;32;0,84375;0,96875
"2910";767;255;2910;6;127;151;24;0,5;0,59375
"2911";767;255;2911;6;135;159;24;0,53125;0,625
"2912";767;255;2912;6;135;167;32;0,53125;0,65625
"2913";767;255;2913;6;151;183;32;0,59375;0,71875
"2914";767;255;2914;6;151;191;40;0,59375;0,75
"2915";767;255;2915;6;167;191;24;0,65625;0,75
"2916";767;255;2916;6;167;199;32;0,65625;0,78125
"2917";767;255;2917;6;167;207;40;0,65625;0,8125
"2918";767;255;2918;6;183;207;24;0,71875;0,8125
"2919";767;255;2919;6;215;255;40;0,84375;1
"2920";767;255;2920;6;231;255;24;0,90625;1
"2921";767;255;2921;6;143;167;24;0,5625;0,65625
"2922";767;255;2922;6;103;127;24;0,40625;0,5
"2923";767;255;2923;6;63;87;24;0,25;0,34375
"2924";767;255;2924;6;143;175;32;0,5625;0,6875
"2925";767;255;2925;6;223;247;24;0,875;0,96875
"2926";767;255;2926;6;79;103;24;0,3125;0,40625
"2927";767;255;2927;6;191;215;24;0,75;0,84375
"2928";767;255;2928;6;111;135;24;0,4375;0,53125
"2929";767;255;2929;6;199;223;24;0,78125;0,875
"2930";767;255;2930;6;207;231;24;0,8125;0,90625
"2931";767;255;2931;6;223;255;32;0,875;1
"2932";767;255;2932;6;47;71;24;0,1875;0,28125
"2933";767;255;2933;6;95;119;24;0,375;0,46875
"2934";767;255;2934;6;31;55;24;0,125;0,21875
"2935";767;255;2935;6;7;31;24;0,03125;0,125
"2936";767;255;2936;6;55;79;24;0,21875;0,3125
"2937";767;255;2937;6;39;63;24;0,15625;0,25
"2938";767;255;2938;6;127;159;32;0,5;0,625
"2939";767;255;2939;6;119;151;32;0,46875;0,59375
"2940";767;255;2940;6;199;231;32;0,78125;0,90625
"2941";767;255;2941;6;87;111;24;0,34375;0,4375
"2942";767;255;2942;6;159;199;40;0,625;0,78125
"2943";767;255;2943;6;191;223;32;0,75;0,875
"2944";767;255;2944;7;35;47;12;0,140625;0,1875
"2945";767;255;2945;7;123;135;12;0,484375;0,53125
"2946";767;255;2946;7;31;43;12;0,125;0,171875
"2947";767;255;2947;7;99;111;12;0,390625;0,4375
"2948";767;255;2948;7;147;159;12;0,578125;0,625
"2949";767;255;2949;7;151;163;12;0,59375;0,640625
"2950";767;255;2950;7;151;167;16;0,59375;0,65625
"2951";767;255;2951;7;151;171;20;0,59375;0,671875
"2952";767;255;2952;7;187;199;12;0,734375;0,78125
"2953";767;255;2953;7;235;247;12;0,921875;0,96875
"2954";767;255;2954;7;235;251;16;0,921875;0,984375
"2955";767;255;2955;7;239;251;12;0,9375;0,984375
"2956";767;255;2956;7;115;127;12;0,453125;0,5
"2957";767;255;2957;7;115;131;16;0,453125;0,515625
"2958";767;255;2958;7;127;139;12;0,5;0,546875
"2959";767;255;2959;7;135;147;12;0,53125;0,578125
"2960";767;255;2960;7;139;151;12;0,546875;0,59375
"2961";767;255;2961;7;143;155;12;0,5625;0,609375
"2962";767;255;2962;7;143;159;16;0,5625;0,625
"2963";767;255;2963;7;163;175;12;0,640625;0,6875
"2964";767;255;2964;7;167;179;12;0,65625;0,703125
"2965";767;255;2965;7;167;183;16;0,65625;0,71875
"2966";767;255;2966;7;167;187;20;0,65625;0,734375
"2967";767;255;2967;7;171;183;12;0,671875;0,71875
"2968";767;255;2968;7;187;203;16;0,734375;0,796875
"2969";767;255;2969;7;191;203;12;0,75;0,796875
"2970";767;255;2970;7;215;227;12;0,84375;0,890625
"2971";767;255;2971;7;215;231;16;0,84375;0,90625
"2972";767;255;2972;7;215;235;20;0,84375;0,921875
"2973";767;255;2973;7;227;239;12;0,890625;0,9375
"2974";767;255;2974;7;227;243;16;0,890625;0,953125
"2975";767;255;2975;7;231;243;12;0,90625;0,953125
"2976";767;255;2976;7;231;247;16;0,90625;0,96875
"2977";767;255;2977;7;231;251;20;0,90625;0,984375
"2978";767;255;2978;7;15;27;12;0,0625;0,109375
"2979";767;255;2979;7;43;55;12;0,171875;0,21875
"2980";767;255;2980;7;55;67;12;0,21875;0,265625
"2981";767;255;2981;7;67;79;12;0,265625;0,3125
"2982";767;255;2982;7;67;83;16;0,265625;0,328125
"2983";767;255;2983;7;83;95;12;0,328125;0,375
"2984";767;255;2984;7;119;131;12;0,46875;0,515625
"2985";767;255;2985;7;119;135;16;0,46875;0,53125
"2986";767;255;2986;7;123;139;16;0,484375;0,546875
"2987";767;255;2987;7;147;163;16;0,578125;0,640625
"2988";767;255;2988;7;147;167;20;0,578125;0,65625
"2989";767;255;2989;7;155;167;12;0,609375;0,65625
"2990";767;255;2990;7;155;171;16;0,609375;0,671875
"2991";767;255;2991;7;155;175;20;0,609375;0,6875
"2992";767;255;2992;7;155;179;24;0,609375;0,703125
"2993";767;255;2993;7;159;171;12;0,625;0,671875
"2994";767;255;2994;7;159;175;16;0,625;0,6875
"2995";767;255;2995;7;163;179;16;0,640625;0,703125
"2996";767;255;2996;7;163;183;20;0,640625;0,71875
"2997";767;255;2997;7;171;187;16;0,671875;0,734375
"2998";767;255;2998;7;175;187;12;0,6875;0,734375
"2999";767;255;2999;7;175;191;16;0,6875;0,75
"3000";767;255;3000;7;175;195;20;0,6875;0,765625
"3001";767;255;3001;7;179;191;12;0,703125;0,75
"3002";767;255;3002;7;179;195;16;0,703125;0,765625
"3003";767;255;3003;7;179;199;20;0,703125;0,78125
"3004";767;255;3004;7;187;207;20;0,734375;0,8125
"3005";767;255;3005;7;191;207;16;0,75;0,8125
"3006";767;255;3006;7;195;207;12;0,765625;0,8125
"3007";767;255;3007;7;219;231;12;0,859375;0,90625
"3008";767;255;3008;7;219;235;16;0,859375;0,921875
"3009";767;255;3009;7;223;235;12;0,875;0,921875
"3010";767;255;3010;7;59;71;12;0,234375;0,28125
"3011";767;255;3011;7;103;115;12;0,40625;0,453125
"3012";767;255;3012;7;163;187;24;0,640625;0,734375
"3013";767;255;3013;7;223;239;16;0,875;0,9375
"3014";767;255;3014;7;223;243;20;0,875;0,953125
"3015";767;255;3015;7;223;247;24;0,875;0,96875
"3016";767;255;3016;7;223;251;28;0,875;0,984375
"3017";767;255;3017;7;227;247;20;0,890625;0,96875
"3018";767;255;3018;7;227;251;24;0,890625;0,984375
"3019";767;255;3019;7;227;255;28;0,890625;1
"3020";767;255;3020;7;239;255;16;0,9375;1
"3021";767;255;3021;7;127;143;16;0,5;0,5625
"3022";767;255;3022;7;183;195;12;0,71875;0,765625
"3023";767;255;3023;7;183;199;16;0,71875;0,78125
"3024";767;255;3024;7;235;255;20;0,921875;1
"3025";767;255;3025;7;39;51;12;0,15625;0,203125
"3026";767;255;3026;7;107;119;12;0,421875;0,46875
"3027";767;255;3027;7;175;199;24;0,6875;0,78125
"3028";767;255;3028;7;63;75;12;0,25;0,296875
"3029";767;255;3029;7;207;219;12;0,8125;0,859375
"3030";767;255;3030;7;139;155;16;0,546875;0,609375
"3031";767;255;3031;7;167;191;24;0,65625;0,75
"3032";767;255;3032;7;219;239;20;0,859375;0,9375
"3033";767;255;3033;7;219;243;24;0,859375;0,953125
"3034";767;255;3034;7;219;247;28;0,859375;0,96875
"3035";767;255;3035;7;231;255;24;0,90625;1
"3036";767;255;3036;7;71;83;12;0,28125;0,328125
"3037";767;255;3037;7;131;143;12;0,515625;0,5625
"3038";767;255;3038;7;207;223;16;0,8125;0,875
"3039";767;255;3039;7;207;227;20;0,8125;0,890625
"3040";767;255;3040;7;87;99;12;0,34375;0,390625
"3041";767;255;3041;7;215;239;24;0,84375;0,9375
"3042";767;255;3042;7;215;243;28;0,84375;0,953125
"3043";767;255;3043;7;95;107;12;0,375;0,421875
"3044";767;255;3044;7;135;151;16;0,53125;0,59375
"3045";767;255;3045;7;135;155;20;0,53125;0,609375
"3046";767;255;3046;7;107;123;16;0,421875;0,484375
"3047";767;255;3047;7;115;135;20;0,453125;0,53125
"3048";767;255;3048;7;131;147;16;0,515625;0,578125
"3049";767;255;3049;7;215;247;32;0,84375;0,96875
"3050";767;255;3050;7;243;255;12;0,953125;1
"3051";767;255;3051;7;99;115;16;0,390625;0,453125
"3052";767;255;3052;7;103;119;16;0,40625;0,46875
"3053";767;255;3053;7;51;63;12;0,203125;0,25
"3054";767;255;3054;7;91;103;12;0,359375;0,40625
"3055";767;255;3055;7;11;23;12;0,046875;0,09375
"3056";767;255;3056;7;211;223;12;0,828125;0,875
"3057";767;255;3057;7;211;227;16;0,828125;0,890625
"3058";767;255;3058;7;211;231;20;0,828125;0,90625
"3059";767;255;3059;7;203;215;12;0,796875;0,84375
"3060";767;255;3060;7;203;219;16;0,796875;0,859375
"3061";767;255;3061;7;63;79;16;0,25;0,3125
"3062";767;255;3062;7;171;191;20;0,671875;0,75
"3063";767;255;3063;7;171;195;24;0,671875;0,765625
"3064";767;255;3064;7;63;83;20;0,25;0,328125
"3065";767;255;3065;7;199;211;12;0,78125;0,828125
"3066";767;255;3066;7;199;215;16;0,78125;0,84375
"3067";767;255;3067;7;199;219;20;0,78125;0,859375
"3068";767;255;3068;7;199;223;24;0,78125;0,875
"3069";767;255;3069;7;199;227;28;0,78125;0,890625
"3070";767;255;3070;7;75;87;12;0,296875;0,34375
"3071";767;255;3071;7;47;59;12;0,1875;0,234375
"3072";767;255;3072;7;35;51;16;0,140625;0,203125
"3073";767;255;3073;7;27;39;12;0,109375;0,15625
"3074";767;255;3074;7;223;255;32;0,875;1
"3075";767;255;3075;7;219;251;32;0,859375;0,984375
"3076";767;255;3076;7;215;251;36;0,84375;0,984375
"3077";767;255;3077;7;167;195;28;0,65625;0,765625
"3078";767;255;3078;7;3;15;12;0,015625;0,0625
"3079";767;255;3079;7;39;55;16;0,15625;0,21875
"3080";767;255;3080;7;59;75;16;0,234375;0,296875
"3081";1895;72;3081;4;40;64;24;0,555555555555556;0,888888888888889
"3082";1895;72;3082;4;40;72;32;0,555555555555556;1
"3083";1895;72;3083;4;48;72;24;0,666666666666667;1
"3084";1895;72;3084;5;36;48;12;0,5;0,666666666666667
"3085";1895;72;3085;5;36;52;16;0,5;0,722222222222222
"3086";1895;72;3086;5;40;52;12;0,555555555555556;0,722222222222222
"3087";1895;72;3087;5;52;64;12;0,722222222222222;0,888888888888889
"3088";1895;72;3088;5;44;56;12;0,611111111111111;0,777777777777778
"3089";1895;72;3089;5;52;68;16;0,722222222222222;0,944444444444444
"3090";1895;72;3090;5;52;72;20;0,722222222222222;1
"3091";1895;72;3091;5;56;68;12;0,777777777777778;0,944444444444444
"3092";1895;72;3092;5;56;72;16;0,777777777777778;1
"3093";1895;72;3093;5;60;72;12;0,833333333333333;1
"3094";1895;72;3094;5;40;56;16;0,555555555555556;0,777777777777778
"3095";1895;72;3095;5;44;60;16;0,611111111111111;0,833333333333333
"3096";1895;72;3096;5;44;64;20;0,611111111111111;0,888888888888889
"3097";1895;72;3097;5;44;68;24;0,611111111111111;0,944444444444444
"3098";1895;72;3098;5;44;72;28;0,611111111111111;1
"3099";1895;72;3099;5;15;27;12;0,222222222222222;0,388888888888889
"3100";1895;72;3100;5;36;56;20;0,5;0,777777777777778
"3101";1895;72;3101;5;40;60;20;0,555555555555556;0,833333333333333
"3102";1895;72;3102;5;40;64;24;0,555555555555556;0,888888888888889
"3103";1895;72;3103;5;48;60;12;0,666666666666667;0,833333333333333
"3104";1895;72;3104;5;48;64;16;0,666666666666667;0,888888888888889
"3105";1895;72;3105;5;11;23;12;0,166666666666667;0,333333333333333
"3106";1895;72;3106;5;36;60;24;0,5;0,833333333333333
"3107";1895;72;3107;5;48;68;20;0,666666666666667;0,944444444444444
"3108";1895;72;3108;5;48;72;24;0,666666666666667;1
"3109";1895;72;3109;5;7;19;12;0,111111111111111;0,277777777777778
"3110";1895;72;3110;5;31;44;13;0,444444444444444;0,611111111111111
"3111";1895;72;3111;5;40;68;28;0,555555555555556;0,944444444444444
"3112";1895;72;3112;5;40;72;32;0,555555555555556;1
"3113";1895;72;3113;6;19;25;6;0,277777777777778;0,361111111111111
"3114";1895;72;3114;6;21;27;6;0,305555555555556;0,388888888888889
"3115";1895;72;3115;6;21;29;8;0,305555555555556;0,416666666666667
"3116";1895;72;3116;6;23;29;6;0,333333333333333;0,416666666666667
"3117";1895;72;3117;6;31;38;7;0,444444444444444;0,527777777777778
"3118";1895;72;3118;6;36;42;6;0,5;0,583333333333333
"3119";1895;72;3119;6;38;44;6;0,527777777777778;0,611111111111111
"3120";1895;72;3120;6;40;46;6;0,555555555555556;0,638888888888889
"3121";1895;72;3121;6;42;48;6;0,583333333333333;0,666666666666667
"3122";1895;72;3122;6;58;64;6;0,805555555555556;0,888888888888889
"3123";1895;72;3123;6;9;15;6;0,138888888888889;0,222222222222222
"3124";1895;72;3124;6;38;46;8;0,527777777777778;0,638888888888889
"3125";1895;72;3125;6;38;48;10;0,527777777777778;0,666666666666667
"3126";1895;72;3126;6;40;48;8;0,555555555555556;0,666666666666667
"3127";1895;72;3127;6;40;50;10;0,555555555555556;0,694444444444444
"3128";1895;72;3128;6;42;50;8;0,583333333333333;0,694444444444444
"3129";1895;72;3129;6;44;50;6;0,611111111111111;0,694444444444444
"3130";1895;72;3130;6;44;52;8;0,611111111111111;0,722222222222222
"3131";1895;72;3131;6;50;56;6;0,694444444444444;0,777777777777778
"3132";1895;72;3132;6;50;58;8;0,694444444444444;0,805555555555556
"3133";1895;72;3133;6;52;58;6;0,722222222222222;0,805555555555556
"3134";1895;72;3134;6;52;60;8;0,722222222222222;0,833333333333333
"3135";1895;72;3135;6;52;62;10;0,722222222222222;0,861111111111111
"3136";1895;72;3136;6;54;60;6;0,75;0,833333333333333
"3137";1895;72;3137;6;58;66;8;0,805555555555556;0,916666666666667
"3138";1895;72;3138;6;60;66;6;0,833333333333333;0,916666666666667
"3139";1895;72;3139;6;60;68;8;0,833333333333333;0,944444444444444
"3140";1895;72;3140;6;60;70;10;0,833333333333333;0,972222222222222
"3141";1895;72;3141;6;62;68;6;0,861111111111111;0,944444444444444
"3142";1895;72;3142;6;62;70;8;0,861111111111111;0,972222222222222
"3143";1895;72;3143;6;62;72;10;0,861111111111111;1
"3144";1895;72;3144;6;17;23;6;0,25;0,333333333333333
"3145";1895;72;3145;6;17;25;8;0,25;0,361111111111111
"3146";1895;72;3146;6;17;27;10;0,25;0,388888888888889
"3147";1895;72;3147;6;19;27;8;0,277777777777778;0,388888888888889
"3148";1895;72;3148;6;19;29;10;0,277777777777778;0,416666666666667
"3149";1895;72;3149;6;36;44;8;0,5;0,611111111111111
"3150";1895;72;3150;6;38;50;12;0,527777777777778;0,694444444444444
"3151";1895;72;3151;6;38;52;14;0,527777777777778;0,722222222222222
"3152";1895;72;3152;6;40;52;12;0,555555555555556;0,722222222222222
"3153";1895;72;3153;6;46;52;6;0,638888888888889;0,722222222222222
"3154";1895;72;3154;6;48;54;6;0,666666666666667;0,75
"3155";1895;72;3155;6;48;56;8;0,666666666666667;0,777777777777778
"3156";1895;72;3156;6;48;58;10;0,666666666666667;0,805555555555556
"3157";1895;72;3157;6;48;60;12;0,666666666666667;0,833333333333333
"3158";1895;72;3158;6;48;62;14;0,666666666666667;0,861111111111111
"3159";1895;72;3159;6;48;64;16;0,666666666666667;0,888888888888889
"3160";1895;72;3160;6;52;64;12;0,722222222222222;0,888888888888889
"3161";1895;72;3161;6;54;62;8;0,75;0,861111111111111
"3162";1895;72;3162;6;54;64;10;0,75;0,888888888888889
"3163";1895;72;3163;6;58;68;10;0,805555555555556;0,944444444444444
"3164";1895;72;3164;6;58;70;12;0,805555555555556;0,972222222222222
"3165";1895;72;3165;6;50;60;10;0,694444444444444;0,833333333333333
"3166";1895;72;3166;6;7;13;6;0,111111111111111;0,194444444444444
"3167";1895;72;3167;6;11;17;6;0,166666666666667;0,25
"3168";1895;72;3168;6;31;40;9;0,444444444444444;0,555555555555556
"3169";1895;72;3169;6;36;46;10;0,5;0,638888888888889
"3170";1895;72;3170;6;36;48;12;0,5;0,666666666666667
"3171";1895;72;3171;6;36;50;14;0,5;0,694444444444444
"3172";1895;72;3172;6;42;52;10;0,583333333333333;0,722222222222222
"3173";1895;72;3173;6;60;72;12;0,833333333333333;1
"3174";1895;72;3174;6;11;19;8;0,166666666666667;0,277777777777778
"3175";1895;72;3175;6;33;40;7;0,472222222222222;0,555555555555556
"3176";1895;72;3176;6;33;42;9;0,472222222222222;0,583333333333333
"3177";1895;72;3177;6;52;66;14;0,722222222222222;0,916666666666667
"3178";1895;72;3178;6;52;68;16;0,722222222222222;0,944444444444444
"3179";1895;72;3179;6;52;70;18;0,722222222222222;0,972222222222222
"3180";1895;72;3180;6;56;62;6;0,777777777777778;0,861111111111111
"3181";1895;72;3181;6;56;64;8;0,777777777777778;0,888888888888889
"3182";1895;72;3182;6;58;72;14;0,805555555555556;1
"3183";1895;72;3183;6;15;21;6;0,222222222222222;0,305555555555556
"3184";1895;72;3184;6;9;17;8;0,138888888888889;0,25
"3185";1895;72;3185;6;56;66;10;0,777777777777778;0,916666666666667
"3186";1895;72;3186;6;56;68;12;0,777777777777778;0,944444444444444
"3187";1895;72;3187;6;54;66;12;0,75;0,916666666666667
"3188";1895;72;3188;6;54;68;14;0,75;0,944444444444444
"3189";1895;72;3189;6;54;70;16;0,75;0,972222222222222
"3190";1895;72;3190;6;54;72;18;0,75;1
"3191";1895;72;3191;6;50;62;12;0,694444444444444;0,861111111111111
"3192";1895;72;3192;6;50;64;14;0,694444444444444;0,888888888888889
"3193";1895;72;3193;6;50;66;16;0,694444444444444;0,916666666666667
"3194";1895;72;3194;6;50;68;18;0,694444444444444;0,944444444444444
"3195";1895;72;3195;6;5;11;6;0,0833333333333333;0,166666666666667
"3196";1895;72;3196;6;56;70;14;0,777777777777778;0,972222222222222
"3197";1895;72;3197;6;7;15;8;0,111111111111111;0,222222222222222
"3198";1895;72;3198;6;13;19;6;0,194444444444444;0,277777777777778
"3199";1895;72;3199;6;36;52;16;0,5;0,722222222222222
"3200";1895;72;3200;6;40;54;14;0,555555555555556;0,75
"3201";1895;72;3201;6;40;56;16;0,555555555555556;0,777777777777778
"3202";1895;72;3202;6;40;58;18;0,555555555555556;0,805555555555556
"3203";1895;72;3203;6;40;60;20;0,555555555555556;0,833333333333333
"3204";1895;72;3204;6;42;54;12;0,583333333333333;0,75
"3205";1895;72;3205;6;42;56;14;0,583333333333333;0,777777777777778
"3206";1895;72;3206;6;42;58;16;0,583333333333333;0,805555555555556
"3207";1895;72;3207;6;44;54;10;0,611111111111111;0,75
"3208";1895;72;3208;6;44;56;12;0,611111111111111;0,777777777777778
"3209";1895;72;3209;6;44;58;14;0,611111111111111;0,805555555555556
"3210";1895;72;3210;6;44;60;16;0,611111111111111;0,833333333333333
"3211";1895;72;3211;6;44;62;18;0,611111111111111;0,861111111111111
"3212";1895;72;3212;6;56;72;16;0,777777777777778;1
"3213";1895;72;3213;6;33;44;11;0,472222222222222;0,611111111111111
"3214";1895;72;3214;6;33;46;13;0,472222222222222;0,638888888888889
"3215";1895;72;3215;6;33;48;15;0,472222222222222;0,666666666666667
"3216";1895;72;3216;6;40;62;22;0,555555555555556;0,861111111111111
"3217";1895;72;3217;6;40;64;24;0,555555555555556;0,888888888888889
"3218";1895;72;3218;6;40;66;26;0,555555555555556;0,916666666666667
"3219";1895;72;3219;6;40;68;28;0,555555555555556;0,944444444444444
"3220";1895;72;3220;6;40;70;30;0,555555555555556;0,972222222222222
"3221";1895;72;3221;6;52;72;20;0,722222222222222;1
"3222";1895;72;3222;6;31;42;11;0,444444444444444;0,583333333333333
"3223";1895;72;3223;6;46;54;8;0,638888888888889;0,75
"3224";1895;72;3224;6;29;36;7;0,416666666666667;0,5
"3225";1895;72;3225;6;33;50;17;0,472222222222222;0,694444444444444
"3226";1895;72;3226;6;31;44;13;0,444444444444444;0,611111111111111
"3227";1895;72;3227;6;31;46;15;0,444444444444444;0,638888888888889
"3228";1895;72;3228;6;50;70;20;0,694444444444444;0,972222222222222
"3229";1895;72;3229;6;50;72;22;0,694444444444444;1
"3230";1895;72;3230;6;38;54;16;0,527777777777778;0,75
"3231";1895;72;3231;6;48;66;18;0,666666666666667;0,916666666666667
"3232";1895;72;3232;6;48;68;20;0,666666666666667;0,944444444444444
"3233";1895;72;3233;6;48;70;22;0,666666666666667;0,972222222222222
"3234";1895;72;3234;6;15;23;8;0,222222222222222;0,333333333333333
"3235";3085;85;3235;3;33;85;52;0,4;1
"3236";3085;85;3236;4;42;68;26;0,5;0,8
"3237";3085;85;3237;4;51;76;25;0,6;0,9
"3238";3085;85;3238;4;51;85;34;0,6;1
"3239";3085;85;3239;4;42;76;34;0,5;0,9
"3240";3085;85;3240;4;42;85;43;0,5;1
"3241";3085;85;3241;4;59;85;26;0,7;1
"3242";3085;85;3242;4;25;51;26;0,3;0,6
"3243";3085;85;3243;4;33;59;26;0,4;0,7
"3244";3085;85;3244;4;33;68;35;0,4;0,8
"3245";3085;85;3245;4;33;76;43;0,4;0,9
"3246";3085;85;3246;5;48;60;12;0,571428571428571;0,714285714285714
"3247";3085;85;3247;5;52;65;13;0,619047619047619;0,761904761904762
"3248";3085;85;3248;5;52;69;17;0,619047619047619;0,80952380952381
"3249";3085;85;3249;5;65;77;12;0,761904761904762;0,904761904761905
"3250";3085;85;3250;5;69;81;12;0,80952380952381;0,952380952380952
"3251";3085;85;3251;5;69;85;16;0,80952380952381;1
"3252";3085;85;3252;5;48;65;17;0,571428571428571;0,761904761904762
"3253";3085;85;3253;5;48;69;21;0,571428571428571;0,80952380952381
"3254";3085;85;3254;5;56;69;13;0,666666666666667;0,80952380952381
"3255";3085;85;3255;5;56;73;17;0,666666666666667;0,857142857142857
"3256";3085;85;3256;5;56;77;21;0,666666666666667;0,904761904761905
"3257";3085;85;3257;5;56;81;25;0,666666666666667;0,952380952380952
"3258";3085;85;3258;5;65;81;16;0,761904761904762;0,952380952380952
"3259";3085;85;3259;5;32;44;12;0,380952380952381;0,523809523809524
"3260";3085;85;3260;5;32;48;16;0,380952380952381;0,571428571428571
"3261";3085;85;3261;5;36;48;12;0,428571428571429;0,571428571428571
"3262";3085;85;3262;5;36;52;16;0,428571428571429;0,619047619047619
"3263";3085;85;3263;5;48;73;25;0,571428571428571;0,857142857142857
"3264";3085;85;3264;5;52;73;21;0,619047619047619;0,857142857142857
"3265";3085;85;3265;5;52;77;25;0,619047619047619;0,904761904761905
"3266";3085;85;3266;5;52;81;29;0,619047619047619;0,952380952380952
"3267";3085;85;3267;5;52;85;33;0,619047619047619;1
"3268";3085;85;3268;5;65;85;20;0,761904761904762;1
"3269";3085;85;3269;5;28;40;12;0,333333333333333;0,476190476190476
"3270";3085;85;3270;5;40;52;12;0,476190476190476;0,619047619047619
"3271";3085;85;3271;5;60;73;13;0,714285714285714;0,857142857142857
"3272";3085;85;3272;5;44;56;12;0,523809523809524;0,666666666666667
"3273";3085;85;3273;5;48;77;29;0,571428571428571;0,904761904761905
"3274";3085;85;3274;5;48;81;33;0,571428571428571;0,952380952380952
"3275";3085;85;3275;5;48;85;37;0,571428571428571;1
"3276";3085;85;3276;5;56;85;29;0,666666666666667;1
"3277";3085;85;3277;5;60;77;17;0,714285714285714;0,904761904761905
"3278";3085;85;3278;5;60;81;21;0,714285714285714;0,952380952380952
"3279";3085;85;3279;5;60;85;25;0,714285714285714;1
"3280";3085;85;3280;5;24;36;12;0,285714285714286;0,428571428571429
"3281";3085;85;3281;5;40;56;16;0,476190476190476;0,666666666666667
"3282";3085;85;3282;5;40;60;20;0,476190476190476;0,714285714285714
"3283";3085;85;3283;5;28;44;16;0,333333333333333;0,523809523809524
"3284";3085;85;3284;5;32;52;20;0,380952380952381;0,619047619047619
"3285";3085;85;3285;5;36;56;20;0,428571428571429;0,666666666666667
"3286";3085;85;3286;5;36;60;24;0,428571428571429;0,714285714285714
"3287";3085;85;3287;5;28;48;20;0,333333333333333;0,571428571428571
"3288";3085;85;3288;5;44;60;16;0,523809523809524;0,714285714285714
"3289";3085;85;3289;5;44;65;21;0,523809523809524;0,761904761904762
"3290";3085;85;3290;5;24;40;16;0,285714285714286;0,476190476190476
"3291";3085;85;3291;5;44;69;25;0,523809523809524;0,80952380952381
"3292";3085;85;3292;5;44;73;29;0,523809523809524;0,857142857142857
"3293";3085;85;3293;6;33;39;6;0,395348837209302;0,465116279069767
"3294";3085;85;3294;6;33;41;8;0,395348837209302;0,488372093023256
"3295";3085;85;3295;6;33;43;10;0,395348837209302;0,511627906976744
"3296";3085;85;3296;6;35;41;6;0,418604651162791;0,488372093023256
"3297";3085;85;3297;6;35;43;8;0,418604651162791;0,511627906976744
"3298";3085;85;3298;6;39;45;6;0,465116279069767;0,534883720930233
"3299";3085;85;3299;6;53;59;6;0,627906976744186;0,697674418604651
"3300";3085;85;3300;6;53;61;8;0,627906976744186;0,720930232558139
"3301";3085;85;3301;6;67;73;6;0,790697674418605;0,86046511627907
"3302";3085;85;3302;6;67;75;8;0,790697674418605;0,883720930232558
"3303";3085;85;3303;6;69;75;6;0,813953488372093;0,883720930232558
"3304";3085;85;3304;6;69;77;8;0,813953488372093;0,906976744186046
"3305";3085;85;3305;6;27;33;6;0,325581395348837;0,395348837209302
"3306";3085;85;3306;6;27;35;8;0,325581395348837;0,418604651162791
"3307";3085;85;3307;6;29;35;6;0,348837209302326;0,418604651162791
"3308";3085;85;3308;6;29;37;8;0,348837209302326;0,441860465116279
"3309";3085;85;3309;6;33;45;12;0,395348837209302;0,534883720930233
"3310";3085;85;3310;6;35;45;10;0,418604651162791;0,534883720930233
"3311";3085;85;3311;6;35;47;12;0,418604651162791;0,558139534883721
"3312";3085;85;3312;6;43;49;6;0,511627906976744;0,581395348837209
"3313";3085;85;3313;6;45;51;6;0,534883720930233;0,604651162790698
"3314";3085;85;3314;6;53;63;10;0,627906976744186;0,744186046511628
"3315";3085;85;3315;6;53;65;12;0,627906976744186;0,767441860465116
"3316";3085;85;3316;6;53;67;14;0,627906976744186;0,790697674418605
"3317";3085;85;3317;6;53;69;16;0,627906976744186;0,813953488372093
"3318";3085;85;3318;6;59;65;6;0,697674418604651;0,767441860465116
"3319";3085;85;3319;6;67;77;10;0,790697674418605;0,906976744186046
"3320";3085;85;3320;6;67;79;12;0,790697674418605;0,930232558139535
"3321";3085;85;3321;6;67;81;14;0,790697674418605;0,953488372093023
"3322";3085;85;3322;6;67;83;16;0,790697674418605;0,976744186046512
"3323";3085;85;3323;6;69;79;10;0,813953488372093;0,930232558139535
"3324";3085;85;3324;6;69;81;12;0,813953488372093;0,953488372093023
"3325";3085;85;3325;6;69;83;14;0,813953488372093;0,976744186046512
"3326";3085;85;3326;6;69;85;16;0,813953488372093;1
"3327";3085;85;3327;6;7;13;6;0,0930232558139535;0,162790697674419
"3328";3085;85;3328;6;37;43;6;0,441860465116279;0,511627906976744
"3329";3085;85;3329;6;53;71;18;0,627906976744186;0,837209302325581
"3330";3085;85;3330;6;51;57;6;0,604651162790698;0,674418604651163
"3331";3085;85;3331;6;47;53;6;0,558139534883721;0,627906976744186
"3332";3085;85;3332;6;37;45;8;0,441860465116279;0,534883720930233
"3333";3085;85;3333;6;39;47;8;0,465116279069767;0,558139534883721
"3334";3085;85;3334;6;41;47;6;0,488372093023256;0,558139534883721
"3335";3085;85;3335;6;41;49;8;0,488372093023256;0,581395348837209
"3336";3085;85;3336;6;51;59;8;0,604651162790698;0,697674418604651
"3337";3085;85;3337;6;51;61;10;0,604651162790698;0,720930232558139
"3338";3085;85;3338;6;51;63;12;0,604651162790698;0,744186046511628
"3339";3085;85;3339;6;65;71;6;0,767441860465116;0,837209302325581
"3340";3085;85;3340;6;65;73;8;0,767441860465116;0,86046511627907
"3341";3085;85;3341;6;43;51;8;0,511627906976744;0,604651162790698
"3342";3085;85;3342;6;47;55;8;0,558139534883721;0,651162790697674
"3343";3085;85;3343;6;59;67;8;0,697674418604651;0,790697674418605
"3344";3085;85;3344;6;59;69;10;0,697674418604651;0,813953488372093
"3345";3085;85;3345;6;59;71;12;0,697674418604651;0,837209302325581
"3346";3085;85;3346;6;59;73;14;0,697674418604651;0,86046511627907
"3347";3085;85;3347;6;59;75;16;0,697674418604651;0,883720930232558
"3348";3085;85;3348;6;65;75;10;0,767441860465116;0,883720930232558
"3349";3085;85;3349;6;65;77;12;0,767441860465116;0,906976744186046
"3350";3085;85;3350;6;67;85;18;0,790697674418605;1
"3351";3085;85;3351;6;5;11;6;0,0697674418604651;0,13953488372093
"3352";3085;85;3352;6;49;55;6;0,581395348837209;0,651162790697674
"3353";3085;85;3353;6;9;15;6;0,116279069767442;0,186046511627907
"3354";3085;85;3354;6;35;49;14;0,418604651162791;0,581395348837209
"3355";3085;85;3355;6;37;47;10;0,441860465116279;0,558139534883721
"3356";3085;85;3356;6;51;65;14;0,604651162790698;0,767441860465116
"3357";3085;85;3357;6;51;67;16;0,604651162790698;0,790697674418605
"3358";3085;85;3358;6;47;57;10;0,558139534883721;0,674418604651163
"3359";3085;85;3359;6;47;59;12;0,558139534883721;0,697674418604651
"3360";3085;85;3360;6;25;31;6;0,302325581395349;0,372093023255814
"3361";3085;85;3361;6;31;37;6;0,372093023255814;0,441860465116279
"3362";3085;85;3362;6;45;53;8;0,534883720930233;0,627906976744186
"3363";3085;85;3363;6;49;57;8;0,581395348837209;0,674418604651163
"3364";3085;85;3364;6;49;59;10;0,581395348837209;0,697674418604651
"3365";3085;85;3365;6;23;29;6;0,27906976744186;0,348837209302326
"3366";3085;85;3366;6;39;49;10;0,465116279069767;0,581395348837209
"3367";3085;85;3367;6;41;51;10;0,488372093023256;0,604651162790698
"3368";3085;85;3368;6;43;53;10;0,511627906976744;0,627906976744186
"3369";3085;85;3369;6;53;73;20;0,627906976744186;0,86046511627907
"3370";3085;85;3370;6;53;75;22;0,627906976744186;0,883720930232558
"3371";3085;85;3371;6;53;77;24;0,627906976744186;0,906976744186046
"3372";3085;85;3372;6;53;79;26;0,627906976744186;0,930232558139535
"3373";3085;85;3373;6;39;51;12;0,465116279069767;0,604651162790698
"3374";3085;85;3374;6;31;39;8;0,372093023255814;0,465116279069767
"3375";3085;85;3375;6;33;47;14;0,395348837209302;0,558139534883721
"3376";3085;85;3376;6;33;49;16;0,395348837209302;0,581395348837209
"3377";3085;85;3377;6;35;51;16;0,418604651162791;0,604651162790698
"3378";3085;85;3378;6;37;49;12;0,441860465116279;0,581395348837209
"3379";3085;85;3379;6;59;77;18;0,697674418604651;0,906976744186046
"3380";3085;85;3380;6;53;81;28;0,627906976744186;0,953488372093023
"3381";3085;85;3381;6;65;79;14;0,767441860465116;0,930232558139535
"3382";3085;85;3382;6;65;81;16;0,767441860465116;0,953488372093023
"3383";3085;85;3383;6;59;79;20;0,697674418604651;0,930232558139535
"3384";3085;85;3384;6;59;81;22;0,697674418604651;0,953488372093023
"3385";3085;85;3385;6;59;83;24;0,697674418604651;0,976744186046512
"3386";3085;85;3386;6;45;55;10;0,534883720930233;0,651162790697674
"3387";3085;85;3387;6;49;61;12;0,581395348837209;0,720930232558139
"3388";3085;85;3388;6;49;63;14;0,581395348837209;0,744186046511628
"3389";3085;85;3389;6;31;41;10;0,372093023255814;0,488372093023256
"3390";3085;85;3390;6;65;83;18;0,767441860465116;0,976744186046512
"3391";3085;85;3391;6;21;27;6;0,255813953488372;0,325581395348837
"3392";3085;85;3392;6;29;39;10;0,348837209302326;0,465116279069767
"3393";3085;85;3393;6;47;61;14;0,558139534883721;0,720930232558139
"3394";3085;85;3394;6;47;63;16;0,558139534883721;0,744186046511628
"3395";3085;85;3395;6;51;69;18;0,604651162790698;0,813953488372093
"3396";3085;85;3396;6;51;71;20;0,604651162790698;0,837209302325581
"3397";3085;85;3397;6;51;73;22;0,604651162790698;0,86046511627907
"3398";3085;85;3398;6;51;75;24;0,604651162790698;0,883720930232558
"3399";3085;85;3399;6;65;85;20;0,767441860465116;1
"3400";3085;85;3400;6;45;57;12;0,534883720930233;0,674418604651163
"3401";3085;85;3401;6;51;77;26;0,604651162790698;0,906976744186046
"3402";3085;85;3402;6;53;83;30;0,627906976744186;0,976744186046512
"3403";3085;85;3403;6;25;33;8;0,302325581395349;0,395348837209302
"3404";3085;85;3404;6;53;85;32;0,627906976744186;1
"3405";3085;85;3405;6;19;25;6;0,232558139534884;0,302325581395349
"3406";3187;165;3406;3;32;132;100;0,2;0,8
"3407";3187;165;3407;4;65;115;50;0,4;0,7
"3408";3187;165;3408;4;82;132;50;0,5;0,8
"3409";3187;165;3409;5;16;40;24;0,1;0,25
"3410";3187;165;3410;5;115;140;25;0,7;0,85
"3411";3187;165;3411;5;65;90;25;0,4;0,55
"3412";3187;165;3412;5;7;32;25;0,05;0,2
"3413";3187;165;3413;6;19;31;12;0,121951219512195;0,195121951219512
"3414";3187;165;3414;6;125;137;12;0,75609756097561;0,829268292682927
"3415";3187;165;3415;6;153;165;12;0,926829268292683;1
"3416";3187;165;3416;6;31;44;13;0,195121951219512;0,268292682926829
"3417";3187;165;3417;6;149;161;12;0,902439024390244;0,975609756097561
"3418";3187;165;3418;6;27;39;12;0,170731707317073;0,24390243902439
"3419";3187;165;3419;6;27;44;17;0,170731707317073;0,268292682926829
"3420";3187;165;3420;6;72;84;12;0,439024390243902;0,51219512195122
"3421";3187;165;3421;6;76;88;12;0,463414634146341;0,536585365853659
"3422";3187;165;3422;6;145;157;12;0,878048780487805;0,951219512195122
"3423";3187;165;3423;6;145;161;16;0,878048780487805;0,975609756097561
"3424";3187;165;3424;6;15;27;12;0,0975609756097561;0,170731707317073
"3425";3187;165;3425;6;120;133;13;0,731707317073171;0,804878048780488
"3426";3187;165;3426;6;64;76;12;0,390243902439024;0,463414634146341
"3427";3187;165;3427;6;92;104;12;0,560975609756098;0,634146341463415
"3428";3187;165;3428;6;149;165;16;0,902439024390244;1
"3429";3187;165;3429;6;64;80;16;0,390243902439024;0,48780487804878
"3430";3187;165;3430;6;72;88;16;0,439024390243902;0,536585365853659
"3431";3187;165;3431;6;112;125;13;0,682926829268293;0,75609756097561
"3432";3187;165;3432;6;116;129;13;0,707317073170732;0,780487804878049
"3433";3187;165;3433;6;68;80;12;0,414634146341463;0,48780487804878
"3434";3187;165;3434;6;145;165;20;0,878048780487805;1
"3435";3187;165;3435;6;80;92;12;0,48780487804878;0,560975609756098
"3436";3187;165;3436;6;56;68;12;0,341463414634146;0,414634146341463
"3437";3187;165;3437;6;88;100;12;0,536585365853659;0,609756097560976
"3438";3187;165;3438;6;68;84;16;0,414634146341463;0,51219512195122
"3439";3187;165;3439;6;7;19;12;0,0487804878048781;0,121951219512195
"3440";3352;84;3440;3;16;67;51;0,2;0,8
"3441";3352;84;3441;3;33;84;51;0,4;1
"3442";3352;84;3442;4;16;42;26;0,2;0,5
"3443";3352;84;3443;4;24;50;26;0,3;0,6
"3444";3352;84;3444;4;42;67;25;0,5;0,8
"3445";3352;84;3445;4;8;33;25;0,1;0,4
"3446";3352;84;3446;4;33;58;25;0,4;0,7
"3447";3352;84;3447;4;24;58;34;0,3;0,7
"3448";3352;84;3448;4;8;42;34;0,1;0,5
"3449";3352;84;3449;5;44;56;12;0,523809523809524;0,666666666666667
"3450";3352;84;3450;5;48;60;12;0,571428571428571;0,714285714285714
"3451";3352;84;3451;5;52;64;12;0,619047619047619;0,761904761904762
"3452";3352;84;3452;5;68;80;12;0,80952380952381;0,952380952380952
"3453";3352;84;3453;5;68;84;16;0,80952380952381;1
"3454";3352;84;3454;5;35;48;13;0,428571428571429;0,571428571428571
"3455";3352;84;3455;5;15;27;12;0,19047619047619;0,333333333333333
"3456";3352;84;3456;5;39;52;13;0,476190476190476;0,619047619047619
"3457";3352;84;3457;5;39;56;17;0,476190476190476;0,666666666666667
"3458";3352;84;3458;5;19;31;12;0,238095238095238;0,380952380952381
"3459";3352;84;3459;5;44;60;16;0,523809523809524;0,714285714285714
"3460";3352;84;3460;5;11;23;12;0,142857142857143;0,285714285714286
"3461";3352;84;3461;5;23;35;12;0,285714285714286;0,428571428571429
"3462";3352;84;3462;5;72;84;12;0,857142857142857;1
"3463";3352;84;3463;5;7;19;12;0,0952380952380952;0,238095238095238
"3464";3352;84;3464;5;19;35;16;0,238095238095238;0,428571428571429
"3465";3352;84;3465;5;48;64;16;0,571428571428571;0,761904761904762
"3466";3352;84;3466;5;15;31;16;0,19047619047619;0,380952380952381
"3467";3352;84;3467;5;11;27;16;0,142857142857143;0,333333333333333
"3468";3352;84;3468;6;19;25;6;0,238095238095238;0,30952380952381
"3469";3352;84;3469;6;21;27;6;0,261904761904762;0,333333333333333
"3470";3352;84;3470;6;29;35;6;0,357142857142857;0,428571428571429
"3471";3352;84;3471;6;37;44;7;0,452380952380952;0,523809523809524
"3472";3352;84;3472;6;37;46;9;0,452380952380952;0,547619047619048
"3473";3352;84;3473;6;39;46;7;0,476190476190476;0,547619047619048
"3474";3352;84;3474;6;78;84;6;0,928571428571429;1
"3475";3352;84;3475;6;11;17;6;0,142857142857143;0,214285714285714
"3476";3352;84;3476;6;13;19;6;0,166666666666667;0,238095238095238
"3477";3352;84;3477;6;39;48;9;0,476190476190476;0,571428571428571
"3478";3352;84;3478;6;42;48;6;0,5;0,571428571428571
"3479";3352;84;3479;6;50;56;6;0,595238095238095;0,666666666666667
"3480";3352;84;3480;6;50;58;8;0,595238095238095;0,69047619047619
"3481";3352;84;3481;6;52;58;6;0,619047619047619;0,69047619047619
"3482";3352;84;3482;6;68;74;6;0,80952380952381;0,880952380952381
"3483";3352;84;3483;6;68;76;8;0,80952380952381;0,904761904761905
"3484";3352;84;3484;6;76;82;6;0,904761904761905;0,976190476190476
"3485";3352;84;3485;6;37;48;11;0,452380952380952;0,571428571428571
"3486";3352;84;3486;6;50;60;10;0,595238095238095;0,714285714285714
"3487";3352;84;3487;6;52;60;8;0,619047619047619;0,714285714285714
"3488";3352;84;3488;6;54;60;6;0,642857142857143;0,714285714285714
"3489";3352;84;3489;6;76;84;8;0,904761904761905;1
"3490";3352;84;3490;6;23;29;6;0,285714285714286;0,357142857142857
"3491";3352;84;3491;6;48;54;6;0,571428571428571;0,642857142857143
"3492";3352;84;3492;6;48;56;8;0,571428571428571;0,666666666666667
"3493";3352;84;3493;6;7;13;6;0,0952380952380952;0,166666666666667
"3494";3352;84;3494;6;9;15;6;0,119047619047619;0,19047619047619
"3495";3352;84;3495;6;56;62;6;0,666666666666667;0,738095238095238
"3496";3352;84;3496;6;58;64;6;0,69047619047619;0,761904761904762
"3497";3352;84;3497;6;17;23;6;0,214285714285714;0,285714285714286
"3498";3352;84;3498;6;17;25;8;0,214285714285714;0,30952380952381
"3499";3352;84;3499;6;17;27;10;0,214285714285714;0,333333333333333
"3500";3352;84;3500;6;21;29;8;0,261904761904762;0,357142857142857
"3501";3352;84;3501;6;25;31;6;0,30952380952381;0,380952380952381
"3502";3352;84;3502;6;27;33;6;0,333333333333333;0,404761904761905
"3503";3352;84;3503;6;42;50;8;0,5;0,595238095238095
"3504";3352;84;3504;6;48;58;10;0,571428571428571;0,69047619047619
"3505";3352;84;3505;6;68;78;10;0,80952380952381;0,928571428571429
"3506";3352;84;3506;6;72;78;6;0,857142857142857;0,928571428571429
"3507";3352;84;3507;6;72;80;8;0,857142857142857;0,952380952380952
"3508";3352;84;3508;6;19;27;8;0,238095238095238;0,333333333333333
"3509";3352;84;3509;6;25;33;8;0,30952380952381;0,404761904761905
"3510";3352;84;3510;6;48;60;12;0,571428571428571;0,714285714285714
"3511";3352;84;3511;6;11;19;8;0,142857142857143;0,238095238095238
"3512";3352;84;3512;6;15;21;6;0,19047619047619;0,261904761904762
"3513";3352;84;3513;6;44;50;6;0,523809523809524;0,595238095238095
"3514";3352;84;3514;6;23;31;8;0,285714285714286;0,380952380952381
"3515";3352;84;3515;6;23;33;10;0,285714285714286;0,404761904761905
"3516";3352;84;3516;6;46;52;6;0,547619047619048;0,619047619047619
"3517";3352;84;3517;6;46;54;8;0,547619047619048;0,642857142857143
"3518";3352;84;3518;6;50;62;12;0,595238095238095;0,738095238095238
"3519";3352;84;3519;6;13;21;8;0,166666666666667;0,261904761904762
"3520";3352;84;3520;6;56;64;8;0,666666666666667;0,761904761904762
"3521";3352;84;3521;6;9;17;8;0,119047619047619;0,214285714285714
"3522";3352;84;3522;6;42;52;10;0,5;0,619047619047619
"3523";3352;84;3523;6;19;29;10;0,238095238095238;0,357142857142857
"3524";3352;84;3524;6;21;31;10;0,261904761904762;0,380952380952381
"3525";3352;84;3525;6;72;82;10;0,857142857142857;0,976190476190476
"3526";3352;84;3526;6;72;84;12;0,857142857142857;1
"3527";3366;92;3527;3;36;92;56;0,4;1
"3528";3366;92;3528;3;18;73;55;0,2;0,8
"3529";3366;92;3529;4;67;92;25;0,727272727272727;1
"3530";3366;92;3530;4;33;58;25;0,363636363636364;0,636363636363636
"3531";3366;92;3531;4;58;84;26;0,636363636363636;0,909090909090909
"3532";3366;92;3532;4;58;92;34;0,636363636363636;1
"3533";3366;92;3533;4;41;67;26;0,454545454545455;0,727272727272727
"3534";3366;92;3534;4;24;50;26;0,272727272727273;0,545454545454545
"3535";3366;92;3535;5;68;80;12;0,739130434782609;0,869565217391304
"3536";3366;92;3536;5;43;56;13;0,478260869565217;0,608695652173913
"3537";3366;92;3537;5;43;60;17;0,478260869565217;0,652173913043478
"3538";3366;92;3538;5;48;60;12;0,521739130434783;0,652173913043478
"3539";3366;92;3539;5;72;84;12;0,782608695652174;0,91304347826087
"3540";3366;92;3540;5;72;88;16;0,782608695652174;0,956521739130435
"3541";3366;92;3541;5;72;92;20;0,782608695652174;1
"3542";3366;92;3542;5;76;88;12;0,826086956521739;0,956521739130435
"3543";3366;92;3543;5;76;92;16;0,826086956521739;1
"3544";3366;92;3544;5;80;92;12;0,869565217391304;1
"3545";3366;92;3545;5;68;84;16;0,739130434782609;0,91304347826087
"3546";3366;92;3546;5;68;88;20;0,739130434782609;0,956521739130435
"3547";3366;92;3547;5;52;64;12;0,565217391304348;0,695652173913043
"3548";3366;92;3548;5;7;19;12;0,0869565217391304;0,217391304347826
"3549";3366;92;3549;5;19;31;12;0,217391304347826;0,347826086956522
"3550";3366;92;3550;6;13;19;6;0,152173913043478;0,217391304347826
"3551";3366;92;3551;6;43;50;7;0,478260869565217;0,543478260869565
"3552";3366;92;3552;6;78;84;6;0,847826086956522;0,91304347826087
"3553";3366;92;3553;6;82;88;6;0,891304347826087;0,956521739130435
"3554";3366;92;3554;6;25;31;6;0,282608695652174;0,347826086956522
"3555";3366;92;3555;6;43;52;9;0,478260869565217;0,565217391304348
"3556";3366;92;3556;6;46;52;6;0,5;0,565217391304348
"3557";3366;92;3557;6;50;56;6;0,543478260869565;0,608695652173913
"3558";3366;92;3558;6;52;58;6;0,565217391304348;0,630434782608696
"3559";3366;92;3559;6;56;62;6;0,608695652173913;0,673913043478261
"3560";3366;92;3560;6;70;76;6;0,760869565217391;0,826086956521739
"3561";3366;92;3561;6;70;78;8;0,760869565217391;0,847826086956522
"3562";3366;92;3562;6;70;80;10;0,760869565217391;0,869565217391304
"3563";3366;92;3563;6;72;78;6;0,782608695652174;0,847826086956522
"3564";3366;92;3564;6;74;80;6;0,804347826086957;0,869565217391304
"3565";3366;92;3565;6;74;82;8;0,804347826086957;0,891304347826087
"3566";3366;92;3566;6;74;84;10;0,804347826086957;0,91304347826087
"3567";3366;92;3567;6;76;82;6;0,826086956521739;0,891304347826087
"3568";3366;92;3568;6;80;86;6;0,869565217391304;0,934782608695652
"3569";3366;92;3569;6;80;88;8;0,869565217391304;0,956521739130435
"3570";3366;92;3570;6;80;90;10;0,869565217391304;0,978260869565217
"3571";3366;92;3571;6;46;54;8;0,5;0,58695652173913
"3572";3366;92;3572;6;46;56;10;0,5;0,608695652173913
"3573";3366;92;3573;6;46;58;12;0,5;0,630434782608696
"3574";3366;92;3574;6;46;60;14;0,5;0,652173913043478
"3575";3366;92;3575;6;48;54;6;0,521739130434783;0,58695652173913
"3576";3366;92;3576;6;48;56;8;0,521739130434783;0,608695652173913
"3577";3366;92;3577;6;48;58;10;0,521739130434783;0,630434782608696
"3578";3366;92;3578;6;54;60;6;0,58695652173913;0,652173913043478
"3579";3366;92;3579;6;72;80;8;0,782608695652174;0,869565217391304
"3580";3366;92;3580;6;72;82;10;0,782608695652174;0,891304347826087
"3581";3366;92;3581;6;72;84;12;0,782608695652174;0,91304347826087
"3582";3366;92;3582;6;72;86;14;0,782608695652174;0,934782608695652
"3583";3366;92;3583;6;72;88;16;0,782608695652174;0,956521739130435
"3584";3366;92;3584;6;74;86;12;0,804347826086957;0,934782608695652
"3585";3366;92;3585;6;76;84;8;0,826086956521739;0,91304347826087
"3586";3366;92;3586;6;76;86;10;0,826086956521739;0,934782608695652
"3587";3366;92;3587;6;76;88;12;0,826086956521739;0,956521739130435
"3588";3366;92;3588;6;76;90;14;0,826086956521739;0,978260869565217
"3589";3366;92;3589;6;78;86;8;0,847826086956522;0,934782608695652
"3590";3366;92;3590;6;78;88;10;0,847826086956522;0,956521739130435
"3591";3366;92;3591;6;23;29;6;0,260869565217391;0,326086956521739
"3592";3366;92;3592;6;23;31;8;0,260869565217391;0,347826086956522
"3593";3366;92;3593;6;50;58;8;0,543478260869565;0,630434782608696
"3594";3366;92;3594;6;50;60;10;0,543478260869565;0,652173913043478
"3595";3366;92;3595;6;52;60;8;0,565217391304348;0,652173913043478
"3596";3366;92;3596;6;52;62;10;0,565217391304348;0,673913043478261
"3597";3366;92;3597;6;66;72;6;0,717391304347826;0,782608695652174
"3598";3366;92;3598;6;43;54;11;0,478260869565217;0,58695652173913
"3599";3366;92;3599;6;43;56;13;0,478260869565217;0,608695652173913
"3600";3366;92;3600;6;43;58;15;0,478260869565217;0,630434782608696
"3601";3366;92;3601;6;50;62;12;0,543478260869565;0,673913043478261
"3602";3366;92;3602;6;54;62;8;0,58695652173913;0,673913043478261
"3603";3366;92;3603;6;70;82;12;0,760869565217391;0,891304347826087
"3604";3366;92;3604;6;70;84;14;0,760869565217391;0,91304347826087
"3605";3366;92;3605;6;74;88;14;0,804347826086957;0,956521739130435
"3606";3366;92;3606;6;80;92;12;0,869565217391304;1
"3607";3366;92;3607;6;11;17;6;0,130434782608696;0,195652173913043
"3608";3366;92;3608;6;11;19;8;0,130434782608696;0,217391304347826
"3609";3366;92;3609;6;21;27;6;0,239130434782609;0,304347826086957
"3610";3366;92;3610;6;70;86;16;0,760869565217391;0,934782608695652
"3611";3366;92;3611;6;78;90;12;0,847826086956522;0,978260869565217
"3612";3366;92;3612;6;82;90;8;0,891304347826087;0,978260869565217
"3613";3366;92;3613;6;82;92;10;0,891304347826087;1
"3614";3366;92;3614;6;41;48;7;0,456521739130435;0,521739130434783
"3615";3366;92;3615;6;41;50;9;0,456521739130435;0,543478260869565
"3616";3366;92;3616;6;48;60;12;0,521739130434783;0,652173913043478
"3617";3366;92;3617;6;48;62;14;0,521739130434783;0,673913043478261
"3618";3366;92;3618;6;41;52;11;0,456521739130435;0,565217391304348
"3619";3366;92;3619;6;41;54;13;0,456521739130435;0,58695652173913
"3620";3366;92;3620;6;41;56;15;0,456521739130435;0,608695652173913
"3621";3366;92;3621;6;74;90;16;0,804347826086957;0,978260869565217
"3622";3366;92;3622;6;74;92;18;0,804347826086957;1
"3623";3366;92;3623;6;78;92;14;0,847826086956522;1
"3624";3366;92;3624;6;70;88;18;0,760869565217391;0,956521739130435
"3625";3366;92;3625;6;70;90;20;0,760869565217391;0,978260869565217
"3626";3366;92;3626;6;70;92;22;0,760869565217391;1
"3627";3366;92;3627;6;76;92;16;0,826086956521739;1
"3628";3366;92;3628;6;64;70;6;0,695652173913043;0,760869565217391
"3629";3366;92;3629;6;72;90;18;0,782608695652174;0,978260869565217
"3630";3366;92;3630;6;72;92;20;0,782608695652174;1
"3631";3366;92;3631;6;19;25;6;0,217391304347826;0,282608695652174
"3632";3366;92;3632;6;68;74;6;0,739130434782609;0,804347826086957
"3633";3366;92;3633;6;68;76;8;0,739130434782609;0,826086956521739
"3634";3366;92;3634;6;46;62;16;0,5;0,673913043478261
"3635";3366;92;3635;6;43;60;17;0,478260869565217;0,652173913043478
"3636";3366;92;3636;6;9;15;6;0,108695652173913;0,173913043478261
"3637";3402;58;3637;3;33;58;25;0,571428571428571;1
"3638";3402;58;3638;4;41;54;13;0,714285714285714;0,928571428571429
"3639";3402;58;3639;4;41;58;17;0,714285714285714;1
"3640";3402;58;3640;4;45;58;13;0,785714285714286;1
"3641";3402;58;3641;4;33;45;12;0,571428571428571;0,785714285714286
"3642";3402;58;3642;4;28;41;13;0,5;0,714285714285714
"3643";3402;58;3643;4;37;50;13;0,642857142857143;0,857142857142857
"3644";3402;58;3644;4;37;54;17;0,642857142857143;0,928571428571429
"3645";3402;58;3645;4;37;58;21;0,642857142857143;1
"3646";3402;58;3646;4;20;33;13;0,357142857142857;0,571428571428571
"3647";3402;58;3647;4;3;16;13;0,0714285714285714;0,285714285714286
"3648";3402;58;3648;5;7;13;6;0,137931034482759;0,241379310344828
"3649";3402;58;3649;5;7;15;8;0,137931034482759;0,275862068965517
"3650";3402;58;3650;5;9;15;6;0,172413793103448;0,275862068965517
"3651";3402;58;3651;5;36;42;6;0,620689655172414;0,724137931034483
"3652";3402;58;3652;5;42;48;6;0,724137931034483;0,827586206896552
"3653";3402;58;3653;5;48;54;6;0,827586206896552;0,931034482758621
"3654";3402;58;3654;5;19;25;6;0,344827586206897;0,448275862068966
"3655";3402;58;3655;5;21;27;6;0,379310344827586;0,482758620689655
"3656";3402;58;3656;5;44;50;6;0,758620689655172;0,862068965517241
"3657";3402;58;3657;5;44;52;8;0,758620689655172;0,896551724137931
"3658";3402;58;3658;5;44;54;10;0,758620689655172;0,931034482758621
"3659";3402;58;3659;5;44;56;12;0,758620689655172;0,96551724137931
"3660";3402;58;3660;5;46;52;6;0,793103448275862;0,896551724137931
"3661";3402;58;3661;5;46;54;8;0,793103448275862;0,931034482758621
"3662";3402;58;3662;5;46;56;10;0,793103448275862;0,96551724137931
"3663";3402;58;3663;5;19;27;8;0,344827586206897;0,482758620689655
"3664";3402;58;3664;5;48;56;8;0,827586206896552;0,96551724137931
"3665";3402;58;3665;5;19;30;11;0,344827586206897;0,517241379310345
"3666";3402;58;3666;5;19;32;13;0,344827586206897;0,551724137931034
"3667";3402;58;3667;5;23;30;7;0,413793103448276;0,517241379310345
"3668";3402;58;3668;5;44;58;14;0,758620689655172;1
"3669";3402;58;3669;5;46;58;12;0,793103448275862;1
"3670";3402;58;3670;5;48;58;10;0,827586206896552;1
"3671";3402;58;3671;5;3;9;6;0,0689655172413793;0,172413793103448
"3672";3402;58;3672;5;25;32;7;0,448275862068966;0,551724137931034
"3673";3402;58;3673;5;23;32;9;0,413793103448276;0,551724137931034
"3674";3402;58;3674;5;42;50;8;0,724137931034483;0,862068965517241
"3675";3402;58;3675;5;21;30;9;0,379310344827586;0,517241379310345
"3676";3402;58;3676;5;21;32;11;0,379310344827586;0,551724137931034
"3677";3402;58;3677;5;36;44;8;0,620689655172414;0,758620689655172
"3678";3402;58;3678;5;34;40;6;0,586206896551724;0,689655172413793
"3679";3402;58;3679;5;42;52;10;0,724137931034483;0,896551724137931
"3680";3402;58;3680;5;32;38;6;0,551724137931034;0,655172413793103
"3681";3402;58;3681;5;1;7;6;0,0344827586206897;0,137931034482759
"3682";3402;58;3682;5;42;54;12;0,724137931034483;0,931034482758621
"3683";3402;58;3683;5;42;56;14;0,724137931034483;0,96551724137931
"3684";3402;58;3684;5;15;21;6;0,275862068965517;0,379310344827586
"3685";3402;58;3685;5;38;44;6;0,655172413793103;0,758620689655172
"3686";3402;58;3686;5;40;46;6;0,689655172413793;0,793103448275862
"3687";3402;58;3687;5;40;48;8;0,689655172413793;0,827586206896552
"3688";3402;58;3688;5;42;58;16;0,724137931034483;1
"3689";3402;58;3689;5;34;42;8;0,586206896551724;0,724137931034483
"3690";3402;58;3690;5;36;46;10;0,620689655172414;0,793103448275862
"3691";3402;58;3691;5;38;46;8;0,655172413793103;0,793103448275862
"3692";3430;153;3692;3;38;153;115;0,25;1
"3693";3430;153;3693;4;85;136;51;0,555555555555556;0,888888888888889
"3694";3430;153;3694;4;85;153;68;0,555555555555556;1
"3695";3430;153;3695;4;102;153;51;0,666666666666667;1
"3696";3430;153;3696;4;67;119;52;0,444444444444444;0,777777777777778
"3697";3430;153;3697;4;67;136;69;0,444444444444444;0,888888888888889
"3698";3430;153;3698;4;16;67;51;0,111111111111111;0,444444444444444
"3699";3430;153;3699;4;50;102;52;0,333333333333333;0,666666666666667
"3700";3430;153;3700;4;50;119;69;0,333333333333333;0,777777777777778
"3701";3430;153;3701;4;67;153;86;0,444444444444444;1
"3702";3430;153;3702;4;33;85;52;0,222222222222222;0,555555555555556
"3703";3430;153;3703;5;72;96;24;0,473684210526316;0,631578947368421
"3704";3430;153;3704;5;121;145;24;0,789473684210526;0,947368421052632
"3705";3430;153;3705;5;121;153;32;0,789473684210526;1
"3706";3430;153;3706;5;129;153;24;0,842105263157895;1
"3707";3430;153;3707;5;23;48;25;0,157894736842105;0,315789473684211
"3708";3430;153;3708;5;31;56;25;0,210526315789474;0,368421052631579
"3709";3430;153;3709;5;40;64;24;0,263157894736842;0,421052631578947
"3710";3430;153;3710;5;64;88;24;0,421052631578947;0,578947368421053
"3711";3430;153;3711;5;64;96;32;0,421052631578947;0,631578947368421
"3712";3430;153;3712;5;112;137;25;0,736842105263158;0,894736842105263
"3713";3430;153;3713;5;112;145;33;0,736842105263158;0,947368421052632
"3714";3430;153;3714;5;31;64;33;0,210526315789474;0,421052631578947
"3715";3430;153;3715;5;80;104;24;0,526315789473684;0,684210526315789
"3716";3430;153;3716;5;23;56;33;0,157894736842105;0,368421052631579
"3717";3430;153;3717;6;64;76;12;0,421052631578947;0,5
"3718";3430;153;3718;6;121;133;12;0,789473684210526;0,868421052631579
"3719";3430;153;3719;6;121;137;16;0,789473684210526;0,894736842105263
"3720";3430;153;3720;6;125;137;12;0,815789473684211;0,894736842105263
"3721";3430;153;3721;6;129;141;12;0,842105263157895;0,921052631578947
"3722";3430;153;3722;6;129;145;16;0,842105263157895;0,947368421052632
"3723";3430;153;3723;6;133;145;12;0,868421052631579;0,947368421052632
"3724";3430;153;3724;6;68;80;12;0,447368421052632;0,526315789473684
"3725";3430;153;3725;6;125;141;16;0,815789473684211;0,921052631578947
"3726";3430;153;3726;6;48;60;12;0,315789473684211;0,394736842105263
"3727";3430;153;3727;6;52;64;12;0,342105263157895;0,421052631578947
"3728";3430;153;3728;6;64;80;16;0,421052631578947;0,526315789473684
"3729";3430;153;3729;6;68;84;16;0,447368421052632;0,552631578947368
"3730";3430;153;3730;6;68;88;20;0,447368421052632;0,578947368421053
"3731";3430;153;3731;6;68;92;24;0,447368421052632;0,605263157894737
"3732";3430;153;3732;6;68;96;28;0,447368421052632;0,631578947368421
"3733";3430;153;3733;6;72;84;12;0,473684210526316;0,552631578947368
"3734";3430;153;3734;6;76;88;12;0,5;0,578947368421053
"3735";3430;153;3735;6;84;96;12;0,552631578947368;0,631578947368421
"3736";3430;153;3736;6;121;141;20;0,789473684210526;0,921052631578947
"3737";3430;153;3737;6;121;145;24;0,789473684210526;0,947368421052632
"3738";3430;153;3738;6;121;149;28;0,789473684210526;0,973684210526316
"3739";3430;153;3739;6;125;145;20;0,815789473684211;0,947368421052632
"3740";3430;153;3740;6;125;149;24;0,815789473684211;0,973684210526316
"3741";3430;153;3741;6;129;149;20;0,842105263157895;0,973684210526316
"3742";3430;153;3742;6;108;121;13;0,710526315789474;0,789473684210526
"3743";3430;153;3743;6;44;56;12;0,289473684210526;0,368421052631579
"3744";3430;153;3744;6;88;100;12;0,578947368421053;0,657894736842105
"3745";3430;153;3745;6;112;125;13;0,736842105263158;0,815789473684211
"3746";3430;153;3746;6;133;149;16;0,868421052631579;0,973684210526316
"3747";3430;153;3747;6;117;129;12;0,763157894736842;0,842105263157895
"3748";3430;153;3748;6;117;133;16;0,763157894736842;0,868421052631579
"3749";3430;153;3749;6;76;92;16;0,5;0,605263157894737
"3750";3430;153;3750;6;76;96;20;0,5;0,631578947368421
"3751";3430;153;3751;6;80;92;12;0,526315789473684;0,605263157894737
"3752";3430;153;3752;6;80;96;16;0,526315789473684;0,631578947368421
"3753";3430;153;3753;6;117;137;20;0,763157894736842;0,894736842105263
"3754";3430;153;3754;6;117;141;24;0,763157894736842;0,921052631578947
"3755";3430;153;3755;6;56;68;12;0,368421052631579;0,447368421052632
"3756";3430;153;3756;6;129;153;24;0,842105263157895;1
"3757";3430;153;3757;6;133;153;20;0,868421052631579;1
"3758";3430;153;3758;6;72;88;16;0,473684210526316;0,578947368421053
"3759";3430;153;3759;6;72;92;20;0,473684210526316;0,605263157894737
"3760";3430;153;3760;6;121;153;32;0,789473684210526;1
"3761";3430;153;3761;6;40;52;12;0,263157894736842;0,342105263157895
"3762";3430;153;3762;6;7;19;12;0,0526315789473684;0,131578947368421
"3763";3430;153;3763;6;125;153;28;0,815789473684211;1
"3764";3430;153;3764;6;35;48;13;0,236842105263158;0,315789473684211
"3765";3430;153;3765;6;64;84;20;0,421052631578947;0,552631578947368
"3766";3430;153;3766;6;31;44;13;0,210526315789474;0,289473684210526
"3767";3430;153;3767;6;48;64;16;0,315789473684211;0,421052631578947
"3768";3430;153;3768;6;112;129;17;0,736842105263158;0,842105263157895
"3769";3430;153;3769;6;44;60;16;0,289473684210526;0,394736842105263
"3770";3430;153;3770;6;72;96;24;0,473684210526316;0,631578947368421
"3771";3430;153;3771;6;117;145;28;0,763157894736842;0,947368421052632
"3772";3430;153;3772;6;117;149;32;0,763157894736842;0,973684210526316
"3773";3430;153;3773;6;117;153;36;0,763157894736842;1
"3774";3430;153;3774;6;84;100;16;0,552631578947368;0,657894736842105
"3775";3430;153;3775;6;64;88;24;0,421052631578947;0,578947368421053
"3776";3430;153;3776;6;27;40;13;0,184210526315789;0,263157894736842
"3777";3431;167;3777;3;66;167;101;0,4;1
"3778";3431;167;3778;4;49;100;51;0,3;0,6
"3779";3431;167;3779;4;66;117;51;0,4;0,7
"3780";3431;167;3780;4;117;167;50;0,7;1
"3781";3431;167;3781;4;100;150;50;0,6;0,9
"3782";3431;167;3782;5;71;95;24;0,428571428571429;0,571428571428571
"3783";3431;167;3783;5;135;159;24;0,80952380952381;0,952380952380952
"3784";3431;167;3784;5;135;167;32;0,80952380952381;1
"3785";3431;167;3785;5;143;167;24;0,857142857142857;1
"3786";3431;167;3786;5;63;87;24;0,380952380952381;0,523809523809524
"3787";3431;167;3787;5;87;111;24;0,523809523809524;0,666666666666667
"3788";3431;167;3788;5;79;103;24;0,476190476190476;0,619047619047619
"3789";3431;167;3789;5;79;111;32;0,476190476190476;0,666666666666667
"3790";3431;167;3790;5;71;103;32;0,428571428571429;0,619047619047619
"3791";3431;167;3791;5;55;79;24;0,333333333333333;0,476190476190476
"3792";3431;167;3792;5;47;71;24;0,285714285714286;0,428571428571429
"3793";3431;167;3793;5;39;63;24;0,238095238095238;0,380952380952381
"3794";3431;167;3794;5;71;111;40;0,428571428571429;0,666666666666667
"3795";3431;167;3795;5;63;95;32;0,380952380952381;0,571428571428571
"3796";3431;167;3796;6;43;55;12;0,261904761904762;0,333333333333333
"3797";3431;167;3797;6;43;59;16;0,261904761904762;0,357142857142857
"3798";3431;167;3798;6;95;107;12;0,571428571428571;0,642857142857143
"3799";3431;167;3799;6;143;155;12;0,857142857142857;0,928571428571429
"3800";3431;167;3800;6;147;159;12;0,880952380952381;0,952380952380952
"3801";3431;167;3801;6;151;163;12;0,904761904761905;0,976190476190476
"3802";3431;167;3802;6;151;167;16;0,904761904761905;1
"3803";3431;167;3803;6;47;59;12;0,285714285714286;0,357142857142857
"3804";3431;167;3804;6;79;91;12;0,476190476190476;0,547619047619048
"3805";3431;167;3805;6;79;95;16;0,476190476190476;0,571428571428571
"3806";3431;167;3806;6;83;95;12;0,5;0,571428571428571
"3807";3431;167;3807;6;95;111;16;0,571428571428571;0,666666666666667
"3808";3431;167;3808;6;99;111;12;0,595238095238095;0,666666666666667
"3809";3431;167;3809;6;135;147;12;0,80952380952381;0,880952380952381
"3810";3431;167;3810;6;135;151;16;0,80952380952381;0,904761904761905
"3811";3431;167;3811;6;139;151;12;0,833333333333333;0,904761904761905
"3812";3431;167;3812;6;139;155;16;0,833333333333333;0,928571428571429
"3813";3431;167;3813;6;143;159;16;0,857142857142857;0,952380952380952
"3814";3431;167;3814;6;143;163;20;0,857142857142857;0,976190476190476
"3815";3431;167;3815;6;11;23;12;0,0714285714285714;0,142857142857143
"3816";3431;167;3816;6;63;75;12;0,380952380952381;0,452380952380952
"3817";3431;167;3817;6;87;99;12;0,523809523809524;0,595238095238095
"3818";3431;167;3818;6;39;51;12;0,238095238095238;0,30952380952381
"3819";3431;167;3819;6;59;71;12;0,357142857142857;0,428571428571429
"3820";3431;167;3820;6;83;99;16;0,5;0,595238095238095
"3821";3431;167;3821;6;83;103;20;0,5;0,619047619047619
"3822";3431;167;3822;6;83;107;24;0,5;0,642857142857143
"3823";3431;167;3823;6;83;111;28;0,5;0,666666666666667
"3824";3431;167;3824;6;87;103;16;0,523809523809524;0,619047619047619
"3825";3431;167;3825;6;87;107;20;0,523809523809524;0,642857142857143
"3826";3431;167;3826;6;103;115;12;0,619047619047619;0,69047619047619
"3827";3431;167;3827;6;135;155;20;0,80952380952381;0,928571428571429
"3828";3431;167;3828;6;135;159;24;0,80952380952381;0,952380952380952
"3829";3431;167;3829;6;135;163;28;0,80952380952381;0,976190476190476
"3830";3431;167;3830;6;131;143;12;0,785714285714286;0,857142857142857
"3831";3431;167;3831;6;143;167;24;0,857142857142857;1
"3832";3431;167;3832;6;147;163;16;0,880952380952381;0,976190476190476
"3833";3431;167;3833;6;147;167;20;0,880952380952381;1
"3834";3431;167;3834;6;7;19;12;0,0476190476190476;0,119047619047619
"3835";3431;167;3835;6;63;79;16;0,380952380952381;0,476190476190476
"3836";3431;167;3836;6;139;159;20;0,833333333333333;0,952380952380952
"3837";3431;167;3837;6;75;87;12;0,452380952380952;0,523809523809524
"3838";3431;167;3838;6;135;167;32;0,80952380952381;1
"3839";3431;167;3839;6;139;163;24;0,833333333333333;0,976190476190476
"3840";3431;167;3840;6;139;167;28;0,833333333333333;1
"3841";3431;167;3841;6;67;79;12;0,404761904761905;0,476190476190476
"3842";3431;167;3842;6;87;111;24;0,523809523809524;0,666666666666667
"3843";3431;167;3843;6;131;147;16;0,785714285714286;0,880952380952381
"3844";3431;167;3844;6;39;55;16;0,238095238095238;0,333333333333333
"3845";3431;167;3845;6;39;59;20;0,238095238095238;0,357142857142857
"3846";3431;167;3846;6;75;91;16;0,452380952380952;0,547619047619048
"3847";3431;167;3847;6;59;75;16;0,357142857142857;0,452380952380952
"3848";3431;167;3848;6;35;47;12;0,214285714285714;0,285714285714286
"3849";3431;167;3849;6;99;115;16;0,595238095238095;0,69047619047619
"3850";3431;167;3850;6;131;151;20;0,785714285714286;0,904761904761905
"3851";3584;140;3851;3;34;140;106;0,25;1
"3852";3584;140;3852;4;34;87;53;0,25;0,625
"3853";3584;140;3853;4;70;122;52;0,5;0,875
"3854";3584;140;3854;4;87;140;53;0,625;1
"3855";3584;140;3855;4;70;140;70;0,5;1
"3856";3584;140;3856;4;52;105;53;0,375;0,75
"3857";3584;140;3857;4;17;70;53;0,125;0,5
"3858";3584;140;3858;5;24;49;25;0,176470588235294;0,352941176470588
"3859";3584;140;3859;5;57;82;25;0,411764705882353;0,588235294117647
"3860";3584;140;3860;5;32;57;25;0,235294117647059;0,411764705882353
"3861";3584;140;3861;5;65;90;25;0,470588235294118;0,647058823529412
"3862";3584;140;3862;5;74;99;25;0,529411764705882;0,705882352941177
"3863";3584;140;3863;5;82;107;25;0,588235294117647;0,764705882352941
"3864";3584;140;3864;5;107;132;25;0,764705882352941;0,941176470588235
"3865";3584;140;3865;5;107;140;33;0,764705882352941;1
"3866";3584;140;3866;5;49;74;25;0,352941176470588;0,529411764705882
"3867";3584;140;3867;5;82;115;33;0,588235294117647;0,823529411764706
"3868";3584;140;3868;5;99;123;24;0,705882352941177;0,882352941176471
"3869";3584;140;3869;5;115;140;25;0,823529411764706;1
"3870";3584;140;3870;5;90;115;25;0,647058823529412;0,823529411764706
"3871";3584;140;3871;5;90;123;33;0,647058823529412;0,882352941176471
"3872";3584;140;3872;5;99;132;33;0,705882352941177;0,941176470588235
"3873";3584;140;3873;5;99;140;41;0,705882352941177;1
"3874";3584;140;3874;5;49;82;33;0,352941176470588;0,588235294117647
"3875";3584;140;3875;5;65;99;34;0,470588235294118;0,705882352941177
"3876";3584;140;3876;5;40;65;25;0,294117647058824;0,470588235294118
"3877";3584;140;3877;5;90;132;42;0,647058823529412;0,941176470588235
"3878";3584;140;3878;5;16;40;24;0,117647058823529;0,294117647058824
"3879";3584;140;3879;5;74;107;33;0,529411764705882;0,764705882352941
"3880";3584;140;3880;6;39;51;12;0,285714285714286;0,371428571428571
"3881";3584;140;3881;6;23;35;12;0,171428571428571;0,257142857142857
"3882";3584;140;3882;6;35;47;12;0,257142857142857;0,342857142857143
"3883";3584;140;3883;6;51;63;12;0,371428571428571;0,457142857142857
"3884";3584;140;3884;6;67;80;13;0,485714285714286;0,571428571428571
"3885";3584;140;3885;6;72;84;12;0,514285714285714;0,6
"3886";3584;140;3886;6;76;88;12;0,542857142857143;0,628571428571429
"3887";3584;140;3887;6;116;128;12;0,828571428571429;0,914285714285714
"3888";3584;140;3888;6;116;132;16;0,828571428571429;0,942857142857143
"3889";3584;140;3889;6;55;67;12;0,4;0,485714285714286
"3890";3584;140;3890;6;63;76;13;0,457142857142857;0,542857142857143
"3891";3584;140;3891;6;84;96;12;0,6;0,685714285714286
"3892";3584;140;3892;6;100;112;12;0,714285714285714;0,8
"3893";3584;140;3893;6;100;116;16;0,714285714285714;0,828571428571429
"3894";3584;140;3894;6;104;116;12;0,742857142857143;0,828571428571429
"3895";3584;140;3895;6;104;120;16;0,742857142857143;0,857142857142857
"3896";3584;140;3896;6;120;132;12;0,857142857142857;0,942857142857143
"3897";3584;140;3897;6;120;136;16;0,857142857142857;0,971428571428571
"3898";3584;140;3898;6;80;92;12;0,571428571428571;0,657142857142857
"3899";3584;140;3899;6;15;27;12;0,114285714285714;0,2
"3900";3584;140;3900;6;84;100;16;0,6;0,714285714285714
"3901";3584;140;3901;6;88;100;12;0,628571428571429;0,714285714285714
"3902";3584;140;3902;6;120;140;20;0,857142857142857;1
"3903";3584;140;3903;6;124;136;12;0,885714285714286;0,971428571428571
"3904";3584;140;3904;6;124;140;16;0,885714285714286;1
"3905";3584;140;3905;6;47;59;12;0,342857142857143;0,428571428571429
"3906";3584;140;3906;6;43;55;12;0,314285714285714;0,4
"3907";3584;140;3907;6;108;120;12;0,771428571428571;0,857142857142857
"3908";3584;140;3908;6;72;88;16;0,514285714285714;0,628571428571429
"3909";3584;140;3909;6;27;39;12;0,2;0,285714285714286
"3910";3584;140;3910;6;92;104;12;0,657142857142857;0,742857142857143
"3911";3584;140;3911;6;19;31;12;0,142857142857143;0,228571428571429
"3912";3584;140;3912;6;88;104;16;0,628571428571429;0,742857142857143
"3913";3584;140;3913;6;100;120;20;0,714285714285714;0,857142857142857
"3914";3584;140;3914;6;108;124;16;0,771428571428571;0,885714285714286
"3915";3584;140;3915;6;116;136;20;0,828571428571429;0,971428571428571
"3916";3584;140;3916;6;116;140;24;0,828571428571429;1
"3917";3584;140;3917;6;67;84;17;0,485714285714286;0,6
"3918";3584;140;3918;6;59;72;13;0,428571428571429;0,514285714285714
"3919";3584;140;3919;6;59;76;17;0,428571428571429;0,542857142857143
"3920";3584;140;3920;6;96;108;12;0,685714285714286;0,771428571428571
"3921";3584;140;3921;6;96;112;16;0,685714285714286;0,8
"3922";3584;140;3922;6;63;80;17;0,457142857142857;0,571428571428571
"3923";3584;140;3923;6;104;124;20;0,742857142857143;0,885714285714286
"3924";3584;140;3924;6;104;128;24;0,742857142857143;0,914285714285714
"3925";3584;140;3925;6;104;132;28;0,742857142857143;0,942857142857143
"3926";3584;140;3926;6;104;136;32;0,742857142857143;0,971428571428571
"3927";3584;140;3927;6;104;140;36;0,742857142857143;1
"3928";3584;140;3928;6;112;124;12;0,8;0,885714285714286
"3929";3584;140;3929;6;35;51;16;0,257142857142857;0,371428571428571
"3930";3584;140;3930;6;112;128;16;0,8;0,914285714285714
"3931";3584;140;3931;6;96;116;20;0,685714285714286;0,828571428571429
"3932";3584;140;3932;6;84;104;20;0,6;0,742857142857143
"3933";3584;140;3933;6;31;43;12;0,228571428571429;0,314285714285714
"3934";3584;140;3934;6;80;96;16;0,571428571428571;0,685714285714286
"3935";3584;140;3935;6;43;59;16;0,314285714285714;0,428571428571429
"3936";3584;140;3936;6;108;128;20;0,771428571428571;0,914285714285714
"3937";3584;140;3937;6;108;132;24;0,771428571428571;0,942857142857143
"3938";3584;140;3938;6;76;92;16;0,542857142857143;0,657142857142857
"3939";3584;140;3939;6;92;108;16;0,657142857142857;0,771428571428571
"3940";3584;140;3940;6;76;96;20;0,542857142857143;0,685714285714286
"3941";3584;140;3941;6;112;132;20;0,8;0,942857142857143
"3942";3584;140;3942;6;27;43;16;0,2;0,314285714285714
"3943";3592;129;3943;4;80;129;49;0,625;1
"3944";3592;129;3944;4;64;113;49;0,5;0,875
"3945";3592;129;3945;5;80;105;25;0,625;0,8125
"3946";3592;129;3946;5;88;113;25;0,6875;0,875
"3947";3592;129;3947;5;96;121;25;0,75;0,9375
"3948";3592;129;3948;5;23;48;25;0,1875;0,375
"3949";3592;129;3949;6;11;23;12;0,09375;0,1875
"3950";3592;129;3950;6;101;113;12;0,78125;0,875
"3951";3592;129;3951;6;40;52;12;0,3125;0,40625
"3952";3592;129;3952;6;36;48;12;0,28125;0,375
"3953";3592;129;3953;6;84;96;12;0,65625;0,75
"3954";3592;129;3954;6;96;109;13;0,75;0,84375
"3955";3592;129;3955;6;96;113;17;0,75;0,875
"3956";3592;129;3956;6;101;117;16;0,78125;0,90625
"3957";3592;129;3957;6;105;117;12;0,8125;0,90625
"3958";3592;129;3958;6;88;101;13;0,6875;0,78125
"3959";3592;129;3959;6;7;19;12;0,0625;0,15625
"3960";3592;129;3960;6;27;40;13;0,21875;0,3125
"3961";3592;129;3961;6;32;44;12;0,25;0,34375
"3962";3592;129;3962;6;96;117;21;0,75;0,90625
"3963";3592;129;3963;6;88;105;17;0,6875;0,8125
"3964";3592;129;3964;6;92;105;13;0,71875;0,8125
"3965";3592;129;3965;6;3;15;12;0,03125;0,125
"3966";3592;129;3966;6;84;101;17;0,65625;0,78125
"3967";3592;129;3967;6;23;36;13;0,1875;0,28125
"3968";3592;129;3968;6;109;121;12;0,84375;0,9375
"3969";3592;129;3969;6;32;48;16;0,25;0,375
"3970";3592;129;3970;6;92;109;17;0,71875;0,84375
"3971";3592;129;3971;6;92;113;21;0,71875;0,875
"3972";3592;129;3972;6;88;109;21;0,6875;0,84375
"3973";3744;138;3973;4;86;138;52;0,625;1
"3974";3744;138;3974;5;24;48;24;0,176470588235294;0,352941176470588
"3975";3744;138;3975;5;15;40;25;0,117647058823529;0,294117647058824
"3976";3744;138;3976;5;24;56;32;0,176470588235294;0,411764705882353
"3977";3744;138;3977;5;32;56;24;0,235294117647059;0,411764705882353
"3978";3744;138;3978;5;105;130;25;0,764705882352941;0,941176470588235
"3979";3744;138;3979;5;97;122;25;0,705882352941177;0,882352941176471
"3980";3744;138;3980;5;97;130;33;0,705882352941177;0,941176470588235
"3981";3744;138;3981;5;15;48;33;0,117647058823529;0,352941176470588
"3982";3744;138;3982;5;56;81;25;0,411764705882353;0,588235294117647
"3983";3744;138;3983;5;7;32;25;0,0588235294117647;0,235294117647059
"3984";3744;138;3984;5;113;138;25;0,823529411764706;1
"3985";3744;138;3985;5;40;64;24;0,294117647058824;0,470588235294118
"3986";3744;138;3986;5;81;105;24;0,588235294117647;0,764705882352941
"3987";3744;138;3987;5;89;113;24;0,647058823529412;0,823529411764706
"3988";3744;138;3988;5;73;97;24;0,529411764705882;0,705882352941177
"3989";3744;138;3989;5;64;89;25;0,470588235294118;0,647058823529412
"3990";3744;138;3990;5;89;122;33;0,647058823529412;0,882352941176471
"3991";3744;138;3991;6;11;24;13;0,0882352941176471;0,176470588235294
"3992";3744;138;3992;6;15;28;13;0,117647058823529;0,205882352941176
"3993";3744;138;3993;6;15;32;17;0,117647058823529;0,235294117647059
"3994";3744;138;3994;6;24;36;12;0,176470588235294;0,264705882352941
"3995";3744;138;3995;6;24;40;16;0,176470588235294;0,294117647058824
"3996";3744;138;3996;6;32;44;12;0,235294117647059;0,323529411764706
"3997";3744;138;3997;6;40;52;12;0,294117647058824;0,382352941176471
"3998";3744;138;3998;6;93;105;12;0,676470588235294;0,764705882352941
"3999";3744;138;3999;6;105;118;13;0,764705882352941;0,852941176470588
"4000";3744;138;4000;6;109;122;13;0,794117647058823;0,882352941176471
"4001";3744;138;4001;6;113;126;13;0,823529411764706;0,911764705882353
"4002";3744;138;4002;6;15;36;21;0,117647058823529;0,264705882352941
"4003";3744;138;4003;6;15;40;25;0,117647058823529;0,294117647058824
"4004";3744;138;4004;6;19;32;13;0,147058823529412;0,235294117647059
"4005";3744;138;4005;6;19;36;17;0,147058823529412;0,264705882352941
"4006";3744;138;4006;6;19;40;21;0,147058823529412;0,294117647058824
"4007";3744;138;4007;6;19;44;25;0,147058823529412;0,323529411764706
"4008";3744;138;4008;6;28;40;12;0,205882352941176;0,294117647058824
"4009";3744;138;4009;6;28;44;16;0,205882352941176;0,323529411764706
"4010";3744;138;4010;6;32;48;16;0,235294117647059;0,352941176470588
"4011";3744;138;4011;6;32;52;20;0,235294117647059;0,382352941176471
"4012";3744;138;4012;6;36;48;12;0,264705882352941;0,352941176470588
"4013";3744;138;4013;6;36;52;16;0,264705882352941;0,382352941176471
"4014";3744;138;4014;6;40;56;16;0,294117647058824;0,411764705882353
"4015";3744;138;4015;6;89;101;12;0,647058823529412;0,735294117647059
"4016";3744;138;4016;6;105;122;17;0,764705882352941;0,882352941176471
"4017";3744;138;4017;6;24;44;20;0,176470588235294;0,323529411764706
"4018";3744;138;4018;6;24;48;24;0,176470588235294;0,352941176470588
"4019";3744;138;4019;6;24;52;28;0,176470588235294;0,382352941176471
"4020";3744;138;4020;6;24;56;32;0,176470588235294;0,411764705882353
"4021";3744;138;4021;6;28;48;20;0,205882352941176;0,352941176470588
"4022";3744;138;4022;6;32;56;24;0,235294117647059;0,411764705882353
"4023";3744;138;4023;6;36;56;20;0,264705882352941;0,411764705882353
"4024";3744;138;4024;6;81;93;12;0,588235294117647;0,676470588235294
"4025";3744;138;4025;6;101;113;12;0,735294117647059;0,823529411764706
"4026";3744;138;4026;6;109;126;17;0,794117647058823;0,911764705882353
"4027";3744;138;4027;6;109;130;21;0,794117647058823;0,941176470588235
"4028";3744;138;4028;6;113;130;17;0,823529411764706;0,941176470588235
"4029";3744;138;4029;6;77;89;12;0,558823529411765;0,647058823529412
"4030";3744;138;4030;6;101;118;17;0,735294117647059;0,852941176470588
"4031";3744;138;4031;6;101;122;21;0,735294117647059;0,882352941176471
"4032";3744;138;4032;6;101;126;25;0,735294117647059;0,911764705882353
"4033";3744;138;4033;6;105;126;21;0,764705882352941;0,911764705882353
"4034";3744;138;4034;6;105;130;25;0,764705882352941;0,941176470588235
"4035";3744;138;4035;6;28;52;24;0,205882352941176;0,382352941176471
"4036";3744;138;4036;6;97;109;12;0,705882352941177;0,794117647058823
"4037";3744;138;4037;6;7;19;12;0,0588235294117647;0,147058823529412
"4038";3744;138;4038;6;11;28;17;0,0882352941176471;0,205882352941176
"4039";3744;138;4039;6;93;109;16;0,676470588235294;0,794117647058823
"4040";3744;138;4040;6;126;138;12;0,911764705882353;1
"4041";3744;138;4041;6;28;56;28;0,205882352941176;0,411764705882353
"4042";3744;138;4042;6;101;130;29;0,735294117647059;0,941176470588235
"4043";3744;138;4043;6;89;105;16;0,647058823529412;0,764705882352941
"4044";3744;138;4044;6;56;68;12;0,411764705882353;0,5
"4045";3744;138;4045;6;19;48;29;0,147058823529412;0,352941176470588
"4046";3744;138;4046;6;93;113;20;0,676470588235294;0,823529411764706
"4047";3744;138;4047;6;73;85;12;0,529411764705882;0,617647058823529
"4048";3744;138;4048;6;64;77;13;0,470588235294118;0,558823529411765
"4049";3744;138;4049;6;68;81;13;0,5;0,588235294117647
"4050";3744;138;4050;6;97;113;16;0,705882352941177;0,823529411764706
"4051";3744;138;4051;6;85;97;12;0,617647058823529;0,705882352941177
"4052";3744;138;4052;6;122;134;12;0,882352941176471;0,970588235294118
"4053";3923;70;4053;4;43;70;27;0,625;1
"4054";3923;70;4054;5;53;66;13;0,764705882352941;0,941176470588235
"4055";3923;70;4055;5;53;70;17;0,764705882352941;1
"4056";3923;70;4056;5;57;70;13;0,823529411764706;1
"4057";3923;70;4057;5;12;24;12;0,176470588235294;0,352941176470588
"4058";3923;70;4058;5;12;28;16;0,176470588235294;0,411764705882353
"4059";3923;70;4059;5;16;28;12;0,235294117647059;0,411764705882353
"4060";3923;70;4060;5;7;20;13;0,117647058823529;0,294117647058824
"4061";3923;70;4061;5;32;45;13;0,470588235294118;0,647058823529412
"4062";3923;70;4062;5;28;41;13;0,411764705882353;0,588235294117647
"4063";3923;70;4063;5;49;62;13;0,705882352941177;0,882352941176471
"4064";3923;70;4064;5;49;66;17;0,705882352941177;0,941176470588235
"4065";3923;70;4065;5;49;70;21;0,705882352941177;1
"4066";3923;70;4066;5;7;24;17;0,117647058823529;0,352941176470588
"4067";3923;70;4067;6;5;11;6;0,0857142857142857;0,171428571428571
"4068";3923;70;4068;6;36;42;6;0,514285714285714;0,6
"4069";3923;70;4069;6;50;56;6;0,714285714285714;0,8
"4070";3923;70;4070;6;50;58;8;0,714285714285714;0,828571428571429
"4071";3923;70;4071;6;52;58;6;0,742857142857143;0,828571428571429
"4072";3923;70;4072;6;52;60;8;0,742857142857143;0,857142857142857
"4073";3923;70;4073;6;54;60;6;0,771428571428571;0,857142857142857
"4074";3923;70;4074;6;54;62;8;0,771428571428571;0,885714285714286
"4075";3923;70;4075;6;56;62;6;0,8;0,885714285714286
"4076";3923;70;4076;6;58;64;6;0,828571428571429;0,914285714285714
"4077";3923;70;4077;6;62;68;6;0,885714285714286;0,971428571428571
"4078";3923;70;4078;6;62;70;8;0,885714285714286;1
"4079";3923;70;4079;6;64;70;6;0,914285714285714;1
"4080";3923;70;4080;6;13;19;6;0,2;0,285714285714286
"4081";3923;70;4081;6;33;40;7;0,485714285714286;0,571428571428571
"4082";3923;70;4082;6;36;44;8;0,514285714285714;0,628571428571429
"4083";3923;70;4083;6;38;44;6;0,542857142857143;0,628571428571429
"4084";3923;70;4084;6;50;60;10;0,714285714285714;0,857142857142857
"4085";3923;70;4085;6;50;62;12;0,714285714285714;0,885714285714286
"4086";3923;70;4086;6;50;64;14;0,714285714285714;0,914285714285714
"4087";3923;70;4087;6;50;66;16;0,714285714285714;0,942857142857143
"4088";3923;70;4088;6;50;68;18;0,714285714285714;0,971428571428571
"4089";3923;70;4089;6;54;64;10;0,771428571428571;0,914285714285714
"4090";3923;70;4090;6;54;66;12;0,771428571428571;0,942857142857143
"4091";3923;70;4091;6;54;68;14;0,771428571428571;0,971428571428571
"4092";3923;70;4092;6;56;64;8;0,8;0,914285714285714
"4093";3923;70;4093;6;56;66;10;0,8;0,942857142857143
"4094";3923;70;4094;6;56;68;12;0,8;0,971428571428571
"4095";3923;70;4095;6;58;66;8;0,828571428571429;0,942857142857143
"4096";3923;70;4096;6;58;68;10;0,828571428571429;0,971428571428571
"4097";3923;70;4097;6;60;66;6;0,857142857142857;0,942857142857143
"4098";3923;70;4098;6;60;68;8;0,857142857142857;0,971428571428571
"4099";3923;70;4099;6;3;9;6;0,0571428571428571;0,142857142857143
"4100";3923;70;4100;6;11;17;6;0,171428571428571;0,257142857142857
"4101";3923;70;4101;6;29;36;7;0,428571428571429;0,514285714285714
"4102";3923;70;4102;6;52;62;10;0,742857142857143;0,885714285714286
"4103";3923;70;4103;6;48;54;6;0,685714285714286;0,771428571428571
"4104";3923;70;4104;6;60;70;10;0,857142857142857;1
"4105";3923;70;4105;6;15;21;6;0,228571428571429;0,314285714285714
"4106";3923;70;4106;6;40;46;6;0,571428571428571;0,657142857142857
"4107";3923;70;4107;6;58;70;12;0,828571428571429;1
"4108";3923;70;4108;6;31;38;7;0,457142857142857;0,542857142857143
"4109";3923;70;4109;6;42;48;6;0,6;0,685714285714286
"4110";3923;70;4110;6;9;15;6;0,142857142857143;0,228571428571429
"4111";3923;70;4111;6;33;42;9;0,485714285714286;0,6
"4112";3923;70;4112;6;36;46;10;0,514285714285714;0,657142857142857
"4113";3923;70;4113;6;11;19;8;0,171428571428571;0,285714285714286
"4114";3923;70;4114;6;52;64;12;0,742857142857143;0,914285714285714
"4115";3923;70;4115;6;52;66;14;0,742857142857143;0,942857142857143
"4116";3923;70;4116;6;52;68;16;0,742857142857143;0,971428571428571
"4117";3923;70;4117;6;52;70;18;0,742857142857143;1
"4118";3923;70;4118;6;56;70;14;0,8;1
"4119";3923;70;4119;6;29;38;9;0,428571428571429;0,542857142857143
"4120";3923;70;4120;6;31;40;9;0,457142857142857;0,571428571428571
"4121";3923;70;4121;6;54;70;16;0,771428571428571;1
"4122";3923;70;4122;6;17;23;6;0,257142857142857;0,342857142857143
"4123";3923;70;4123;6;33;44;11;0,485714285714286;0,628571428571429
"4124";3923;70;4124;6;5;13;8;0,0857142857142857;0,2
"4125";3923;70;4125;6;13;21;8;0,2;0,314285714285714
"4126";3923;70;4126;6;23;29;6;0,342857142857143;0,428571428571429
"4127";3923;70;4127;6;19;25;6;0,285714285714286;0,371428571428571
"4128";3923;70;4128;6;38;46;8;0,542857142857143;0,657142857142857
"4129";3923;70;4129;6;19;27;8;0,285714285714286;0,4
"4130";3923;70;4130;6;50;70;20;0,714285714285714;1
"4131";3923;70;4131;6;21;27;6;0,314285714285714;0,4
"4132";3923;70;4132;6;9;17;8;0,142857142857143;0,257142857142857
"4133";3923;70;4133;6;29;40;11;0,428571428571429;0,571428571428571
"4134";3923;70;4134;6;3;11;8;0,0571428571428571;0,171428571428571
"4135";4007;132;4135;4;66;115;49;0,5;0,875
"4136";4007;132;4136;4;82;132;50;0,625;1
"4137";4007;132;4137;4;49;99;50;0,375;0,75
"4138";4007;132;4138;5;74;99;25;0,5625;0,75
"4139";4007;132;4139;5;82;107;25;0,625;0,8125
"4140";4007;132;4140;5;107;132;25;0,8125;1
"4141";4007;132;4141;5;90;115;25;0,6875;0,875
"4142";4007;132;4142;5;99;124;25;0,75;0,9375
"4143";4007;132;4143;5;99;132;33;0,75;1
"4144";4007;132;4144;5;66;90;24;0,5;0,6875
"4145";4007;132;4145;5;82;115;33;0,625;0,875
"4146";4007;132;4146;5;90;124;34;0,6875;0,9375
"4147";4007;132;4147;6;39;51;12;0,303030303030303;0,393939393939394
"4148";4007;132;4148;6;84;96;12;0,636363636363636;0,727272727272727
"4149";4007;132;4149;6;88;100;12;0,666666666666667;0,757575757575758
"4150";4007;132;4150;6;92;104;12;0,696969696969697;0,787878787878788
"4151";4007;132;4151;6;112;124;12;0,848484848484849;0,939393939393939
"4152";4007;132;4152;6;112;128;16;0,848484848484849;0,96969696969697
"4153";4007;132;4153;6;116;128;12;0,878787878787879;0,96969696969697
"4154";4007;132;4154;6;51;63;12;0,393939393939394;0,484848484848485
"4155";4007;132;4155;6;63;76;13;0,484848484848485;0,575757575757576
"4156";4007;132;4156;6;88;104;16;0,666666666666667;0,787878787878788
"4157";4007;132;4157;6;88;108;20;0,666666666666667;0,818181818181818
"4158";4007;132;4158;6;92;108;16;0,696969696969697;0,818181818181818
"4159";4007;132;4159;6;96;108;12;0,727272727272727;0,818181818181818
"4160";4007;132;4160;6;100;112;12;0,757575757575758;0,848484848484849
"4161";4007;132;4161;6;112;132;20;0,848484848484849;1
"4162";4007;132;4162;6;116;132;16;0,878787878787879;1
"4163";4007;132;4163;6;120;132;12;0,909090909090909;1
"4164";4007;132;4164;6;23;35;12;0,181818181818182;0,272727272727273
"4165";4007;132;4165;6;76;88;12;0,575757575757576;0,666666666666667
"4166";4007;132;4166;6;80;92;12;0,606060606060606;0,696969696969697
"4167";4007;132;4167;6;80;96;16;0,606060606060606;0,727272727272727
"4168";4007;132;4168;6;84;100;16;0,636363636363636;0,757575757575758
"4169";4007;132;4169;6;96;112;16;0,727272727272727;0,848484848484849
"4170";4007;132;4170;6;100;116;16;0,757575757575758;0,878787878787879
"4171";4007;132;4171;6;108;120;12;0,818181818181818;0,909090909090909
"4172";4007;132;4172;6;92;112;20;0,696969696969697;0,848484848484849
"4173";4007;132;4173;6;108;124;16;0,818181818181818;0,939393939393939
"4174";4007;132;4174;6;108;128;20;0,818181818181818;0,96969696969697
"4175";4007;132;4175;6;84;104;20;0,636363636363636;0,787878787878788
"4176";4007;132;4176;6;19;31;12;0,151515151515152;0,242424242424242
"4177";4007;132;4177;6;68;80;12;0,515151515151515;0,606060606060606
"4178";4007;132;4178;6;72;84;12;0,545454545454545;0,636363636363636
"4179";4007;132;4179;6;104;116;12;0,787878787878788;0,878787878787879
"4180";4007;132;4180;6;15;27;12;0,121212121212121;0,212121212121212
"4181";4007;132;4181;6;88;112;24;0,666666666666667;0,848484848484849
"4182";4007;132;4182;6;11;23;12;0,0909090909090909;0,181818181818182
"4183";4007;132;4183;6;72;88;16;0,545454545454545;0,666666666666667
"4184";4007;132;4184;6;108;132;24;0,818181818181818;1
"4185";4007;132;4185;6;35;47;12;0,272727272727273;0,363636363636364
"4186";4007;132;4186;6;84;108;24;0,636363636363636;0,818181818181818
"4187";4021;100;4187;3;50;100;50;0,5;1
"4188";4021;100;4188;4;58;83;25;0,583333333333333;0,833333333333333
"4189";4021;100;4189;4;66;92;26;0,666666666666667;0,916666666666667
"4190";4021;100;4190;4;66;100;34;0,666666666666667;1
"4191";4021;100;4191;4;7;33;26;0,0833333333333333;0,333333333333333
"4192";4021;100;4192;4;75;100;25;0,75;1
"4193";4021;100;4193;5;64;76;12;0,64;0,76
"4194";4021;100;4194;5;11;23;12;0,12;0,24
"4195";4021;100;4195;5;35;47;12;0,36;0,48
"4196";4021;100;4196;5;39;52;13;0,4;0,52
"4197";4021;100;4197;5;64;80;16;0,64;0,8
"4198";4021;100;4198;5;68;80;12;0,68;0,8
"4199";4021;100;4199;5;68;84;16;0,68;0,84
"4200";4021;100;4200;5;68;88;20;0,68;0,88
"4201";4021;100;4201;5;72;84;12;0,72;0,84
"4202";4021;100;4202;5;72;88;16;0,72;0,88
"4203";4021;100;4203;5;76;88;12;0,76;0,88
"4204";4021;100;4204;5;88;100;12;0,88;1
"4205";4021;100;4205;5;7;19;12;0,08;0,2
"4206";4021;100;4206;5;64;84;20;0,64;0,84
"4207";4021;100;4207;5;76;92;16;0,76;0,92
"4208";4021;100;4208;5;64;88;24;0,64;0,88
"4209";4021;100;4209;5;60;72;12;0,6;0,72
"4210";4021;100;4210;5;84;96;12;0,84;0,96
"4211";4021;100;4211;5;84;100;16;0,84;1
"4212";4021;100;4212;5;60;76;16;0,6;0,76
"4213";4021;100;4213;5;15;27;12;0,16;0,28
"4214";4021;100;4214;5;80;92;12;0,8;0,92
"4215";4021;100;4215;6;62;68;6;0,62;0,68
"4216";4021;100;4216;6;82;88;6;0,82;0,88
"4217";4021;100;4217;6;3;9;6;0,04;0,1
"4218";4021;100;4218;6;15;21;6;0,16;0,22
"4219";4021;100;4219;6;25;31;6;0,26;0,32
"4220";4021;100;4220;6;35;41;6;0,36;0,42
"4221";4021;100;4221;6;39;45;6;0,4;0,46
"4222";4021;100;4222;6;41;47;6;0,42;0,48
"4223";4021;100;4223;6;60;66;6;0,6;0,66
"4224";4021;100;4224;6;66;72;6;0,66;0,72
"4225";4021;100;4225;6;68;74;6;0,68;0,74
"4226";4021;100;4226;6;68;76;8;0,68;0,76
"4227";4021;100;4227;6;74;80;6;0,74;0,8
"4228";4021;100;4228;6;74;82;8;0,74;0,82
"4229";4021;100;4229;6;76;82;6;0,76;0,82
"4230";4021;100;4230;6;78;84;6;0,78;0,84
"4231";4021;100;4231;6;78;86;8;0,78;0,86
"4232";4021;100;4232;6;78;88;10;0,78;0,88
"4233";4021;100;4233;6;90;96;6;0,9;0,96
"4234";4021;100;4234;6;92;98;6;0,92;0,98
"4235";4021;100;4235;6;92;100;8;0,92;1
"4236";4021;100;4236;6;15;23;8;0,16;0,24
"4237";4021;100;4237;6;25;33;8;0,26;0,34
"4238";4021;100;4238;6;37;43;6;0,38;0,44
"4239";4021;100;4239;6;37;45;8;0,38;0,46
"4240";4021;100;4240;6;37;47;10;0,38;0,48
"4241";4021;100;4241;6;37;50;13;0,38;0,5
"4242";4021;100;4242;6;39;47;8;0,4;0,48
"4243";4021;100;4243;6;39;50;11;0,4;0,5
"4244";4021;100;4244;6;41;50;9;0,42;0,5
"4245";4021;100;4245;6;43;50;7;0,44;0,5
"4246";4021;100;4246;6;62;70;8;0,62;0,7
"4247";4021;100;4247;6;62;72;10;0,62;0,72
"4248";4021;100;4248;6;64;70;6;0,64;0,7
"4249";4021;100;4249;6;64;72;8;0,64;0,72
"4250";4021;100;4250;6;64;74;10;0,64;0,74
"4251";4021;100;4251;6;66;74;8;0,66;0,74
"4252";4021;100;4252;6;68;78;10;0,68;0,78
"4253";4021;100;4253;6;76;84;8;0,76;0,84
"4254";4021;100;4254;6;76;86;10;0,76;0,86
"4255";4021;100;4255;6;80;86;6;0,8;0,86
"4256";4021;100;4256;6;80;88;8;0,8;0,88
"4257";4021;100;4257;6;88;94;6;0,88;0,94
"4258";4021;100;4258;6;84;90;6;0,84;0,9
"4259";4021;100;4259;6;90;98;8;0,9;0,98
"4260";4021;100;4260;6;19;25;6;0,2;0,26
"4261";4021;100;4261;6;50;56;6;0,5;0,56
"4262";4021;100;4262;6;90;100;10;0,9;1
"4263";4021;100;4263;6;66;76;10;0,66;0,76
"4264";4021;100;4264;6;5;11;6;0,06;0,12
"4265";4021;100;4265;6;17;23;6;0,18;0,24
"4266";4021;100;4266;6;64;76;12;0,64;0,76
"4267";4021;100;4267;6;64;78;14;0,64;0,78
"4268";4021;100;4268;6;64;80;16;0,64;0,8
"4269";4021;100;4269;6;72;78;6;0,72;0,78
"4270";4021;100;4270;6;72;80;8;0,72;0,8
"4271";4021;100;4271;6;72;82;10;0,72;0,82
"4272";4021;100;4272;6;64;82;18;0,64;0,82
"4273";4021;100;4273;6;64;84;20;0,64;0,84
"4274";4021;100;4274;6;64;86;22;0,64;0,86
"4275";4021;100;4275;6;64;88;24;0,64;0,88
"4276";4021;100;4276;6;68;80;12;0,68;0,8
"4277";4021;100;4277;6;72;84;12;0,72;0,84
"4278";4021;100;4278;6;72;86;14;0,72;0,86
"4279";4021;100;4279;6;72;88;16;0,72;0,88
"4280";4021;100;4280;6;74;84;10;0,74;0,84
"4281";4021;100;4281;6;74;86;12;0,74;0,86
"4282";4021;100;4282;6;74;88;14;0,74;0,88
"4283";4021;100;4283;6;76;88;12;0,76;0,88
"4284";4021;100;4284;6;82;90;8;0,82;0,9
"4285";4021;100;4285;6;88;96;8;0,88;0,96
"4286";4021;100;4286;6;88;98;10;0,88;0,98
"4287";4021;100;4287;6;62;74;12;0,62;0,74
"4288";4021;100;4288;6;62;76;14;0,62;0,76
"4289";4021;100;4289;6;88;100;12;0,88;1
"4290";4021;100;4290;6;23;29;6;0,24;0,3
"4291";4021;100;4291;6;86;92;6;0,86;0,92
"4292";4021;100;4292;6;86;94;8;0,86;0,94
"4293";4021;100;4293;6;86;96;10;0,86;0,96
"4294";4021;100;4294;6;66;78;12;0,66;0,78
"4295";4021;100;4295;6;66;80;14;0,66;0,8
"4296";4021;100;4296;6;66;82;16;0,66;0,82
"4297";4021;100;4297;6;66;84;18;0,66;0,84
"4298";4021;100;4298;6;11;17;6;0,12;0,18
"4299";4021;100;4299;6;21;27;6;0,22;0,28
"4300";4021;100;4300;6;62;78;16;0,62;0,78
"4301";4021;100;4301;6;68;82;14;0,68;0,82
"4302";4021;100;4302;6;68;84;16;0,68;0,84
"4303";4021;100;4303;6;68;86;18;0,68;0,86
"4304";4021;100;4304;6;60;68;8;0,6;0,68
"4305";4021;100;4305;6;56;62;6;0,56;0,62
"4306";4021;100;4306;6;58;64;6;0,58;0,64
"4307";4021;100;4307;6;15;25;10;0,16;0,26
"4308";4021;100;4308;6;60;70;10;0,6;0,7
"4309";4021;100;4309;6;60;72;12;0,6;0,72
"4310";4021;100;4310;6;60;74;14;0,6;0,74
"4311";4021;100;4311;6;60;76;16;0,6;0,76
"4312";4021;100;4312;6;23;31;8;0,24;0,32
"4313";4021;100;4313;6;62;80;18;0,62;0,8
"4314";4059;143;4314;3;35;143;108;0,25;1
"4315";4059;143;4315;4;79;127;48;0,555555555555556;0,888888888888889
"4316";4059;143;4316;4;95;143;48;0,666666666666667;1
"4317";4059;143;4317;4;79;143;64;0,555555555555556;1
"4318";4059;143;4318;4;63;111;48;0,444444444444444;0,777777777777778
"4319";4059;143;4319;5;87;111;24;0,611111111111111;0,777777777777778
"4320";4059;143;4320;5;87;119;32;0,611111111111111;0,833333333333333
"4321";4059;143;4321;5;79;103;24;0,555555555555556;0,722222222222222
"4322";4059;143;4322;5;119;143;24;0,833333333333333;1
"4323";4059;143;4323;5;63;87;24;0,444444444444444;0,611111111111111
"4324";4059;143;4324;5;71;95;24;0,5;0,666666666666667
"4325";4059;143;4325;5;103;127;24;0,722222222222222;0,888888888888889
"4326";4059;143;4326;5;111;135;24;0,777777777777778;0,944444444444444
"4327";4059;143;4327;5;71;103;32;0,5;0,722222222222222
"4328";4059;143;4328;5;95;119;24;0,666666666666667;0,833333333333333
"4329";4059;143;4329;5;79;111;32;0,555555555555556;0,777777777777778
"4330";4059;143;4330;6;87;99;12;0,611111111111111;0,694444444444444
"4331";4059;143;4331;6;91;103;12;0,638888888888889;0,722222222222222
"4332";4059;143;4332;6;67;79;12;0,472222222222222;0,555555555555556
"4333";4059;143;4333;6;67;83;16;0,472222222222222;0,583333333333333
"4334";4059;143;4334;6;59;71;12;0,416666666666667;0,5
"4335";4059;143;4335;6;71;83;12;0,5;0,583333333333333
"4336";4059;143;4336;6;83;95;12;0,583333333333333;0,666666666666667
"4337";4059;143;4337;6;83;99;16;0,583333333333333;0,694444444444444
"4338";4059;143;4338;6;87;103;16;0,611111111111111;0,722222222222222
"4339";4059;143;4339;6;99;111;12;0,694444444444444;0,777777777777778
"4340";4059;143;4340;6;131;143;12;0,916666666666667;1
"4341";4059;143;4341;6;75;87;12;0,527777777777778;0,611111111111111
"4342";4059;143;4342;6;95;107;12;0,666666666666667;0,75
"4343";4059;143;4343;6;83;103;20;0,583333333333333;0,722222222222222
"4344";4059;143;4344;6;87;107;20;0,611111111111111;0,75
"4345";4059;143;4345;6;123;135;12;0,861111111111111;0,944444444444444
"4346";4059;143;4346;6;123;139;16;0,861111111111111;0,972222222222222
"4347";4059;143;4347;6;123;143;20;0,861111111111111;1
"4348";4059;143;4348;6;115;127;12;0,805555555555556;0,888888888888889
"4349";4059;143;4349;6;115;131;16;0,805555555555556;0,916666666666667
"4350";4059;143;4350;6;119;131;12;0,833333333333333;0,916666666666667
"4351";4059;143;4351;6;119;135;16;0,833333333333333;0,944444444444444
"4352";4059;143;4352;6;119;139;20;0,833333333333333;0,972222222222222
"4353";4059;143;4353;6;119;143;24;0,833333333333333;1
"4354";4059;143;4354;6;103;115;12;0,722222222222222;0,805555555555556
"4355";4059;143;4355;6;115;135;20;0,805555555555556;0,944444444444444
"4356";4059;143;4356;6;115;139;24;0,805555555555556;0,972222222222222
"4357";4059;143;4357;6;115;143;28;0,805555555555556;1
"4358";4059;143;4358;6;107;119;12;0,75;0,833333333333333
"4359";4059;143;4359;6;63;75;12;0,444444444444444;0,527777777777778
"4360";4059;143;4360;6;63;79;16;0,444444444444444;0,555555555555556
"4361";4059;143;4361;6;63;83;20;0,444444444444444;0,583333333333333
"4362";4059;143;4362;6;79;91;12;0,555555555555556;0,638888888888889
"4363";4059;143;4363;6;59;75;16;0,416666666666667;0,527777777777778
"4364";4059;143;4364;6;91;107;16;0,638888888888889;0,75
"4365";4059;143;4365;6;127;139;12;0,888888888888889;0,972222222222222
"4366";4059;143;4366;6;127;143;16;0,888888888888889;1
"4367";4137;120;4367;3;51;103;52;0,428571428571429;0,857142857142857
"4368";4137;120;4368;3;34;85;51;0,285714285714286;0,714285714285714
"4369";4137;120;4369;3;68;120;52;0,571428571428571;1
"4370";4137;120;4370;4;47;72;25;0,4;0,6
"4371";4137;120;4371;4;39;64;25;0,333333333333333;0,533333333333333
"4372";4137;120;4372;4;55;80;25;0,466666666666667;0,666666666666667
"4373";4137;120;4373;4;72;96;24;0,6;0,8
"4374";4137;120;4374;4;31;55;24;0,266666666666667;0,466666666666667
"4375";4137;120;4375;4;80;104;24;0,666666666666667;0,866666666666667
"4376";4137;120;4376;4;96;120;24;0,8;1
"4377";4137;120;4377;4;64;88;24;0,533333333333333;0,733333333333333
"4378";4137;120;4378;4;88;112;24;0,733333333333333;0,933333333333333
"4379";4137;120;4379;4;64;96;32;0,533333333333333;0,8
"4380";4137;120;4380;5;27;39;12;0,233333333333333;0,333333333333333
"4381";4137;120;4381;5;72;84;12;0,6;0,7
"4382";4137;120;4382;5;51;64;13;0,433333333333333;0,533333333333333
"4383";4137;120;4383;5;55;68;13;0,466666666666667;0,566666666666667
"4384";4137;120;4384;5;64;76;12;0,533333333333333;0,633333333333333
"4385";4137;120;4385;5;68;80;12;0,566666666666667;0,666666666666667
"4386";4137;120;4386;5;72;88;16;0,6;0,733333333333333
"4387";4137;120;4387;5;76;88;12;0,633333333333333;0,733333333333333
"4388";4137;120;4388;5;84;96;12;0,7;0,8
"4389";4137;120;4389;5;108;120;12;0,9;1
"4390";4137;120;4390;5;35;47;12;0,3;0,4
"4391";4137;120;4391;5;43;55;12;0,366666666666667;0,466666666666667
"4392";4137;120;4392;5;96;108;12;0,8;0,9
"4393";4137;120;4393;5;31;43;12;0,266666666666667;0,366666666666667
"4394";4137;120;4394;5;104;116;12;0,866666666666667;0,966666666666667
"4395";4137;120;4395;5;104;120;16;0,866666666666667;1
"4396";4137;120;4396;5;60;72;12;0,5;0,6
"4397";4137;120;4397;5;88;100;12;0,733333333333333;0,833333333333333
"4398";4137;120;4398;5;64;80;16;0,533333333333333;0,666666666666667
"4399";4137;120;4399;5;80;92;12;0,666666666666667;0,766666666666667
"4400";4137;120;4400;5;7;19;12;0,0666666666666667;0,166666666666667
"4401";4137;120;4401;5;47;60;13;0,4;0,5
"4402";4137;120;4402;5;92;104;12;0,766666666666667;0,866666666666667
"4403";4137;120;4403;5;39;51;12;0,333333333333333;0,433333333333333
"4404";4137;120;4404;5;68;84;16;0,566666666666667;0,7
"4405";4137;120;4405;5;100;112;12;0,833333333333333;0,933333333333333
"4406";4137;120;4406;5;84;100;16;0,7;0,833333333333333
"4407";4137;120;4407;5;80;96;16;0,666666666666667;0,8
"4408";4137;120;4408;6;13;19;6;0,116666666666667;0,166666666666667
"4409";4137;120;4409;6;47;53;6;0,4;0,45
"4410";4137;120;4410;6;78;84;6;0,65;0,7
"4411";4137;120;4411;6;100;106;6;0,833333333333333;0,883333333333333
"4412";4137;120;4412;6;9;15;6;0,0833333333333333;0,133333333333333
"4413";4137;120;4413;6;35;41;6;0,3;0,35
"4414";4137;120;4414;6;39;45;6;0,333333333333333;0,383333333333333
"4415";4137;120;4415;6;39;47;8;0,333333333333333;0,4
"4416";4137;120;4416;6;49;55;6;0,416666666666667;0,466666666666667
"4417";4137;120;4417;6;53;60;7;0,45;0,5
"4418";4137;120;4418;6;82;88;6;0,683333333333333;0,733333333333333
"4419";4137;120;4419;6;86;92;6;0,716666666666667;0,766666666666667
"4420";4137;120;4420;6;90;96;6;0,75;0,8
"4421";4137;120;4421;6;96;102;6;0,8;0,85
"4422";4137;120;4422;6;98;104;6;0,816666666666667;0,866666666666667
"4423";4137;120;4423;6;108;114;6;0,9;0,95
"4424";4137;120;4424;6;112;118;6;0,933333333333333;0,983333333333333
"4425";4137;120;4425;6;5;11;6;0,05;0,1
"4426";4137;120;4426;6;37;43;6;0,316666666666667;0,366666666666667
"4427";4137;120;4427;6;41;47;6;0,35;0,4
"4428";4137;120;4428;6;43;49;6;0,366666666666667;0,416666666666667
"4429";4137;120;4429;6;51;57;6;0,433333333333333;0,483333333333333
"4430";4137;120;4430;6;53;62;9;0,45;0,516666666666667
"4431";4137;120;4431;6;55;62;7;0,466666666666667;0,516666666666667
"4432";4137;120;4432;6;57;64;7;0,483333333333333;0,533333333333333
"4433";4137;120;4433;6;66;72;6;0,55;0,6
"4434";4137;120;4434;6;68;74;6;0,566666666666667;0,616666666666667
"4435";4137;120;4435;6;70;76;6;0,583333333333333;0,633333333333333
"4436";4137;120;4436;6;74;80;6;0,616666666666667;0,666666666666667
"4437";4137;120;4437;6;76;82;6;0,633333333333333;0,683333333333333
"4438";4137;120;4438;6;78;86;8;0,65;0,716666666666667
"4439";4137;120;4439;6;80;86;6;0,666666666666667;0,716666666666667
"4440";4137;120;4440;6;110;116;6;0,916666666666667;0,966666666666667
"4441";4137;120;4441;6;64;70;6;0,533333333333333;0,583333333333333
"4442";4137;120;4442;6;72;78;6;0,6;0,65
"4443";4137;120;4443;6;72;80;8;0,6;0,666666666666667
"4444";4137;120;4444;6;96;104;8;0,8;0,866666666666667
"4445";4137;120;4445;6;96;106;10;0,8;0,883333333333333
"4446";4137;120;4446;6;29;35;6;0,25;0,3
"4447";4137;120;4447;6;64;72;8;0,533333333333333;0,6
"4448";4137;120;4448;6;66;74;8;0,55;0,616666666666667
"4449";4137;120;4449;6;76;84;8;0,633333333333333;0,7
"4450";4137;120;4450;6;88;94;6;0,733333333333333;0,783333333333333
"4451";4137;120;4451;6;110;118;8;0,916666666666667;0,983333333333333
"4452";4137;120;4452;6;110;120;10;0,916666666666667;1
"4453";4137;120;4453;6;114;120;6;0,95;1
"4454";4137;120;4454;6;27;33;6;0,233333333333333;0,283333333333333
"4455";4137;120;4455;6;55;64;9;0,466666666666667;0,533333333333333
"4456";4137;120;4456;6;70;78;8;0,583333333333333;0,65
"4457";4137;120;4457;6;70;80;10;0,583333333333333;0,666666666666667
"4458";4137;120;4458;6;72;82;10;0,6;0,683333333333333
"4459";4137;120;4459;6;72;84;12;0,6;0,7
"4460";4137;120;4460;6;74;82;8;0,616666666666667;0,683333333333333
"4461";4137;120;4461;6;94;100;6;0,783333333333333;0,833333333333333
"4462";4137;120;4462;6;98;106;8;0,816666666666667;0,883333333333333
"4463";4137;120;4463;6;108;116;8;0,9;0,966666666666667
"4464";4137;120;4464;6;108;118;10;0,9;0,983333333333333
"4465";4137;120;4465;6;112;120;8;0,933333333333333;1
"4466";4137;120;4466;6;102;108;6;0,85;0,9
"4467";4137;120;4467;6;106;112;6;0,883333333333333;0,933333333333333
"4468";4137;120;4468;6;106;114;8;0,883333333333333;0,95
"4469";4137;120;4469;6;7;13;6;0,0666666666666667;0,116666666666667
"4470";4137;120;4470;6;86;94;8;0,716666666666667;0,783333333333333
"4471";4137;120;4471;6;51;60;9;0,433333333333333;0,5
"4472";4137;120;4472;6;60;66;6;0,5;0,55
"4473";4137;120;4473;6;60;68;8;0,5;0,566666666666667
"4474";4137;120;4474;6;82;90;8;0,683333333333333;0,75
"4475";4137;120;4475;6;84;90;6;0,7;0,75
"4476";4137;120;4476;6;21;27;6;0,183333333333333;0,233333333333333
"4477";4137;120;4477;6;45;51;6;0,383333333333333;0,433333333333333
"4478";4137;120;4478;6;84;92;8;0,7;0,766666666666667
"4479";4137;120;4479;6;84;94;10;0,7;0,783333333333333
"4480";4137;120;4480;6;106;116;10;0,883333333333333;0,966666666666667
"4481";4137;120;4481;6;108;120;12;0,9;1
"4482";4137;120;4482;6;37;45;8;0,316666666666667;0,383333333333333
"4483";4137;120;4483;6;66;76;10;0,55;0,633333333333333
"4484";4137;120;4484;6;92;98;6;0,766666666666667;0,816666666666667
"4485";4137;120;4485;6;68;76;8;0,566666666666667;0,633333333333333
"4486";4137;120;4486;6;3;9;6;0,0333333333333333;0,0833333333333333
"4487";4137;120;4487;6;11;17;6;0,1;0,15
"4488";4137;120;4488;6;47;55;8;0,4;0,466666666666667
"4489";4137;120;4489;6;74;84;10;0,616666666666667;0,7
"4490";4137;120;4490;6;104;110;6;0,866666666666667;0,916666666666667
"4491";4137;120;4491;6;23;29;6;0,2;0,25
"4492";4137;120;4492;6;49;57;8;0,416666666666667;0,483333333333333
"4493";4137;120;4493;6;19;25;6;0,166666666666667;0,216666666666667
"4494";4137;120;4494;6;45;53;8;0,383333333333333;0,45
"4495";4137;120;4495;6;86;96;10;0,716666666666667;0,8
"4496";4137;120;4496;6;53;64;11;0,45;0,533333333333333
"4497";4137;120;4497;6;64;74;10;0,533333333333333;0,616666666666667
"4498";4137;120;4498;6;70;82;12;0,583333333333333;0,683333333333333
"4499";4137;120;4499;6;70;84;14;0,583333333333333;0,7
"4500";4137;120;4500;6;33;39;6;0,283333333333333;0,333333333333333
"4501";4137;120;4501;6;51;62;11;0,433333333333333;0,516666666666667
"4502";4137;120;4502;6;68;78;10;0,566666666666667;0,65
"4503";4137;120;4503;6;62;68;6;0,516666666666667;0,566666666666667
"4504";4137;120;4504;6;94;102;8;0,783333333333333;0,85
"4505";4137;120;4505;6;1;7;6;0,0166666666666667;0,0666666666666667
"4506";4137;120;4506;6;37;47;10;0,316666666666667;0,4
"4507";4137;120;4507;6;80;88;8;0,666666666666667;0,733333333333333
"4508";4137;120;4508;6;90;98;8;0,75;0,816666666666667
"4509";4137;120;4509;6;106;118;12;0,883333333333333;0,983333333333333
"4510";4325;123;4510;3;70;123;53;0,571428571428571;1
"4511";4325;123;4511;4;73;98;25;0,6;0,8
"4512";4325;123;4512;4;73;106;33;0,6;0,866666666666667
"4513";4325;123;4513;4;90;115;25;0,733333333333333;0,933333333333333
"4514";4325;123;4514;4;57;82;25;0,466666666666667;0,666666666666667
"4515";4325;123;4515;4;82;106;24;0,666666666666667;0,866666666666667
"4516";4325;123;4516;4;82;115;33;0,666666666666667;0,933333333333333
"4517";4325;123;4517;4;82;123;41;0,666666666666667;1
"4518";4325;123;4518;4;90;123;33;0,733333333333333;1
"4519";4325;123;4519;4;98;123;25;0,8;1
"4520";4325;123;4520;4;49;73;24;0,4;0,6
"4521";4325;123;4521;4;65;90;25;0,533333333333333;0,733333333333333
"4522";4325;123;4522;4;73;115;42;0,6;0,933333333333333
"4523";4325;123;4523;4;16;40;24;0,133333333333333;0,333333333333333
"4524";4325;123;4524;4;73;123;50;0,6;1
"4525";4325;123;4525;4;65;98;33;0,533333333333333;0,8
"4526";4325;123;4526;5;59;71;12;0,483870967741935;0,580645161290323
"4527";4325;123;4527;5;55;67;12;0,451612903225806;0,548387096774194
"4528";4325;123;4528;5;55;71;16;0,451612903225806;0,580645161290323
"4529";4325;123;4529;5;63;75;12;0,516129032258065;0,612903225806452
"4530";4325;123;4530;5;83;95;12;0,67741935483871;0,774193548387097
"4531";4325;123;4531;5;83;99;16;0,67741935483871;0,806451612903226
"4532";4325;123;4532;5;83;103;20;0,67741935483871;0,838709677419355
"4533";4325;123;4533;5;87;99;12;0,709677419354839;0,806451612903226
"4534";4325;123;4534;5;87;103;16;0,709677419354839;0,838709677419355
"4535";4325;123;4535;5;87;107;20;0,709677419354839;0,870967741935484
"4536";4325;123;4536;5;95;107;12;0,774193548387097;0,870967741935484
"4537";4325;123;4537;5;99;111;12;0,806451612903226;0,903225806451613
"4538";4325;123;4538;5;107;119;12;0,870967741935484;0,967741935483871
"4539";4325;123;4539;5;51;63;12;0,419354838709677;0,516129032258065
"4540";4325;123;4540;5;55;75;20;0,451612903225806;0,612903225806452
"4541";4325;123;4541;5;59;75;16;0,483870967741935;0,612903225806452
"4542";4325;123;4542;5;75;87;12;0,612903225806452;0,709677419354839
"4543";4325;123;4543;5;83;107;24;0,67741935483871;0,870967741935484
"4544";4325;123;4544;5;83;111;28;0,67741935483871;0,903225806451613
"4545";4325;123;4545;5;83;115;32;0,67741935483871;0,935483870967742
"4546";4325;123;4546;5;91;103;12;0,741935483870968;0,838709677419355
"4547";4325;123;4547;5;91;107;16;0,741935483870968;0,870967741935484
"4548";4325;123;4548;5;91;111;20;0,741935483870968;0,903225806451613
"4549";4325;123;4549;5;91;115;24;0,741935483870968;0,935483870967742
"4550";4325;123;4550;5;91;119;28;0,741935483870968;0,967741935483871
"4551";4325;123;4551;5;95;111;16;0,774193548387097;0,903225806451613
"4552";4325;123;4552;5;19;31;12;0,161290322580645;0,258064516129032
"4553";4325;123;4553;5;31;43;12;0,258064516129032;0,354838709677419
"4554";4325;123;4554;5;47;59;12;0,387096774193548;0,483870967741935
"4555";4325;123;4555;5;51;67;16;0,419354838709677;0,548387096774194
"4556";4325;123;4556;5;51;71;20;0,419354838709677;0,580645161290323
"4557";4325;123;4557;5;87;111;24;0,709677419354839;0,903225806451613
"4558";4325;123;4558;5;91;123;32;0,741935483870968;1
"4559";4325;123;4559;5;95;115;20;0,774193548387097;0,935483870967742
"4560";4325;123;4560;5;95;119;24;0,774193548387097;0,967741935483871
"4561";4325;123;4561;5;99;115;16;0,806451612903226;0,935483870967742
"4562";4325;123;4562;5;99;119;20;0,806451612903226;0,967741935483871
"4563";4325;123;4563;5;99;123;24;0,806451612903226;1
"4564";4325;123;4564;5;103;115;12;0,838709677419355;0,935483870967742
"4565";4325;123;4565;5;103;119;16;0,838709677419355;0,967741935483871
"4566";4325;123;4566;5;107;123;16;0,870967741935484;1
"4567";4325;123;4567;5;111;123;12;0,903225806451613;1
"4568";4325;123;4568;5;47;63;16;0,387096774193548;0,516129032258065
"4569";4325;123;4569;5;87;115;28;0,709677419354839;0,935483870967742
"4570";4325;123;4570;5;87;119;32;0,709677419354839;0,967741935483871
"4571";4325;123;4571;5;87;123;36;0,709677419354839;1
"4572";4325;123;4572;5;75;91;16;0,612903225806452;0,741935483870968
"4573";4325;123;4573;5;75;95;20;0,612903225806452;0,774193548387097
"4574";4325;123;4574;5;83;119;36;0,67741935483871;0,967741935483871
"4575";4325;123;4575;5;83;123;40;0,67741935483871;1
"4576";4325;123;4576;5;95;123;28;0,774193548387097;1
"4577";4325;123;4577;5;71;83;12;0,580645161290323;0,67741935483871
"4578";4325;123;4578;5;71;87;16;0,580645161290323;0,709677419354839
"4579";4325;123;4579;5;51;75;24;0,419354838709677;0,612903225806452
"4580";4325;123;4580;5;43;55;12;0,354838709677419;0,451612903225806
"4581";4325;123;4581;5;15;27;12;0,129032258064516;0,225806451612903
"4582";4325;123;4582;5;47;67;20;0,387096774193548;0,548387096774194
"4583";4325;123;4583;5;47;71;24;0,387096774193548;0,580645161290323
"4584";4325;123;4584;5;27;39;12;0,225806451612903;0,32258064516129
"4585";4325;123;4585;5;27;43;16;0,225806451612903;0,354838709677419
"4586";4325;123;4586;5;43;59;16;0,354838709677419;0,483870967741935
"4587";4325;123;4587;6;33;39;6;0,274193548387097;0,32258064516129
"4588";4325;123;4588;6;21;27;6;0,17741935483871;0,225806451612903
"4589";4325;123;4589;6;21;29;8;0,17741935483871;0,241935483870968
"4590";4325;123;4590;6;33;41;8;0,274193548387097;0,338709677419355
"4591";4325;123;4591;6;33;43;10;0,274193548387097;0,354838709677419
"4592";4325;123;4592;6;35;41;6;0,290322580645161;0,338709677419355
"4593";4325;123;4593;6;35;43;8;0,290322580645161;0,354838709677419
"4594";4325;123;4594;6;47;53;6;0,387096774193548;0,435483870967742
"4595";4325;123;4595;6;61;67;6;0,5;0,548387096774194
"4596";4325;123;4596;6;61;69;8;0,5;0,564516129032258
"4597";4325;123;4597;6;67;73;6;0,548387096774194;0,596774193548387
"4598";4325;123;4598;6;83;89;6;0,67741935483871;0,725806451612903
"4599";4325;123;4599;6;83;91;8;0,67741935483871;0,741935483870968
"4600";4325;123;4600;6;87;93;6;0,709677419354839;0,758064516129032
"4601";4325;123;4601;6;91;97;6;0,741935483870968;0,790322580645161
"4602";4325;123;4602;6;91;99;8;0,741935483870968;0,806451612903226
"4603";4325;123;4603;6;97;103;6;0,790322580645161;0,838709677419355
"4604";4325;123;4604;6;105;111;6;0,854838709677419;0,903225806451613
"4605";4325;123;4605;6;105;113;8;0,854838709677419;0,919354838709677
"4606";4325;123;4606;6;109;115;6;0,887096774193548;0,935483870967742
"4607";4325;123;4607;6;111;117;6;0,903225806451613;0,951612903225806
"4608";4325;123;4608;6;9;15;6;0,0806451612903226;0,129032258064516
"4609";4325;123;4609;6;23;29;6;0,193548387096774;0,241935483870968
"4610";4325;123;4610;6;31;37;6;0,258064516129032;0,306451612903226
"4611";4325;123;4611;6;33;45;12;0,274193548387097;0,370967741935484
"4612";4325;123;4612;6;35;45;10;0,290322580645161;0,370967741935484
"4613";4325;123;4613;6;39;45;6;0,32258064516129;0,370967741935484
"4614";4325;123;4614;6;45;51;6;0,370967741935484;0,419354838709677
"4615";4325;123;4615;6;47;55;8;0,387096774193548;0,451612903225806
"4616";4325;123;4616;6;47;57;10;0,387096774193548;0,467741935483871
"4617";4325;123;4617;6;49;55;6;0,403225806451613;0,451612903225806
"4618";4325;123;4618;6;49;57;8;0,403225806451613;0,467741935483871
"4619";4325;123;4619;6;51;57;6;0,419354838709677;0,467741935483871
"4620";4325;123;4620;6;51;59;8;0,419354838709677;0,483870967741935
"4621";4325;123;4621;6;51;61;10;0,419354838709677;0,5
"4622";4325;123;4622;6;53;59;6;0,435483870967742;0,483870967741935
"4623";4325;123;4623;6;53;61;8;0,435483870967742;0,5
"4624";4325;123;4624;6;55;61;6;0,451612903225806;0,5
"4625";4325;123;4625;6;55;63;8;0,451612903225806;0,516129032258065
"4626";4325;123;4626;6;55;65;10;0,451612903225806;0,532258064516129
"4627";4325;123;4627;6;57;63;6;0,467741935483871;0,516129032258065
"4628";4325;123;4628;6;57;65;8;0,467741935483871;0,532258064516129
"4629";4325;123;4629;6;57;67;10;0,467741935483871;0,548387096774194
"4630";4325;123;4630;6;59;65;6;0,483870967741935;0,532258064516129
"4631";4325;123;4631;6;59;67;8;0,483870967741935;0,548387096774194
"4632";4325;123;4632;6;59;69;10;0,483870967741935;0,564516129032258
"4633";4325;123;4633;6;61;71;10;0,5;0,580645161290323
"4634";4325;123;4634;6;61;73;12;0,5;0,596774193548387
"4635";4325;123;4635;6;63;69;6;0,516129032258065;0,564516129032258
"4636";4325;123;4636;6;63;71;8;0,516129032258065;0,580645161290323
"4637";4325;123;4637;6;63;73;10;0,516129032258065;0,596774193548387
"4638";4325;123;4638;6;65;71;6;0,532258064516129;0,580645161290323
"4639";4325;123;4639;6;65;73;8;0,532258064516129;0,596774193548387
"4640";4325;123;4640;6;75;81;6;0,612903225806452;0,661290322580645
"4641";4325;123;4641;6;79;85;6;0,645161290322581;0,693548387096774
"4642";4325;123;4642;6;85;91;6;0,693548387096774;0,741935483870968
"4643";4325;123;4643;6;87;95;8;0,709677419354839;0,774193548387097
"4644";4325;123;4644;6;87;97;10;0,709677419354839;0,790322580645161
"4645";4325;123;4645;6;87;99;12;0,709677419354839;0,806451612903226
"4646";4325;123;4646;6;91;101;10;0,741935483870968;0,82258064516129
"4647";4325;123;4647;6;91;103;12;0,741935483870968;0,838709677419355
"4648";4325;123;4648;6;91;105;14;0,741935483870968;0,854838709677419
"4649";4325;123;4649;6;93;99;6;0,758064516129032;0,806451612903226
"4650";4325;123;4650;6;93;101;8;0,758064516129032;0,82258064516129
"4651";4325;123;4651;6;93;103;10;0,758064516129032;0,838709677419355
"4652";4325;123;4652;6;95;101;6;0,774193548387097;0,82258064516129
"4653";4325;123;4653;6;95;103;8;0,774193548387097;0,838709677419355
"4654";4325;123;4654;6;95;105;10;0,774193548387097;0,854838709677419
"4655";4325;123;4655;6;95;107;12;0,774193548387097;0,870967741935484
"4656";4325;123;4656;6;95;109;14;0,774193548387097;0,887096774193548
"4657";4325;123;4657;6;95;111;16;0,774193548387097;0,903225806451613
"4658";4325;123;4658;6;97;105;8;0,790322580645161;0,854838709677419
"4659";4325;123;4659;6;97;107;10;0,790322580645161;0,870967741935484
"4660";4325;123;4660;6;97;109;12;0,790322580645161;0,887096774193548
"4661";4325;123;4661;6;99;105;6;0,806451612903226;0,854838709677419
"4662";4325;123;4662;6;99;107;8;0,806451612903226;0,870967741935484
"4663";4325;123;4663;6;99;109;10;0,806451612903226;0,887096774193548
"4664";4325;123;4664;6;101;107;6;0,82258064516129;0,870967741935484
"4665";4325;123;4665;6;101;109;8;0,82258064516129;0,887096774193548
"4666";4325;123;4666;6;101;111;10;0,82258064516129;0,903225806451613
"4667";4325;123;4667;6;105;115;10;0,854838709677419;0,935483870967742
"4668";4325;123;4668;6;105;117;12;0,854838709677419;0,951612903225806
"4669";4325;123;4669;6;107;113;6;0,870967741935484;0,919354838709677
"4670";4325;123;4670;6;107;115;8;0,870967741935484;0,935483870967742
"4671";4325;123;4671;6;107;117;10;0,870967741935484;0,951612903225806
"4672";4325;123;4672;6;109;117;8;0,887096774193548;0,951612903225806
"4673";4325;123;4673;6;109;119;10;0,887096774193548;0,967741935483871
"4674";4325;123;4674;6;109;121;12;0,887096774193548;0,983870967741935
"4675";4325;123;4675;6;111;119;8;0,903225806451613;0,967741935483871
"4676";4325;123;4676;6;111;121;10;0,903225806451613;0,983870967741935
"4677";4325;123;4677;6;113;119;6;0,919354838709677;0,967741935483871
"4678";4325;123;4678;6;113;121;8;0,919354838709677;0,983870967741935
"4679";4325;123;4679;6;115;121;6;0,935483870967742;0,983870967741935
"4680";4325;123;4680;6;117;123;6;0,951612903225806;1
"4681";4325;123;4681;6;9;17;8;0,0806451612903226;0,145161290322581
"4682";4325;123;4682;6;17;23;6;0,145161290322581;0,193548387096774
"4683";4325;123;4683;6;19;25;6;0,161290322580645;0,209677419354839
"4684";4325;123;4684;6;29;35;6;0,241935483870968;0,290322580645161
"4685";4325;123;4685;6;47;59;12;0,387096774193548;0,483870967741935
"4686";4325;123;4686;6;47;61;14;0,387096774193548;0,5
"4687";4325;123;4687;6;47;63;16;0,387096774193548;0,516129032258065
"4688";4325;123;4688;6;47;65;18;0,387096774193548;0,532258064516129
"4689";4325;123;4689;6;47;67;20;0,387096774193548;0,548387096774194
"4690";4325;123;4690;6;49;59;10;0,403225806451613;0,483870967741935
"4691";4325;123;4691;6;49;61;12;0,403225806451613;0,5
"4692";4325;123;4692;6;49;63;14;0,403225806451613;0,516129032258065
"4693";4325;123;4693;6;49;65;16;0,403225806451613;0,532258064516129
"4694";4325;123;4694;6;49;67;18;0,403225806451613;0,548387096774194
"4695";4325;123;4695;6;49;69;20;0,403225806451613;0,564516129032258
"4696";4325;123;4696;6;51;63;12;0,419354838709677;0,516129032258065
"4697";4325;123;4697;6;51;65;14;0,419354838709677;0,532258064516129
"4698";4325;123;4698;6;51;67;16;0,419354838709677;0,548387096774194
"4699";4325;123;4699;6;51;69;18;0,419354838709677;0,564516129032258
"4700";4325;123;4700;6;51;71;20;0,419354838709677;0,580645161290323
"4701";4325;123;4701;6;51;73;22;0,419354838709677;0,596774193548387
"4702";4325;123;4702;6;55;67;12;0,451612903225806;0,548387096774194
"4703";4325;123;4703;6;55;69;14;0,451612903225806;0,564516129032258
"4704";4325;123;4704;6;55;71;16;0,451612903225806;0,580645161290323
"4705";4325;123;4705;6;55;73;18;0,451612903225806;0,596774193548387
"4706";4325;123;4706;6;57;69;12;0,467741935483871;0,564516129032258
"4707";4325;123;4707;6;57;71;14;0,467741935483871;0,580645161290323
"4708";4325;123;4708;6;57;73;16;0,467741935483871;0,596774193548387
"4709";4325;123;4709;6;59;71;12;0,483870967741935;0,580645161290323
"4710";4325;123;4710;6;59;73;14;0,483870967741935;0,596774193548387
"4711";4325;123;4711;6;73;79;6;0,596774193548387;0,645161290322581
"4712";4325;123;4712;6;77;83;6;0,629032258064516;0,67741935483871
"4713";4325;123;4713;6;77;85;8;0,629032258064516;0,693548387096774
"4714";4325;123;4714;6;83;93;10;0,67741935483871;0,758064516129032
"4715";4325;123;4715;6;83;95;12;0,67741935483871;0,774193548387097
"4716";4325;123;4716;6;85;93;8;0,693548387096774;0,758064516129032
"4717";4325;123;4717;6;85;95;10;0,693548387096774;0,774193548387097
"4718";4325;123;4718;6;87;101;14;0,709677419354839;0,82258064516129
"4719";4325;123;4719;6;87;103;16;0,709677419354839;0,838709677419355
"4720";4325;123;4720;6;87;105;18;0,709677419354839;0,854838709677419
"4721";4325;123;4721;6;87;107;20;0,709677419354839;0,870967741935484
"4722";4325;123;4722;6;87;109;22;0,709677419354839;0,887096774193548
"4723";4325;123;4723;6;87;111;24;0,709677419354839;0,903225806451613
"4724";4325;123;4724;6;87;113;26;0,709677419354839;0,919354838709677
"4725";4325;123;4725;6;87;115;28;0,709677419354839;0,935483870967742
"4726";4325;123;4726;6;87;117;30;0,709677419354839;0,951612903225806
"4727";4325;123;4727;6;89;95;6;0,725806451612903;0,774193548387097
"4728";4325;123;4728;6;89;97;8;0,725806451612903;0,790322580645161
"4729";4325;123;4729;6;91;107;16;0,741935483870968;0,870967741935484
"4730";4325;123;4730;6;93;105;12;0,758064516129032;0,854838709677419
"4731";4325;123;4731;6;93;107;14;0,758064516129032;0,870967741935484
"4732";4325;123;4732;6;97;111;14;0,790322580645161;0,903225806451613
"4733";4325;123;4733;6;97;113;16;0,790322580645161;0,919354838709677
"4734";4325;123;4734;6;97;115;18;0,790322580645161;0,935483870967742
"4735";4325;123;4735;6;97;117;20;0,790322580645161;0,951612903225806
"4736";4325;123;4736;6;97;119;22;0,790322580645161;0,967741935483871
"4737";4325;123;4737;6;99;111;12;0,806451612903226;0,903225806451613
"4738";4325;123;4738;6;99;113;14;0,806451612903226;0,919354838709677
"4739";4325;123;4739;6;101;113;12;0,82258064516129;0,919354838709677
"4740";4325;123;4740;6;105;119;14;0,854838709677419;0,967741935483871
"4741";4325;123;4741;6;31;39;8;0,258064516129032;0,32258064516129
"4742";4325;123;4742;6;31;41;10;0,258064516129032;0,338709677419355
"4743";4325;123;4743;6;31;43;12;0,258064516129032;0,354838709677419
"4744";4325;123;4744;6;37;43;6;0,306451612903226;0,354838709677419
"4745";4325;123;4745;6;45;53;8;0,370967741935484;0,435483870967742
"4746";4325;123;4746;6;75;83;8;0,612903225806452;0,67741935483871
"4747";4325;123;4747;6;89;99;10;0,725806451612903;0,806451612903226
"4748";4325;123;4748;6;103;109;6;0,838709677419355;0,887096774193548
"4749";4325;123;4749;6;103;111;8;0,838709677419355;0,903225806451613
"4750";4325;123;4750;6;103;113;10;0,838709677419355;0,919354838709677
"4751";4325;123;4751;6;107;119;12;0,870967741935484;0,967741935483871
"4752";4325;123;4752;6;31;45;14;0,258064516129032;0,370967741935484
"4753";4325;123;4753;6;37;45;8;0,306451612903226;0,370967741935484
"4754";4325;123;4754;6;75;85;10;0,612903225806452;0,693548387096774
"4755";4325;123;4755;6;85;97;12;0,693548387096774;0,790322580645161
"4756";4325;123;4756;6;85;99;14;0,693548387096774;0,806451612903226
"4757";4325;123;4757;6;99;115;16;0,806451612903226;0,935483870967742
"4758";4325;123;4758;6;99;117;18;0,806451612903226;0,951612903225806
"4759";4325;123;4759;6;101;115;14;0,82258064516129;0,935483870967742
"4760";4325;123;4760;6;101;117;16;0,82258064516129;0,951612903225806
"4761";4325;123;4761;6;103;115;12;0,838709677419355;0,935483870967742
"4762";4325;123;4762;6;103;117;14;0,838709677419355;0,951612903225806
"4763";4325;123;4763;6;105;121;16;0,854838709677419;0,983870967741935
"4764";4325;123;4764;6;107;121;14;0,870967741935484;0,983870967741935
"4765";4325;123;4765;6;73;81;8;0,596774193548387;0,661290322580645
"4766";4325;123;4766;6;73;83;10;0,596774193548387;0,67741935483871
"4767";4325;123;4767;6;19;27;8;0,161290322580645;0,225806451612903
"4768";4325;123;4768;6;29;37;8;0,241935483870968;0,306451612903226
"4769";4325;123;4769;6;99;119;20;0,806451612903226;0,967741935483871
"4770";4325;123;4770;6;99;121;22;0,806451612903226;0,983870967741935
"4771";4325;123;4771;6;73;85;12;0,596774193548387;0,693548387096774
"4772";4325;123;4772;6;83;97;14;0,67741935483871;0,790322580645161
"4773";4325;123;4773;6;83;99;16;0,67741935483871;0,806451612903226
"4774";4325;123;4774;6;45;55;10;0,370967741935484;0,451612903225806
"4775";4325;123;4775;6;45;57;12;0,370967741935484;0,467741935483871
"4776";4325;123;4776;6;45;59;14;0,370967741935484;0,483870967741935
"4777";4325;123;4777;6;101;119;18;0,82258064516129;0,967741935483871
"4778";4325;123;4778;6;91;109;18;0,741935483870968;0,887096774193548
"4779";4325;123;4779;6;113;123;10;0,919354838709677;1
"4780";4325;123;4780;6;1;7;6;0,0161290322580645;0,0645161290322581
"4781";4325;123;4781;6;85;101;16;0,693548387096774;0,82258064516129
"4782";4325;123;4782;6;85;103;18;0,693548387096774;0,838709677419355
"4783";4325;123;4783;6;85;105;20;0,693548387096774;0,854838709677419
"4784";4325;123;4784;6;85;107;22;0,693548387096774;0,870967741935484
"4785";4325;123;4785;6;85;109;24;0,693548387096774;0,887096774193548
"4786";4325;123;4786;6;103;119;16;0,838709677419355;0,967741935483871
"4787";4325;123;4787;6;103;121;18;0,838709677419355;0,983870967741935
"4788";4325;123;4788;6;29;39;10;0,241935483870968;0,32258064516129
"4789";4325;123;4789;6;53;63;10;0,435483870967742;0,516129032258065
"4790";4325;123;4790;6;53;65;12;0,435483870967742;0,532258064516129
"4791";4325;123;4791;6;89;101;12;0,725806451612903;0,82258064516129
"4792";4325;123;4792;6;3;9;6;0,032258064516129;0,0806451612903226
"4793";4325;123;4793;6;83;101;18;0,67741935483871;0,82258064516129
"4794";4325;123;4794;6;83;103;20;0,67741935483871;0,838709677419355
"4795";4325;123;4795;6;47;69;22;0,387096774193548;0,564516129032258
"4796";4325;123;4796;6;47;71;24;0,387096774193548;0,580645161290323
"4797";4325;123;4797;6;47;73;26;0,387096774193548;0,596774193548387
"4798";4325;123;4798;6;49;71;22;0,403225806451613;0,580645161290323
"4799";4325;123;4799;6;91;111;20;0,741935483870968;0,903225806451613
"4800";4325;123;4800;6;91;113;22;0,741935483870968;0,919354838709677
"4801";4325;123;4801;6;91;115;24;0,741935483870968;0,935483870967742
"4802";4325;123;4802;6;91;117;26;0,741935483870968;0,951612903225806
"4803";4325;123;4803;6;95;113;18;0,774193548387097;0,919354838709677
"4804";4325;123;4804;6;95;115;20;0,774193548387097;0,935483870967742
"4805";4325;123;4805;6;95;117;22;0,774193548387097;0,951612903225806
"4806";4325;123;4806;6;95;119;24;0,774193548387097;0,967741935483871
"4807";4325;123;4807;6;95;121;26;0,774193548387097;0,983870967741935
"4808";4325;123;4808;6;97;121;24;0,790322580645161;0,983870967741935
"4809";4325;123;4809;6;101;121;20;0,82258064516129;0,983870967741935
"4810";4325;123;4810;6;49;73;24;0,403225806451613;0,596774193548387
"4811";4325;123;4811;6;87;119;32;0,709677419354839;0,967741935483871
"4812";4325;123;4812;6;93;109;16;0,758064516129032;0,887096774193548
"4813";4325;123;4813;6;93;111;18;0,758064516129032;0,903225806451613
"4814";4325;123;4814;6;109;123;14;0,887096774193548;1
"4815";4325;123;4815;6;19;29;10;0,161290322580645;0,241935483870968
"4816";4325;123;4816;6;29;41;12;0,241935483870968;0,338709677419355
"4817";4325;123;4817;6;83;105;22;0,67741935483871;0,854838709677419
"4818";4325;123;4818;6;83;107;24;0,67741935483871;0,870967741935484
"4819";4325;123;4819;6;83;109;26;0,67741935483871;0,887096774193548
"4820";4325;123;4820;6;85;111;26;0,693548387096774;0,903225806451613
"4821";4325;123;4821;6;93;113;20;0,758064516129032;0,919354838709677
"4822";4325;123;4822;6;93;115;22;0,758064516129032;0,935483870967742
"4823";4325;123;4823;6;93;117;24;0,758064516129032;0,951612903225806
"4824";4325;123;4824;6;93;119;26;0,758064516129032;0,967741935483871
"4825";4325;123;4825;6;81;87;6;0,661290322580645;0,709677419354839
"4826";4325;123;4826;6;89;103;14;0,725806451612903;0,838709677419355
"4827";4325;123;4827;6;29;43;14;0,241935483870968;0,354838709677419
"4828";4325;123;4828;6;29;45;16;0,241935483870968;0,370967741935484
"4829";4325;123;4829;6;63;75;12;0,516129032258065;0,612903225806452
"4830";4325;123;4830;6;5;11;6;0,0483870967741935;0,0967741935483871
"4831";4325;123;4831;6;65;75;10;0,532258064516129;0,612903225806452
"4832";4325;123;4832;6;17;25;8;0,145161290322581;0,209677419354839
"4833";4359;64;4833;3;15;64;49;0,25;1
"4834";4359;64;4834;4;23;48;25;0,375;0,75
"4835";4359;64;4835;4;40;64;24;0,625;1
"4836";4359;64;4836;4;32;56;24;0,5;0,875
"4837";4359;64;4837;4;32;64;32;0,5;1
"4838";4359;64;4838;4;23;56;33;0,375;0,875
"4839";4359;64;4839;4;23;64;41;0,375;1
"4840";4359;64;4840;5;23;36;13;0,375;0,5625
"4841";4359;64;4841;5;36;48;12;0,5625;0,75
"4842";4359;64;4842;5;40;52;12;0,625;0,8125
"4843";4359;64;4843;5;48;60;12;0,75;0,9375
"4844";4359;64;4844;5;36;52;16;0,5625;0,8125
"4845";4359;64;4845;5;36;56;20;0,5625;0,875
"4846";4359;64;4846;5;36;60;24;0,5625;0,9375
"4847";4359;64;4847;5;36;64;28;0,5625;1
"4848";4359;64;4848;5;40;56;16;0,625;0,875
"4849";4359;64;4849;5;40;60;20;0,625;0,9375
"4850";4359;64;4850;5;40;64;24;0,625;1
"4851";4359;64;4851;5;44;56;12;0,6875;0,875
"4852";4359;64;4852;5;44;60;16;0,6875;0,9375
"4853";4359;64;4853;5;48;64;16;0,75;1
"4854";4359;64;4854;5;27;40;13;0,4375;0,625
"4855";4359;64;4855;5;32;44;12;0,5;0,6875
"4856";4359;64;4856;5;32;48;16;0,5;0,75
"4857";4359;64;4857;5;44;64;20;0,6875;1
"4858";4359;64;4858;5;32;52;20;0,5;0,8125
"4859";4359;64;4859;5;27;44;17;0,4375;0,6875
"4860";4359;64;4860;5;27;48;21;0,4375;0,75
"4861";4359;64;4861;5;19;32;13;0,3125;0,5
"4862";4359;64;4862;5;23;40;17;0,375;0,625
"4863";4359;64;4863;5;27;52;25;0,4375;0,8125
"4864";4359;64;4864;5;27;56;29;0,4375;0,875
"4865";4359;64;4865;6;29;36;7;0,46875;0,5625
"4866";4359;64;4866;6;36;42;6;0,5625;0,65625
"4867";4359;64;4867;6;38;44;6;0,59375;0,6875
"4868";4359;64;4868;6;44;50;6;0,6875;0,78125
"4869";4359;64;4869;6;46;52;6;0,71875;0,8125
"4870";4359;64;4870;6;46;54;8;0,71875;0,84375
"4871";4359;64;4871;6;48;54;6;0,75;0,84375
"4872";4359;64;4872;6;36;44;8;0,5625;0,6875
"4873";4359;64;4873;6;36;46;10;0,5625;0,71875
"4874";4359;64;4874;6;36;48;12;0,5625;0,75
"4875";4359;64;4875;6;36;50;14;0,5625;0,78125
"4876";4359;64;4876;6;38;46;8;0,59375;0,71875
"4877";4359;64;4877;6;38;48;10;0,59375;0,75
"4878";4359;64;4878;6;38;50;12;0,59375;0,78125
"4879";4359;64;4879;6;40;46;6;0,625;0,71875
"4880";4359;64;4880;6;40;48;8;0,625;0,75
"4881";4359;64;4881;6;40;50;10;0,625;0,78125
"4882";4359;64;4882;6;40;52;12;0,625;0,8125
"4883";4359;64;4883;6;42;48;6;0,65625;0,75
"4884";4359;64;4884;6;42;50;8;0,65625;0,78125
"4885";4359;64;4885;6;44;52;8;0,6875;0,8125
"4886";4359;64;4886;6;44;54;10;0,6875;0,84375
"4887";4359;64;4887;6;44;56;12;0,6875;0,875
"4888";4359;64;4888;6;44;58;14;0,6875;0,90625
"4889";4359;64;4889;6;46;56;10;0,71875;0,875
"4890";4359;64;4890;6;46;58;12;0,71875;0,90625
"4891";4359;64;4891;6;48;56;8;0,75;0,875
"4892";4359;64;4892;6;48;58;10;0,75;0,90625
"4893";4359;64;4893;6;48;60;12;0,75;0,9375
"4894";4359;64;4894;6;25;32;7;0,40625;0,5
"4895";4359;64;4895;6;27;34;7;0,4375;0,53125
"4896";4359;64;4896;6;27;36;9;0,4375;0,5625
"4897";4359;64;4897;6;36;52;16;0,5625;0,8125
"4898";4359;64;4898;6;38;52;14;0,59375;0,8125
"4899";4359;64;4899;6;38;54;16;0,59375;0,84375
"4900";4359;64;4900;6;40;54;14;0,625;0,84375
"4901";4359;64;4901;6;40;56;16;0,625;0,875
"4902";4359;64;4902;6;40;58;18;0,625;0,90625
"4903";4359;64;4903;6;40;60;20;0,625;0,9375
"4904";4359;64;4904;6;46;60;14;0,71875;0,9375
"4905";4359;64;4905;6;46;62;16;0,71875;0,96875
"4906";4359;64;4906;6;25;34;9;0,40625;0,53125
"4907";4359;64;4907;6;25;36;11;0,40625;0,5625
"4908";4359;64;4908;6;23;29;6;0,375;0,46875
"4909";4359;64;4909;6;36;54;18;0,5625;0,84375
"4910";4359;64;4910;6;36;56;20;0,5625;0,875
"4911";4359;64;4911;6;36;58;22;0,5625;0,90625
"4912";4359;64;4912;6;36;60;24;0,5625;0,9375
"4913";4359;64;4913;6;38;56;18;0,59375;0,875
"4914";4359;64;4914;6;38;58;20;0,59375;0,90625
"4915";4359;64;4915;6;38;60;22;0,59375;0,9375
"4916";4359;64;4916;6;38;62;24;0,59375;0,96875
"4917";4359;64;4917;6;40;62;22;0,625;0,96875
"4918";4359;64;4918;6;44;60;16;0,6875;0,9375
"4919";4359;64;4919;6;44;62;18;0,6875;0,96875
"4920";4359;64;4920;6;23;32;9;0,375;0,5
"4921";4359;64;4921;6;42;52;10;0,65625;0,8125
"4922";4359;64;4922;6;42;54;12;0,65625;0,84375
"4923";4359;64;4923;6;42;56;14;0,65625;0,875
"4924";4359;64;4924;6;42;58;16;0,65625;0,90625
"4925";4359;64;4925;6;42;60;18;0,65625;0,9375
"4926";4359;64;4926;6;42;62;20;0,65625;0,96875
"4927";4359;64;4927;6;42;64;22;0,65625;1
"4928";4359;64;4928;6;23;34;11;0,375;0,53125
"4929";4359;64;4929;6;36;62;26;0,5625;0,96875
"4930";4359;64;4930;6;36;64;28;0,5625;1
"4931";4359;64;4931;6;40;64;24;0,625;1
"4932";4359;64;4932;6;44;64;20;0,6875;1
"4933";4359;64;4933;6;15;21;6;0,25;0,34375
"4934";4359;64;4934;6;29;38;9;0,46875;0,59375
"4935";4359;64;4935;6;27;38;11;0,4375;0,59375
"4936";4359;64;4936;6;21;27;6;0,34375;0,4375
"4937";4359;64;4937;6;34;40;6;0,53125;0,625
"4938";4359;64;4938;6;34;42;8;0,53125;0,65625
"4939";4359;64;4939;6;34;44;10;0,53125;0,6875
"4940";4359;64;4940;6;34;46;12;0,53125;0,71875
"4941";4359;64;4941;6;34;48;14;0,53125;0,75
"4942";4359;64;4942;6;17;23;6;0,28125;0,375
"4943";4359;64;4943;6;7;13;6;0,125;0,21875
"4944";4359;64;4944;6;32;38;6;0,5;0,59375
"4945";4359;64;4945;6;38;64;26;0,59375;1
"4946";4359;64;4946;6;46;64;18;0,71875;1
"4947";4359;64;4947;6;48;62;14;0,75;0,96875
"4948";4359;64;4948;6;19;25;6;0,3125;0,40625
"4949";4411;134;4949;5;109;134;25;0,8125;1
"4950";4411;134;4950;5;83;109;26;0,625;0,8125
"4951";4411;134;4951;6;69;81;12;0,515151515151515;0,606060606060606
"4952";4411;134;4952;6;122;134;12;0,909090909090909;1
"4953";4411;134;4953;6;118;130;12;0,878787878787879;0,96969696969697
"4954";4411;134;4954;6;118;134;16;0,878787878787879;1
"4955";4411;134;4955;6;24;36;12;0,181818181818182;0,272727272727273
"4956";4411;134;4956;6;28;40;12;0,212121212121212;0,303030303030303
"4957";4411;134;4957;6;3;15;12;0,0303030303030303;0,121212121212121
"4958";4411;134;4958;6;89;101;12;0,666666666666667;0,757575757575758
"4959";4411;134;4959;6;28;44;16;0,212121212121212;0,333333333333333
"4960";4411;134;4960;6;93;105;12;0,696969696969697;0,787878787878788
"4961";4411;134;4961;6;32;44;12;0,242424242424242;0,333333333333333
"4962";4411;134;4962;6;48;60;12;0,363636363636364;0,454545454545455
"4963";4411;134;4963;6;93;109;16;0,696969696969697;0,818181818181818
"4964";4411;134;4964;6;24;40;16;0,181818181818182;0,303030303030303
"4965";4411;134;4965;6;109;122;13;0,818181818181818;0,909090909090909
"4966";4411;134;4966;6;97;109;12;0,727272727272727;0,818181818181818
"4967";4411;134;4967;6;114;126;12;0,848484848484849;0,939393939393939
"4968";4411;134;4968;6;69;85;16;0,515151515151515;0,636363636363636
"4969";4411;134;4969;6;85;97;12;0,636363636363636;0,727272727272727
"4970";4411;134;4970;6;64;77;13;0,484848484848485;0,575757575757576
"4971";4411;134;4971;6;64;81;17;0,484848484848485;0,606060606060606
"4972";4411;134;4972;6;24;44;20;0,181818181818182;0,333333333333333
"4973";4445;110;4973;4;84;110;26;0,769230769230769;1
"4974";4445;110;4974;4;76;101;25;0,692307692307692;0,923076923076923
"4975";4445;110;4975;4;76;110;34;0,692307692307692;1
"4976";4445;110;4976;4;67;93;26;0,615384615384615;0,846153846153846
"4977";4445;110;4977;5;85;98;13;0,777777777777778;0,888888888888889
"4978";4445;110;4978;5;89;102;13;0,814814814814815;0,925925925925926
"4979";4445;110;4979;5;85;102;17;0,777777777777778;0,925925925925926
"4980";4445;110;4980;5;85;106;21;0,777777777777778;0,962962962962963
"4981";4445;110;4981;5;85;110;25;0,777777777777778;1
"4982";4445;110;4982;5;89;106;17;0,814814814814815;0,962962962962963
"4983";4445;110;4983;5;89;110;21;0,814814814814815;1
"4984";4445;110;4984;5;81;94;13;0,740740740740741;0,851851851851852
"4985";4445;110;4985;5;81;98;17;0,740740740740741;0,888888888888889
"4986";4445;110;4986;5;81;102;21;0,740740740740741;0,925925925925926
"4987";4445;110;4987;5;81;106;25;0,740740740740741;0,962962962962963
"4988";4445;110;4988;5;81;110;29;0,740740740740741;1
"4989";4445;110;4989;5;77;89;12;0,703703703703704;0,814814814814815
"4990";4445;110;4990;5;69;81;12;0,62962962962963;0,740740740740741
"4991";4445;110;4991;5;48;61;13;0,444444444444444;0,555555555555556
"4992";4445;110;4992;5;73;85;12;0,666666666666667;0,777777777777778
"4993";4445;110;4993;5;32;44;12;0,296296296296296;0,407407407407407
"4994";4445;110;4994;5;77;94;17;0,703703703703704;0,851851851851852
"4995";4445;110;4995;5;52;65;13;0,481481481481481;0,592592592592593
"4996";4445;110;4996;5;15;28;13;0,148148148148148;0,259259259259259
"4997";4445;110;4997;6;84;90;6;0,763636363636364;0,818181818181818
"4998";4445;110;4998;6;88;94;6;0,8;0,854545454545454
"4999";4445;110;4999;6;84;92;8;0,763636363636364;0,836363636363636
"5000";4445;110;5000;6;84;94;10;0,763636363636364;0,854545454545454
"5001";4445;110;5001;6;84;96;12;0,763636363636364;0,872727272727273
"5002";4445;110;5002;6;86;92;6;0,781818181818182;0,836363636363636
"5003";4445;110;5003;6;86;94;8;0,781818181818182;0,854545454545454
"5004";4445;110;5004;6;86;96;10;0,781818181818182;0,872727272727273
"5005";4445;110;5005;6;88;96;8;0,8;0,872727272727273
"5006";4445;110;5006;6;88;98;10;0,8;0,890909090909091
"5007";4445;110;5007;6;88;100;12;0,8;0,909090909090909
"5008";4445;110;5008;6;39;45;6;0,363636363636364;0,418181818181818
"5009";4445;110;5009;6;68;74;6;0,618181818181818;0,672727272727273
"5010";4445;110;5010;6;84;98;14;0,763636363636364;0,890909090909091
"5011";4445;110;5011;6;84;100;16;0,763636363636364;0,909090909090909
"5012";4445;110;5012;6;84;102;18;0,763636363636364;0,927272727272727
"5013";4445;110;5013;6;84;104;20;0,763636363636364;0,945454545454545
"5014";4445;110;5014;6;84;106;22;0,763636363636364;0,963636363636364
"5015";4445;110;5015;6;86;98;12;0,781818181818182;0,890909090909091
"5016";4445;110;5016;6;86;100;14;0,781818181818182;0,909090909090909
"5017";4445;110;5017;6;86;102;16;0,781818181818182;0,927272727272727
"5018";4445;110;5018;6;86;104;18;0,781818181818182;0,945454545454545
"5019";4445;110;5019;6;86;106;20;0,781818181818182;0,963636363636364
"5020";4445;110;5020;6;86;108;22;0,781818181818182;0,981818181818182
"5021";4445;110;5021;6;76;82;6;0,690909090909091;0,745454545454545
"5022";4445;110;5022;6;56;62;6;0,509090909090909;0,563636363636364
"5023";4445;110;5023;6;88;102;14;0,8;0,927272727272727
"5024";4445;110;5024;6;88;104;16;0,8;0,945454545454545
"5025";4445;110;5025;6;84;108;24;0,763636363636364;0,981818181818182
"5026";4445;110;5026;6;84;110;26;0,763636363636364;1
"5027";4445;110;5027;6;88;106;18;0,8;0,963636363636364
"5028";4445;110;5028;6;88;108;20;0,8;0,981818181818182
"5029";4445;110;5029;6;88;110;22;0,8;1
"5030";4445;110;5030;6;41;47;6;0,381818181818182;0,436363636363636
"5031";4445;110;5031;6;7;13;6;0,0727272727272727;0,127272727272727
"5032";4445;110;5032;6;78;84;6;0,709090909090909;0,763636363636364
"5033";4445;110;5033;6;19;25;6;0,181818181818182;0,236363636363636
"5034";4445;110;5034;6;66;72;6;0,6;0,654545454545455
"5035";4445;110;5035;6;35;41;6;0,327272727272727;0,381818181818182
"5036";4445;110;5036;6;49;56;7;0,454545454545455;0,509090909090909
"5037";4445;110;5037;6;33;39;6;0,309090909090909;0,363636363636364
"5038";4445;110;5038;6;23;29;6;0,218181818181818;0,272727272727273
"5039";4445;110;5039;6;21;27;6;0,2;0,254545454545455
"5040";4445;110;5040;6;47;53;6;0,436363636363636;0,490909090909091
"5041";4445;110;5041;6;86;110;24;0,781818181818182;1
"5042";4445;110;5042;6;31;37;6;0,290909090909091;0,345454545454545
"5043";4445;110;5043;6;37;43;6;0,345454545454545;0,4
"5044";4445;110;5044;6;70;76;6;0,636363636363636;0,690909090909091
"5045";4445;110;5045;6;39;47;8;0,363636363636364;0,436363636363636
"5046";4445;110;5046;6;60;66;6;0,545454545454545;0,6
"5047";4445;110;5047;6;37;45;8;0,345454545454545;0,418181818181818
"5048";4445;110;5048;6;17;23;6;0,163636363636364;0,218181818181818
"5049";4445;110;5049;6;35;43;8;0,327272727272727;0,4
"5050";4445;110;5050;6;66;74;8;0,6;0,672727272727273
"5051";4445;110;5051;6;5;11;6;0,0545454545454545;0,109090909090909
"5052";4590;69;5052;3;16;69;53;0,25;1
"5053";4590;69;5053;4;34;60;26;0,5;0,875
"5054";4590;69;5054;4;43;69;26;0,625;1
"5055";4590;69;5055;4;16;43;27;0,25;0,625
"5056";4590;69;5056;4;25;52;27;0,375;0,75
"5057";4590;69;5057;4;34;69;35;0,5;1
"5058";4590;69;5058;4;25;60;35;0,375;0,875
"5059";4590;69;5059;4;8;34;26;0,125;0,5
"5060";4590;69;5060;4;16;52;36;0,25;0,75
"5061";4590;69;5061;5;36;48;12;0,529411764705882;0,705882352941177
"5062";4590;69;5062;5;40;53;13;0,588235294117647;0,764705882352941
"5063";4590;69;5063;5;40;57;17;0,588235294117647;0,823529411764706
"5064";4590;69;5064;5;44;57;13;0,647058823529412;0,823529411764706
"5065";4590;69;5065;5;48;61;13;0,705882352941177;0,882352941176471
"5066";4590;69;5066;5;48;65;17;0,705882352941177;0,941176470588235
"5067";4590;69;5067;5;53;65;12;0,764705882352941;0,941176470588235
"5068";4590;69;5068;5;57;69;12;0,823529411764706;1
"5069";4590;69;5069;5;3;15;12;0,0588235294117647;0,235294117647059
"5070";4590;69;5070;5;40;61;21;0,588235294117647;0,882352941176471
"5071";4590;69;5071;5;44;61;17;0,647058823529412;0,882352941176471
"5072";4590;69;5072;5;48;69;21;0,705882352941177;1
"5073";4590;69;5073;5;53;69;16;0,764705882352941;1
"5074";4590;69;5074;5;32;44;12;0,470588235294118;0,647058823529412
"5075";4590;69;5075;5;44;65;21;0,647058823529412;0,941176470588235
"5076";4590;69;5076;5;20;32;12;0,294117647058824;0,470588235294118
"5077";4590;69;5077;5;7;20;13;0,117647058823529;0,294117647058824
"5078";4590;69;5078;5;36;53;17;0,529411764705882;0,764705882352941
"5079";4590;69;5079;5;40;65;25;0,588235294117647;0,941176470588235
"5080";4590;69;5080;5;15;28;13;0,235294117647059;0,411764705882353
"5081";4590;69;5081;5;11;24;13;0,176470588235294;0,352941176470588
"5082";4590;69;5082;5;24;36;12;0,352941176470588;0,529411764705882
"5083";4590;69;5083;6;3;9;6;0,0571428571428571;0,142857142857143
"5084";4590;69;5084;6;5;11;6;0,0857142857142857;0,171428571428571
"5085";4590;69;5085;6;27;33;6;0,4;0,485714285714286
"5086";4590;69;5086;6;39;45;6;0,571428571428571;0,657142857142857
"5087";4590;69;5087;6;41;47;6;0,6;0,685714285714286
"5088";4590;69;5088;6;49;55;6;0,714285714285714;0,8
"5089";4590;69;5089;6;49;57;8;0,714285714285714;0,828571428571429
"5090";4590;69;5090;6;53;59;6;0,771428571428571;0,857142857142857
"5091";4590;69;5091;6;57;63;6;0,828571428571429;0,914285714285714
"5092";4590;69;5092;6;59;65;6;0,857142857142857;0,942857142857143
"5093";4590;69;5093;6;9;15;6;0,142857142857143;0,228571428571429
"5094";4590;69;5094;6;25;31;6;0,371428571428571;0,457142857142857
"5095";4590;69;5095;6;37;43;6;0,542857142857143;0,628571428571429
"5096";4590;69;5096;6;43;49;6;0,628571428571429;0,714285714285714
"5097";4590;69;5097;6;51;57;6;0,742857142857143;0,828571428571429
"5098";4590;69;5098;6;51;59;8;0,742857142857143;0,857142857142857
"5099";4590;69;5099;6;55;61;6;0,8;0,885714285714286
"5100";4590;69;5100;6;33;39;6;0,485714285714286;0,571428571428571
"5101";4590;69;5101;6;63;69;6;0,914285714285714;1
"5102";4590;69;5102;6;33;41;8;0,485714285714286;0,6
"5103";4590;69;5103;6;47;53;6;0,685714285714286;0,771428571428571
"5104";4590;69;5104;6;39;47;8;0,571428571428571;0,685714285714286
"5105";4590;69;5105;6;39;49;10;0,571428571428571;0,714285714285714
"5106";4590;69;5106;6;41;49;8;0,6;0,714285714285714
"5107";4590;69;5107;6;11;17;6;0,171428571428571;0,257142857142857
"5108";4590;69;5108;6;23;29;6;0,342857142857143;0,428571428571429
"5109";4590;69;5109;6;23;31;8;0,342857142857143;0,457142857142857
"5110";4590;69;5110;6;35;41;6;0,514285714285714;0,6
"5111";4590;69;5111;6;47;55;8;0,685714285714286;0,8
"5112";4590;69;5112;6;47;57;10;0,685714285714286;0,828571428571429
"5113";4590;69;5113;6;47;59;12;0,685714285714286;0,857142857142857
"5114";4590;69;5114;6;47;61;14;0,685714285714286;0,885714285714286
"5115";4590;69;5115;6;47;63;16;0,685714285714286;0,914285714285714
"5116";4590;69;5116;6;49;59;10;0,714285714285714;0,857142857142857
"5117";4590;69;5117;6;49;61;12;0,714285714285714;0,885714285714286
"5118";4590;69;5118;6;49;63;14;0,714285714285714;0,914285714285714
"5119";4590;69;5119;6;51;61;10;0,742857142857143;0,885714285714286
"5120";4590;69;5120;6;51;63;12;0,742857142857143;0,914285714285714
"5121";4590;69;5121;6;53;61;8;0,771428571428571;0,885714285714286
"5122";4590;69;5122;6;53;63;10;0,771428571428571;0,914285714285714
"5123";4590;69;5123;6;53;65;12;0,771428571428571;0,942857142857143
"5124";4590;69;5124;6;55;63;8;0,8;0,914285714285714
"5125";4590;69;5125;6;41;51;10;0,6;0,742857142857143
"5126";4590;69;5126;6;7;13;6;0,114285714285714;0,2
"5127";4590;69;5127;6;45;51;6;0,657142857142857;0,742857142857143
"5128";4590;69;5128;6;43;51;8;0,628571428571429;0,742857142857143
"5129";4590;69;5129;6;43;53;10;0,628571428571429;0,771428571428571
"5130";4590;69;5130;6;45;53;8;0,657142857142857;0,771428571428571
"5131";4590;69;5131;6;13;19;6;0,2;0,285714285714286
"5132";4590;69;5132;6;15;21;6;0,228571428571429;0,314285714285714
"5133";4590;69;5133;6;17;23;6;0,257142857142857;0,342857142857143
"5134";4590;69;5134;6;19;25;6;0,285714285714286;0,371428571428571
"5135";4590;69;5135;6;41;53;12;0,6;0,771428571428571
"5136";4590;69;5136;6;43;55;12;0,628571428571429;0,8
"5137";4590;69;5137;6;43;57;14;0,628571428571429;0,828571428571429
"5138";4590;69;5138;6;43;59;16;0,628571428571429;0,857142857142857
"5139";4590;69;5139;6;43;61;18;0,628571428571429;0,885714285714286
"5140";4590;69;5140;6;37;45;8;0,542857142857143;0,657142857142857
"5141";4590;69;5141;6;41;55;14;0,6;0,8
"5142";4590;69;5142;6;41;57;16;0,6;0,828571428571429
"5143";4590;69;5143;6;45;55;10;0,657142857142857;0,8
"5144";4590;69;5144;6;21;27;6;0,314285714285714;0,4
"5145";4590;69;5145;6;45;57;12;0,657142857142857;0,828571428571429
"5146";4590;69;5146;6;11;19;8;0,171428571428571;0,285714285714286
"5147";4590;69;5147;6;37;47;10;0,542857142857143;0,685714285714286
"5148";4590;69;5148;6;45;59;14;0,657142857142857;0,857142857142857
"5149";4590;69;5149;6;31;37;6;0,457142857142857;0,542857142857143
"5150";4590;69;5150;6;31;39;8;0,457142857142857;0,571428571428571
"5151";4614;77;5151;3;18;77;59;0,25;1
"5152";4614;77;5152;4;42;68;26;0,555555555555556;0,888888888888889
"5153";4614;77;5153;4;42;77;35;0,555555555555556;1
"5154";4614;77;5154;4;51;77;26;0,666666666666667;1
"5155";4614;77;5155;4;34;60;26;0,444444444444444;0,777777777777778
"5156";4614;77;5156;4;34;68;34;0,444444444444444;0,888888888888889
"5157";4614;77;5157;4;34;77;43;0,444444444444444;1
"5158";4614;77;5158;5;44;56;12;0,578947368421053;0,736842105263158
"5159";4614;77;5159;5;44;61;17;0,578947368421053;0,789473684210526
"5160";4614;77;5160;5;52;65;13;0,684210526315789;0,842105263157895
"5161";4614;77;5161;5;44;65;21;0,578947368421053;0,842105263157895
"5162";4614;77;5162;5;44;69;25;0,578947368421053;0,894736842105263
"5163";4614;77;5163;5;44;73;29;0,578947368421053;0,947368421052632
"5164";4614;77;5164;5;44;77;33;0,578947368421053;1
"5165";4614;77;5165;5;52;69;17;0,684210526315789;0,894736842105263
"5166";4614;77;5166;5;52;73;21;0,684210526315789;0,947368421052632
"5167";4614;77;5167;5;52;77;25;0,684210526315789;1
"5168";4614;77;5168;5;32;44;12;0,421052631578947;0,578947368421053
"5169";4614;77;5169;6;35;41;6;0,461538461538462;0,538461538461538
"5170";4614;77;5170;6;35;43;8;0,461538461538462;0,564102564102564
"5171";4614;77;5171;6;45;51;6;0,58974358974359;0,666666666666667
"5172";4614;77;5172;6;45;53;8;0,58974358974359;0,692307692307692
"5173";4614;77;5173;6;53;59;6;0,692307692307692;0,769230769230769
"5174";4614;77;5174;6;45;55;10;0,58974358974359;0,717948717948718
"5175";4614;77;5175;6;45;57;12;0,58974358974359;0,743589743589744
"5176";4614;77;5176;6;45;59;14;0,58974358974359;0,769230769230769
"5177";4614;77;5177;6;45;61;16;0,58974358974359;0,794871794871795
"5178";4614;77;5178;6;53;61;8;0,692307692307692;0,794871794871795
"5179";4614;77;5179;6;53;63;10;0,692307692307692;0,82051282051282
"5180";4614;77;5180;6;53;65;12;0,692307692307692;0,846153846153846
"5181";4614;77;5181;6;45;63;18;0,58974358974359;0,82051282051282
"5182";4614;77;5182;6;45;65;20;0,58974358974359;0,846153846153846
"5183";4614;77;5183;6;53;67;14;0,692307692307692;0,871794871794872
"5184";4614;77;5184;6;53;69;16;0,692307692307692;0,897435897435897
"5185";4614;77;5185;6;45;67;22;0,58974358974359;0,871794871794872
"5186";4614;77;5186;6;45;69;24;0,58974358974359;0,897435897435897
"5187";4614;77;5187;6;45;71;26;0,58974358974359;0,923076923076923
"5188";4614;77;5188;6;45;73;28;0,58974358974359;0,948717948717949
"5189";4614;77;5189;6;45;75;30;0,58974358974359;0,974358974358974
"5190";4614;77;5190;6;45;77;32;0,58974358974359;1
"5191";4614;77;5191;6;53;71;18;0,692307692307692;0,923076923076923
"5192";4614;77;5192;6;53;73;20;0,692307692307692;0,948717948717949
"5193";4614;77;5193;6;53;75;22;0,692307692307692;0,974358974358974
"5194";4614;77;5194;6;53;77;24;0,692307692307692;1
"5195";4614;77;5195;6;35;45;10;0,461538461538462;0,58974358974359
"5196";4733;76;5196;3;18;76;58;0,25;1
"5197";4733;76;5197;4;50;76;26;0,666666666666667;1
"5198";4733;76;5198;4;16;42;26;0,222222222222222;0,555555555555556
"5199";4733;76;5199;4;42;67;25;0,555555555555556;0,888888888888889
"5200";4733;76;5200;4;42;76;34;0,555555555555556;1
"5201";4733;76;5201;4;25;50;25;0,333333333333333;0,666666666666667
"5202";4733;76;5202;4;33;59;26;0,444444444444444;0,777777777777778
"5203";4733;76;5203;5;56;68;12;0,736842105263158;0,894736842105263
"5204";4733;76;5204;5;27;40;13;0,368421052631579;0,526315789473684
"5205";4733;76;5205;5;31;44;13;0,421052631578947;0,578947368421053
"5206";4733;76;5206;5;48;60;12;0,631578947368421;0,789473684210526
"5207";4733;76;5207;5;19;31;12;0,263157894736842;0,421052631578947
"5208";4733;76;5208;5;23;35;12;0,315789473684211;0,473684210526316
"5209";4733;76;5209;5;23;40;17;0,315789473684211;0,526315789473684
"5210";4733;76;5210;5;23;44;21;0,315789473684211;0,578947368421053
"5211";4733;76;5211;5;27;44;17;0,368421052631579;0,578947368421053
"5212";4733;76;5212;5;48;64;16;0,631578947368421;0,842105263157895
"5213";4733;76;5213;5;48;68;20;0,631578947368421;0,894736842105263
"5214";4733;76;5214;5;52;64;12;0,684210526315789;0,842105263157895
"5215";4733;76;5215;5;52;68;16;0,684210526315789;0,894736842105263
"5216";4733;76;5216;5;52;72;20;0,684210526315789;0,947368421052632
"5217";4733;76;5217;5;52;76;24;0,684210526315789;1
"5218";4733;76;5218;5;56;72;16;0,736842105263158;0,947368421052632
"5219";4733;76;5219;5;56;76;20;0,736842105263158;1
"5220";4733;76;5220;5;64;76;12;0,842105263157895;1
"5221";4733;76;5221;5;44;56;12;0,578947368421053;0,736842105263158
"5222";4733;76;5222;5;44;60;16;0,578947368421053;0,789473684210526
"5223";4733;76;5223;5;11;23;12;0,157894736842105;0,315789473684211
"5224";4733;76;5224;5;15;27;12;0,210526315789474;0,368421052631579
"5225";4733;76;5225;5;19;35;16;0,263157894736842;0,473684210526316
"5226";4733;76;5226;5;44;64;20;0,578947368421053;0,842105263157895
"5227";4733;76;5227;5;48;72;24;0,631578947368421;0,947368421052632
"5228";4733;76;5228;5;48;76;28;0,631578947368421;1
"5229";4733;76;5229;5;19;40;21;0,263157894736842;0,526315789473684
"5230";4733;76;5230;5;60;72;12;0,789473684210526;0,947368421052632
"5231";4733;76;5231;6;19;25;6;0,263157894736842;0,342105263157895
"5232";4733;76;5232;6;31;38;7;0,421052631578947;0,5
"5233";4733;76;5233;6;38;44;6;0,5;0,578947368421053
"5234";4733;76;5234;6;46;52;6;0,605263157894737;0,684210526315789
"5235";4733;76;5235;6;46;54;8;0,605263157894737;0,710526315789474
"5236";4733;76;5236;6;50;56;6;0,657894736842105;0,736842105263158
"5237";4733;76;5237;6;66;72;6;0,868421052631579;0,947368421052632
"5238";4733;76;5238;6;19;27;8;0,263157894736842;0,368421052631579
"5239";4733;76;5239;6;23;29;6;0,315789473684211;0,394736842105263
"5240";4733;76;5240;6;23;31;8;0,315789473684211;0,421052631578947
"5241";4733;76;5241;6;23;33;10;0,315789473684211;0,447368421052632
"5242";4733;76;5242;6;25;31;6;0,342105263157895;0,421052631578947
"5243";4733;76;5243;6;27;33;6;0,368421052631579;0,447368421052632
"5244";4733;76;5244;6;27;35;8;0,368421052631579;0,473684210526316
"5245";4733;76;5245;6;27;38;11;0,368421052631579;0,5
"5246";4733;76;5246;6;29;35;6;0,394736842105263;0,473684210526316
"5247";4733;76;5247;6;29;38;9;0,394736842105263;0,5
"5248";4733;76;5248;6;31;40;9;0,421052631578947;0,526315789473684
"5249";4733;76;5249;6;31;42;11;0,421052631578947;0,552631578947368
"5250";4733;76;5250;6;31;44;13;0,421052631578947;0,578947368421053
"5251";4733;76;5251;6;33;40;7;0,447368421052632;0,526315789473684
"5252";4733;76;5252;6;33;42;9;0,447368421052632;0,552631578947368
"5253";4733;76;5253;6;33;44;11;0,447368421052632;0,578947368421053
"5254";4733;76;5254;6;35;42;7;0,473684210526316;0,552631578947368
"5255";4733;76;5255;6;35;44;9;0,473684210526316;0,578947368421053
"5256";4733;76;5256;6;52;58;6;0,684210526315789;0,763157894736842
"5257";4733;76;5257;6;54;60;6;0,710526315789474;0,789473684210526
"5258";4733;76;5258;6;54;62;8;0,710526315789474;0,815789473684211
"5259";4733;76;5259;6;58;64;6;0,763157894736842;0,842105263157895
"5260";4733;76;5260;6;66;74;8;0,868421052631579;0,973684210526316
"5261";4733;76;5261;6;66;76;10;0,868421052631579;1
"5262";4733;76;5262;6;68;74;6;0,894736842105263;0,973684210526316
"5263";4733;76;5263;6;70;76;6;0,921052631578947;1
"5264";4733;76;5264;6;23;35;12;0,315789473684211;0,473684210526316
"5265";4733;76;5265;6;25;33;8;0,342105263157895;0,447368421052632
"5266";4733;76;5266;6;25;35;10;0,342105263157895;0,473684210526316
"5267";4733;76;5267;6;48;54;6;0,631578947368421;0,710526315789474
"5268";4733;76;5268;6;50;58;8;0,657894736842105;0,763157894736842
"5269";4733;76;5269;6;50;60;10;0,657894736842105;0,789473684210526
"5270";4733;76;5270;6;50;62;12;0,657894736842105;0,815789473684211
"5271";4733;76;5271;6;50;64;14;0,657894736842105;0,842105263157895
"5272";4733;76;5272;6;52;60;8;0,684210526315789;0,789473684210526
"5273";4733;76;5273;6;52;62;10;0,684210526315789;0,815789473684211
"5274";4733;76;5274;6;56;62;6;0,736842105263158;0,815789473684211
"5275";4733;76;5275;6;44;50;6;0,578947368421053;0,657894736842105
"5276";4733;76;5276;6;54;64;10;0,710526315789474;0,842105263157895
"5277";4733;76;5277;6;68;76;8;0,894736842105263;1
"5278";4733;76;5278;6;17;23;6;0,236842105263158;0,315789473684211
"5279";4733;76;5279;6;29;40;11;0,394736842105263;0,526315789473684
"5280";4733;76;5280;6;29;42;13;0,394736842105263;0,552631578947368
"5281";4733;76;5281;6;54;66;12;0,710526315789474;0,868421052631579
"5282";4733;76;5282;6;56;64;8;0,736842105263158;0,842105263157895
"5283";4733;76;5283;6;56;66;10;0,736842105263158;0,868421052631579
"5284";4733;76;5284;6;56;68;12;0,736842105263158;0,894736842105263
"5285";4733;76;5285;6;58;66;8;0,763157894736842;0,868421052631579
"5286";4733;76;5286;6;60;66;6;0,789473684210526;0,868421052631579
"5287";4733;76;5287;6;60;68;8;0,789473684210526;0,894736842105263
"5288";4733;76;5288;6;62;68;6;0,815789473684211;0,894736842105263
"5289";4733;76;5289;6;48;56;8;0,631578947368421;0,736842105263158
"5290";4733;76;5290;6;48;58;10;0,631578947368421;0,763157894736842
"5291";4733;76;5291;6;50;66;16;0,657894736842105;0,868421052631579
"5292";4733;76;5292;6;52;64;12;0,684210526315789;0,842105263157895
"5293";4733;76;5293;6;52;66;14;0,684210526315789;0,868421052631579
"5294";4733;76;5294;6;54;68;14;0,710526315789474;0,894736842105263
"5295";4733;76;5295;6;54;70;16;0,710526315789474;0,921052631578947
"5296";4733;76;5296;6;58;68;10;0,763157894736842;0,894736842105263
"5297";4733;76;5297;6;58;70;12;0,763157894736842;0,921052631578947
"5298";4733;76;5298;6;21;27;6;0,289473684210526;0,368421052631579
"5299";4733;76;5299;6;64;70;6;0,842105263157895;0,921052631578947
"5300";4733;76;5300;6;27;40;13;0,368421052631579;0,526315789473684
"5301";4733;76;5301;6;29;44;15;0,394736842105263;0,578947368421053
"5302";4733;76;5302;6;48;60;12;0,631578947368421;0,789473684210526
"5303";4733;76;5303;6;48;62;14;0,631578947368421;0,815789473684211
"5304";4733;76;5304;6;48;64;16;0,631578947368421;0,842105263157895
"5305";4733;76;5305;6;50;68;18;0,657894736842105;0,894736842105263
"5306";4733;76;5306;6;52;68;16;0,684210526315789;0,894736842105263
"5307";4733;76;5307;6;62;70;8;0,815789473684211;0,921052631578947
"5308";4733;76;5308;6;11;17;6;0,157894736842105;0,236842105263158
"5309";4733;76;5309;6;17;25;8;0,236842105263158;0,342105263157895
"5310";4733;76;5310;6;60;70;10;0,789473684210526;0,921052631578947
"5311";4733;76;5311;6;13;19;6;0,184210526315789;0,263157894736842
"5312";4733;76;5312;6;25;38;13;0,342105263157895;0,5
"5313";4733;76;5313;6;25;40;15;0,342105263157895;0,526315789473684
"5314";4733;76;5314;6;21;29;8;0,289473684210526;0,394736842105263
"5315";4733;76;5315;6;21;31;10;0,289473684210526;0,421052631578947
"5316";4733;76;5316;6;50;70;20;0,657894736842105;0,921052631578947
"5317";4733;76;5317;6;64;72;8;0,842105263157895;0,947368421052632
"5318";4733;76;5318;6;64;74;10;0,842105263157895;0,973684210526316
"5319";4733;76;5319;6;64;76;12;0,842105263157895;1
"5320";4733;76;5320;6;19;29;10;0,263157894736842;0,394736842105263
"5321";4733;76;5321;6;25;42;17;0,342105263157895;0,552631578947368
"5322";4733;76;5322;6;25;44;19;0,342105263157895;0,578947368421053
"5323";4733;76;5323;6;27;42;15;0,368421052631579;0,552631578947368
"5324";4733;76;5324;6;27;44;17;0,368421052631579;0,578947368421053
"5325";4733;76;5325;6;54;72;18;0,710526315789474;0,947368421052632
"5326";4733;76;5326;6;54;74;20;0,710526315789474;0,973684210526316
"5327";4733;76;5327;6;52;70;18;0,684210526315789;0,921052631578947
"5328";4733;76;5328;6;52;72;20;0,684210526315789;0,947368421052632
"5329";4733;76;5329;6;52;74;22;0,684210526315789;0,973684210526316
"5330";4733;76;5330;6;52;76;24;0,684210526315789;1
"5331";4733;76;5331;6;58;72;14;0,763157894736842;0,947368421052632
"5332";4733;76;5332;6;58;74;16;0,763157894736842;0,973684210526316
"5333";4733;76;5333;6;46;56;10;0,605263157894737;0,736842105263158
"5334";4733;76;5334;6;46;58;12;0,605263157894737;0,763157894736842
"5335";4733;76;5335;6;21;33;12;0,289473684210526;0,447368421052632
"5336";4733;76;5336;6;48;66;18;0,631578947368421;0,868421052631579
"5337";4733;76;5337;6;60;72;12;0,789473684210526;0,947368421052632
"5338";4733;76;5338;6;60;74;14;0,789473684210526;0,973684210526316
"5339";4733;76;5339;6;60;76;16;0,789473684210526;1
"5340";4733;76;5340;6;62;72;10;0,815789473684211;0,947368421052632
"5341";4733;76;5341;6;62;74;12;0,815789473684211;0,973684210526316
"5342";4733;76;5342;6;48;68;20;0,631578947368421;0,894736842105263
"5343";4733;76;5343;6;9;15;6;0,131578947368421;0,210526315789474
"5344";4867;97;5344;3;48;97;49;0,5;1
"5345";4867;97;5345;3;32;81;49;0,333333333333333;0,833333333333333
"5346";4867;97;5346;4;32;56;24;0,333333333333333;0,583333333333333
"5347";4867;97;5347;4;56;81;25;0,583333333333333;0,833333333333333
"5348";4867;97;5348;4;56;89;33;0,583333333333333;0,916666666666667
"5349";4867;97;5349;4;56;97;41;0,583333333333333;1
"5350";4867;97;5350;4;72;97;25;0,75;1
"5351";4867;97;5351;4;48;72;24;0,5;0,75
"5352";4867;97;5352;4;48;81;33;0,5;0,833333333333333
"5353";4867;97;5353;4;48;89;41;0,5;0,916666666666667
"5354";4867;97;5354;4;48;97;49;0,5;1
"5355";4867;97;5355;4;64;89;25;0,666666666666667;0,916666666666667
"5356";4867;97;5356;4;64;97;33;0,666666666666667;1
"5357";4867;97;5357;4;40;64;24;0,416666666666667;0,666666666666667
"5358";4867;97;5358;4;7;32;25;0,0833333333333333;0,333333333333333
"5359";4867;97;5359;4;40;72;32;0,416666666666667;0,75
"5360";4867;97;5360;4;40;81;41;0,416666666666667;0,833333333333333
"5361";4867;97;5361;5;36;48;12;0,375;0,5
"5362";4867;97;5362;5;7;19;12;0,0833333333333333;0,208333333333333
"5363";4867;97;5363;5;56;68;12;0,583333333333333;0,708333333333333
"5364";4867;97;5364;5;56;72;16;0,583333333333333;0,75
"5365";4867;97;5365;5;56;77;21;0,583333333333333;0,791666666666667
"5366";4867;97;5366;5;64;77;13;0,666666666666667;0,791666666666667
"5367";4867;97;5367;5;72;85;13;0,75;0,875
"5368";4867;97;5368;5;77;89;12;0,791666666666667;0,916666666666667
"5369";4867;97;5369;5;40;52;12;0,416666666666667;0,541666666666667
"5370";4867;97;5370;5;64;81;17;0,666666666666667;0,833333333333333
"5371";4867;97;5371;5;64;85;21;0,666666666666667;0,875
"5372";4867;97;5372;5;64;89;25;0,666666666666667;0,916666666666667
"5373";4867;97;5373;5;72;89;17;0,75;0,916666666666667
"5374";4867;97;5374;5;72;93;21;0,75;0,958333333333333
"5375";4867;97;5375;5;56;81;25;0,583333333333333;0,833333333333333
"5376";4867;97;5376;5;56;85;29;0,583333333333333;0,875
"5377";4867;97;5377;5;56;89;33;0,583333333333333;0,916666666666667
"5378";4867;97;5378;5;56;93;37;0,583333333333333;0,958333333333333
"5379";4867;97;5379;5;56;97;41;0,583333333333333;1
"5380";4867;97;5380;5;60;72;12;0,625;0,75
"5381";4867;97;5381;5;60;77;17;0,625;0,791666666666667
"5382";4867;97;5382;5;60;81;21;0,625;0,833333333333333
"5383";4867;97;5383;5;60;85;25;0,625;0,875
"5384";4867;97;5384;5;60;89;29;0,625;0,916666666666667
"5385";4867;97;5385;5;60;93;33;0,625;0,958333333333333
"5386";4867;97;5386;5;60;97;37;0,625;1
"5387";4867;97;5387;5;64;93;29;0,666666666666667;0,958333333333333
"5388";4867;97;5388;5;64;97;33;0,666666666666667;1
"5389";4867;97;5389;5;72;97;25;0,75;1
"5390";4867;97;5390;5;77;93;16;0,791666666666667;0,958333333333333
"5391";4867;97;5391;5;77;97;20;0,791666666666667;1
"5392";4867;97;5392;5;48;60;12;0,5;0,625
"5393";4867;97;5393;5;48;64;16;0,5;0,666666666666667
"5394";4867;97;5394;5;52;64;12;0,541666666666667;0,666666666666667
"5395";4867;97;5395;5;32;44;12;0,333333333333333;0,458333333333333
"5396";4867;97;5396;5;36;52;16;0,375;0,541666666666667
"5397";4867;97;5397;5;40;56;16;0,416666666666667;0,583333333333333
"5398";4867;97;5398;5;52;68;16;0,541666666666667;0,708333333333333
"5399";4867;97;5399;5;52;72;20;0,541666666666667;0,75
"5400";4867;97;5400;5;44;56;12;0,458333333333333;0,583333333333333
"5401";4867;97;5401;5;52;77;25;0,541666666666667;0,791666666666667
"5402";4867;97;5402;5;19;32;13;0,208333333333333;0,333333333333333
"5403";4867;97;5403;5;32;48;16;0,333333333333333;0,5
"5404";4867;97;5404;5;11;24;13;0,125;0,25
"5405";4867;97;5405;5;40;60;20;0,416666666666667;0,625
"5406";4867;97;5406;5;52;81;29;0,541666666666667;0,833333333333333
"5407";4867;97;5407;5;52;85;33;0,541666666666667;0,875
"5408";4867;97;5408;5;52;89;37;0,541666666666667;0,916666666666667
"5409";4867;97;5409;5;52;93;41;0,541666666666667;0,958333333333333
"5410";4867;97;5410;5;52;97;45;0,541666666666667;1
"5411";4867;97;5411;5;36;56;20;0,375;0,583333333333333
"5412";4867;97;5412;5;48;68;20;0,5;0,708333333333333
"5413";4867;97;5413;5;48;72;24;0,5;0,75
"5414";4867;97;5414;5;15;28;13;0,166666666666667;0,291666666666667
"5415";4867;97;5415;6;1;7;6;0,0204081632653061;0,0816326530612245
"5416";4867;97;5416;6;1;9;8;0,0204081632653061;0,102040816326531
"5417";4867;97;5417;6;3;9;6;0,0408163265306122;0,102040816326531
"5418";4867;97;5418;6;39;45;6;0,408163265306122;0,469387755102041
"5419";4867;97;5419;6;39;47;8;0,408163265306122;0,489795918367347
"5420";4867;97;5420;6;39;49;10;0,408163265306122;0,510204081632653
"5421";4867;97;5421;6;41;47;6;0,428571428571429;0,489795918367347
"5422";4867;97;5422;6;41;49;8;0,428571428571429;0,510204081632653
"5423";4867;97;5423;6;43;49;6;0,448979591836735;0,510204081632653
"5424";4867;97;5424;6;47;53;6;0,489795918367347;0,551020408163265
"5425";4867;97;5425;6;53;59;6;0,551020408163265;0,612244897959184
"5426";4867;97;5426;6;53;61;8;0,551020408163265;0,63265306122449
"5427";4867;97;5427;6;53;63;10;0,551020408163265;0,653061224489796
"5428";4867;97;5428;6;53;65;12;0,551020408163265;0,673469387755102
"5429";4867;97;5429;6;55;61;6;0,571428571428571;0,63265306122449
"5430";4867;97;5430;6;55;63;8;0,571428571428571;0,653061224489796
"5431";4867;97;5431;6;55;65;10;0,571428571428571;0,673469387755102
"5432";4867;97;5432;6;57;63;6;0,591836734693878;0,653061224489796
"5433";4867;97;5433;6;57;65;8;0,591836734693878;0,673469387755102
"5434";4867;97;5434;6;59;65;6;0,612244897959184;0,673469387755102
"5435";4867;97;5435;6;65;71;6;0,673469387755102;0,73469387755102
"5436";4867;97;5436;6;73;79;6;0,755102040816326;0,816326530612245
"5437";4867;97;5437;6;73;81;8;0,755102040816326;0,836734693877551
"5438";4867;97;5438;6;75;81;6;0,775510204081633;0,836734693877551
"5439";4867;97;5439;6;55;67;12;0,571428571428571;0,693877551020408
"5440";4867;97;5440;6;55;69;14;0,571428571428571;0,714285714285714
"5441";4867;97;5441;6;55;71;16;0,571428571428571;0,73469387755102
"5442";4867;97;5442;6;55;73;18;0,571428571428571;0,755102040816326
"5443";4867;97;5443;6;55;75;20;0,571428571428571;0,775510204081633
"5444";4867;97;5444;6;57;67;10;0,591836734693878;0,693877551020408
"5445";4867;97;5445;6;57;69;12;0,591836734693878;0,714285714285714
"5446";4867;97;5446;6;57;71;14;0,591836734693878;0,73469387755102
"5447";4867;97;5447;6;57;73;16;0,591836734693878;0,755102040816326
"5448";4867;97;5448;6;57;75;18;0,591836734693878;0,775510204081633
"5449";4867;97;5449;6;59;67;8;0,612244897959184;0,693877551020408
"5450";4867;97;5450;6;59;69;10;0,612244897959184;0,714285714285714
"5451";4867;97;5451;6;59;71;12;0,612244897959184;0,73469387755102
"5452";4867;97;5452;6;59;73;14;0,612244897959184;0,755102040816326
"5453";4867;97;5453;6;59;75;16;0,612244897959184;0,775510204081633
"5454";4867;97;5454;6;59;77;18;0,612244897959184;0,795918367346939
"5455";4867;97;5455;6;61;67;6;0,63265306122449;0,693877551020408
"5456";4867;97;5456;6;61;69;8;0,63265306122449;0,714285714285714
"5457";4867;97;5457;6;61;71;10;0,63265306122449;0,73469387755102
"5458";4867;97;5458;6;61;73;12;0,63265306122449;0,755102040816326
"5459";4867;97;5459;6;61;75;14;0,63265306122449;0,775510204081633
"5460";4867;97;5460;6;61;77;16;0,63265306122449;0,795918367346939
"5461";4867;97;5461;6;61;79;18;0,63265306122449;0,816326530612245
"5462";4867;97;5462;6;65;73;8;0,673469387755102;0,755102040816326
"5463";4867;97;5463;6;65;75;10;0,673469387755102;0,775510204081633
"5464";4867;97;5464;6;65;77;12;0,673469387755102;0,795918367346939
"5465";4867;97;5465;6;65;79;14;0,673469387755102;0,816326530612245
"5466";4867;97;5466;6;65;81;16;0,673469387755102;0,836734693877551
"5467";4867;97;5467;6;73;83;10;0,755102040816326;0,857142857142857
"5468";4867;97;5468;6;73;85;12;0,755102040816326;0,877551020408163
"5469";4867;97;5469;6;73;87;14;0,755102040816326;0,897959183673469
"5470";4867;97;5470;6;73;89;16;0,755102040816326;0,918367346938776
"5471";4867;97;5471;6;73;91;18;0,755102040816326;0,938775510204082
"5472";4867;97;5472;6;75;83;8;0,775510204081633;0,857142857142857
"5473";4867;97;5473;6;75;85;10;0,775510204081633;0,877551020408163
"5474";4867;97;5474;6;75;87;12;0,775510204081633;0,897959183673469
"5475";4867;97;5475;6;75;89;14;0,775510204081633;0,918367346938776
"5476";4867;97;5476;6;75;91;16;0,775510204081633;0,938775510204082
"5477";4867;97;5477;6;15;21;6;0,163265306122449;0,224489795918367
"5478";4867;97;5478;6;37;43;6;0,387755102040816;0,448979591836735
"5479";4867;97;5479;6;39;51;12;0,408163265306122;0,530612244897959
"5480";4867;97;5480;6;39;53;14;0,408163265306122;0,551020408163265
"5481";4867;97;5481;6;41;51;10;0,428571428571429;0,530612244897959
"5482";4867;97;5482;6;43;51;8;0,448979591836735;0,530612244897959
"5483";4867;97;5483;6;49;55;6;0,510204081632653;0,571428571428571
"5484";4867;97;5484;6;57;77;20;0,591836734693878;0,795918367346939
"5485";4867;97;5485;6;57;79;22;0,591836734693878;0,816326530612245
"5486";4867;97;5486;6;57;81;24;0,591836734693878;0,836734693877551
"5487";4867;97;5487;6;57;83;26;0,591836734693878;0,857142857142857
"5488";4867;97;5488;6;57;85;28;0,591836734693878;0,877551020408163
"5489";4867;97;5489;6;57;87;30;0,591836734693878;0,897959183673469
"5490";4867;97;5490;6;57;89;32;0,591836734693878;0,918367346938776
"5491";4867;97;5491;6;59;79;20;0,612244897959184;0,816326530612245
"5492";4867;97;5492;6;59;81;22;0,612244897959184;0,836734693877551
"5493";4867;97;5493;6;59;83;24;0,612244897959184;0,857142857142857
"5494";4867;97;5494;6;59;85;26;0,612244897959184;0,877551020408163
"5495";4867;97;5495;6;59;87;28;0,612244897959184;0,897959183673469
"5496";4867;97;5496;6;59;89;30;0,612244897959184;0,918367346938776
"5497";4867;97;5497;6;61;81;20;0,63265306122449;0,836734693877551
"5498";4867;97;5498;6;61;83;22;0,63265306122449;0,857142857142857
"5499";4867;97;5499;6;61;85;24;0,63265306122449;0,877551020408163
"5500";4867;97;5500;6;65;83;18;0,673469387755102;0,857142857142857
"5501";4867;97;5501;6;65;85;20;0,673469387755102;0,877551020408163
"5502";4867;97;5502;6;65;87;22;0,673469387755102;0,897959183673469
"5503";4867;97;5503;6;27;33;6;0,285714285714286;0,346938775510204
"5504";4867;97;5504;6;17;23;6;0,183673469387755;0,244897959183673
"5505";4867;97;5505;6;47;55;8;0,489795918367347;0,571428571428571
"5506";4867;97;5506;6;37;45;8;0,387755102040816;0,469387755102041
"5507";4867;97;5507;6;23;29;6;0,244897959183673;0,306122448979592
"5508";4867;97;5508;6;37;47;10;0,387755102040816;0,489795918367347
"5509";4867;97;5509;6;37;49;12;0,387755102040816;0,510204081632653
"5510";4867;97;5510;6;37;51;14;0,387755102040816;0,530612244897959
"5511";4867;97;5511;6;41;53;12;0,428571428571429;0,551020408163265
"5512";4867;97;5512;6;43;53;10;0,448979591836735;0,551020408163265
"5513";4867;97;5513;6;49;57;8;0,510204081632653;0,591836734693878
"5514";4867;97;5514;6;53;67;14;0,551020408163265;0,693877551020408
"5515";4867;97;5515;6;75;93;18;0,775510204081633;0,959183673469388
"5516";4867;97;5516;6;75;95;20;0,775510204081633;0,979591836734694
"5517";4867;97;5517;6;35;41;6;0,36734693877551;0,428571428571429
"5518";4867;97;5518;6;37;53;16;0,387755102040816;0,551020408163265
"5519";4867;97;5519;6;33;39;6;0,346938775510204;0,408163265306122
"5520";4867;97;5520;6;49;59;10;0,510204081632653;0,612244897959184
"5521";4867;97;5521;6;73;93;20;0,755102040816326;0,959183673469388
"5522";4867;97;5522;6;53;69;16;0,551020408163265;0,714285714285714
"5523";4867;97;5523;6;53;71;18;0,551020408163265;0,73469387755102
"5524";4867;97;5524;6;53;73;20;0,551020408163265;0,755102040816326
"5525";4867;97;5525;6;53;75;22;0,551020408163265;0,775510204081633
"5526";4867;97;5526;6;53;77;24;0,551020408163265;0,795918367346939
"5527";4867;97;5527;6;55;77;22;0,571428571428571;0,795918367346939
"5528";4867;97;5528;6;13;19;6;0,142857142857143;0,204081632653061
"5529";4867;97;5529;6;55;79;24;0,571428571428571;0,816326530612245
"5530";4867;97;5530;6;55;81;26;0,571428571428571;0,836734693877551
"5531";4867;97;5531;6;55;83;28;0,571428571428571;0,857142857142857
"5532";4867;97;5532;6;55;85;30;0,571428571428571;0,877551020408163
"5533";4867;97;5533;6;61;87;26;0,63265306122449;0,897959183673469
"5534";4867;97;5534;6;65;89;24;0,673469387755102;0,918367346938776
"5535";4867;97;5535;6;73;95;22;0,755102040816326;0,979591836734694
"5536";4867;97;5536;6;75;97;22;0,775510204081633;1
"5537";4867;97;5537;6;73;97;24;0,755102040816326;1
"5538";4867;97;5538;6;55;87;32;0,571428571428571;0,897959183673469
"5539";4867;97;5539;6;61;89;28;0,63265306122449;0,918367346938776
"5540";4867;97;5540;6;61;91;30;0,63265306122449;0,938775510204082
"5541";4867;97;5541;6;65;91;26;0,673469387755102;0,938775510204082
"5542";4867;97;5542;6;11;17;6;0,122448979591837;0,183673469387755
"5543";4867;97;5543;6;55;89;34;0,571428571428571;0,918367346938776
"5544";4875;79;5544;3;31;79;48;0,4;1
"5545";4875;79;5545;4;47;71;24;0,6;0,9
"5546";4875;79;5546;4;55;79;24;0,7;1
"5547";4875;79;5547;4;39;63;24;0,5;0,8
"5548";4875;79;5548;4;39;71;32;0,5;0,9
"5549";4875;79;5549;4;47;79;32;0,6;1
"5550";4875;79;5550;4;7;31;24;0,1;0,4
"5551";4875;79;5551;5;3;15;12;0,05;0,2
"5552";4875;79;5552;5;15;27;12;0,2;0,35
"5553";4875;79;5553;5;19;31;12;0,25;0,4
"5554";4875;79;5554;5;59;71;12;0,75;0,9
"5555";4875;79;5555;5;63;75;12;0,8;0,95
"5556";4875;79;5556;5;63;79;16;0,8;1
"5557";4875;79;5557;5;43;55;12;0,55;0,7
"5558";4875;79;5558;5;47;59;12;0,6;0,75
"5559";4875;79;5559;5;35;47;12;0,45;0,6
"5560";4875;79;5560;5;43;59;16;0,55;0,75
"5561";4875;79;5561;5;39;51;12;0,5;0,65
"5562";4875;79;5562;5;59;75;16;0,75;0,95
"5563";4875;79;5563;5;67;79;12;0,85;1
"5564";4875;79;5564;5;47;63;16;0,6;0,8
"5565";4875;79;5565;5;51;63;12;0,65;0,8
"5566";4875;79;5566;5;51;67;16;0,65;0,85
"5567";4875;79;5567;5;51;71;20;0,65;0,9
"5568";4875;79;5568;5;59;79;20;0,75;1
"5569";4875;79;5569;5;55;67;12;0,7;0,85
"5570";4875;79;5570;5;55;71;16;0,7;0,9
"5571";4875;79;5571;5;11;23;12;0,15;0,3
"5572";4875;79;5572;5;7;19;12;0,1;0,25
"5573";4875;79;5573;5;55;75;20;0,7;0,95
"5574";4875;79;5574;6;7;13;6;0,1;0,175
"5575";4875;79;5575;6;9;15;6;0,125;0,2
"5576";4875;79;5576;6;5;11;6;0,075;0,15
"5577";4875;79;5577;6;21;27;6;0,275;0,35
"5578";4875;79;5578;6;23;29;6;0,3;0,375
"5579";4875;79;5579;6;45;51;6;0,575;0,65
"5580";4875;79;5580;6;47;53;6;0,6;0,675
"5581";4875;79;5581;6;49;55;6;0,625;0,7
"5582";4875;79;5582;6;71;77;6;0,9;0,975
"5583";4875;79;5583;6;71;79;8;0,9;1
"5584";4875;79;5584;6;11;17;6;0,15;0,225
"5585";4875;79;5585;6;19;25;6;0,25;0,325
"5586";4875;79;5586;6;19;27;8;0,25;0,35
"5587";4875;79;5587;6;21;29;8;0,275;0,375
"5588";4875;79;5588;6;23;31;8;0,3;0,4
"5589";4875;79;5589;6;33;39;6;0,425;0,5
"5590";4875;79;5590;6;47;55;8;0,6;0,7
"5591";4875;79;5591;6;51;57;6;0,65;0,725
"5592";4875;79;5592;6;61;67;6;0,775;0,85
"5593";4875;79;5593;6;53;59;6;0,675;0,75
"5594";4875;79;5594;6;59;65;6;0,75;0,825
"5595";4875;79;5595;6;73;79;6;0,925;1
"5596";4875;79;5596;6;49;57;8;0,625;0,725
"5597";4875;79;5597;6;25;31;6;0,325;0,4
"5598";4875;79;5598;6;51;59;8;0,65;0,75
"5599";4875;79;5599;6;59;67;8;0,75;0,85
"5600";4875;79;5600;6;59;69;10;0,75;0,875
"5601";4875;79;5601;6;59;71;12;0,75;0,9
"5602";4875;79;5602;6;63;69;6;0,8;0,875
"5603";4875;79;5603;6;69;75;6;0,875;0,95
"5604";4875;79;5604;6;17;23;6;0,225;0,3
"5605";4875;79;5605;6;47;57;10;0,6;0,725
"5606";4875;79;5606;6;47;59;12;0,6;0,75
"5607";4875;79;5607;6;49;59;10;0,625;0,75
"5608";4875;79;5608;6;57;63;6;0,725;0,8
"5609";4875;79;5609;6;59;73;14;0,75;0,925
"5610";4875;79;5610;6;61;69;8;0,775;0,875
"5611";4875;79;5611;6;61;71;10;0,775;0,9
"5612";4875;79;5612;6;61;73;12;0,775;0,925
"5613";4875;79;5613;6;63;71;8;0,8;0,9
"5614";4875;79;5614;6;63;73;10;0,8;0,925
"5615";4875;79;5615;6;63;75;12;0,8;0,95
"5616";4875;79;5616;6;65;71;6;0,825;0,9
"5617";4875;79;5617;6;65;73;8;0,825;0,925
"5618";4875;79;5618;6;65;75;10;0,825;0,95
"5619";4875;79;5619;6;69;77;8;0,875;0,975
"5620";4875;79;5620;6;45;53;8;0,575;0,675
"5621";4875;79;5621;6;45;55;10;0,575;0,7
"5622";4875;79;5622;6;45;57;12;0,575;0,725
"5623";4875;79;5623;6;43;49;6;0,55;0,625
"5624";4875;79;5624;6;67;73;6;0,85;0,925
"5625";4875;79;5625;6;9;17;8;0,125;0,225
"5626";4875;79;5626;6;13;19;6;0,175;0,25
"5627";4875;79;5627;6;39;45;6;0,5;0,575
"5628";4875;79;5628;6;57;65;8;0,725;0,825
"5629";4875;79;5629;6;69;79;10;0,875;1
"5630";4875;79;5630;6;1;7;6;0,025;0,1
"5631";4875;79;5631;6;21;31;10;0,275;0,4
"5632";4875;79;5632;6;35;41;6;0,45;0,525
"5633";4875;79;5633;6;35;43;8;0,45;0,55
"5634";4875;79;5634;6;49;61;12;0,625;0,775
"5635";4875;79;5635;6;63;77;14;0,8;0,975
"5636";4875;79;5636;6;59;75;16;0,75;0,95
"5637";4875;79;5637;6;55;61;6;0,7;0,775
"5638";4875;79;5638;6;3;9;6;0,05;0,125
"5639";4875;79;5639;6;43;51;8;0,55;0,65
"5640";4875;79;5640;6;51;61;10;0,65;0,775
"5641";4875;79;5641;6;53;61;8;0,675;0,775
"5642";4875;79;5642;6;37;43;6;0,475;0,55
"5643";4875;79;5643;6;57;67;10;0,725;0,85
"5644";4936;90;5644;4;16;40;24;0,181818181818182;0,454545454545455
"5645";4936;90;5645;4;65;90;25;0,727272727272727;1
"5646";4936;90;5646;5;49;61;12;0,545454545454545;0,681818181818182
"5647";4936;90;5647;5;73;86;13;0,818181818181818;0,954545454545455
"5648";4936;90;5648;5;78;90;12;0,863636363636364;1
"5649";4936;90;5649;5;20;32;12;0,227272727272727;0,363636363636364
"5650";4936;90;5650;5;73;90;17;0,818181818181818;1
"5651";4936;90;5651;5;69;82;13;0,772727272727273;0,909090909090909
"5652";4936;90;5652;5;69;86;17;0,772727272727273;0,954545454545455
"5653";4936;90;5653;5;3;16;13;0,0454545454545455;0,181818181818182
"5654";4936;90;5654;5;65;78;13;0,727272727272727;0,863636363636364
"5655";4936;90;5655;6;11;17;6;0,133333333333333;0,2
"5656";4936;90;5656;6;21;27;6;0,244444444444444;0,311111111111111
"5657";4936;90;5657;6;37;43;6;0,422222222222222;0,488888888888889
"5658";4936;90;5658;6;50;56;6;0,555555555555556;0,622222222222222
"5659";4936;90;5659;6;70;76;6;0,777777777777778;0,844444444444444
"5660";4936;90;5660;6;76;82;6;0,844444444444444;0,911111111111111
"5661";4936;90;5661;6;7;13;6;0,0888888888888889;0,155555555555556
"5662";4936;90;5662;6;21;29;8;0,244444444444444;0,333333333333333
"5663";4936;90;5663;6;23;29;6;0,266666666666667;0,333333333333333
"5664";4936;90;5664;6;37;46;9;0,422222222222222;0,511111111111111
"5665";4936;90;5665;6;50;58;8;0,555555555555556;0,644444444444444
"5666";4936;90;5666;6;50;60;10;0,555555555555556;0,666666666666667
"5667";4936;90;5667;6;50;62;12;0,555555555555556;0,688888888888889
"5668";4936;90;5668;6;50;64;14;0,555555555555556;0,711111111111111
"5669";4936;90;5669;6;31;37;6;0,355555555555556;0,422222222222222
"5670";4936;90;5670;6;13;19;6;0,155555555555556;0,222222222222222
"5671";4936;90;5671;6;7;15;8;0,0888888888888889;0,177777777777778
"5672";4936;90;5672;6;39;46;7;0,444444444444444;0,511111111111111
"5673";4936;90;5673;6;70;78;8;0,777777777777778;0,866666666666667
"5674";4936;90;5674;6;76;84;8;0,844444444444444;0,933333333333333
"5675";4936;90;5675;6;76;86;10;0,844444444444444;0,955555555555556
"5676";4936;90;5676;6;76;88;12;0,844444444444444;0,977777777777778
"5677";4936;90;5677;6;76;90;14;0,844444444444444;1
"5678";4936;90;5678;6;68;74;6;0,755555555555556;0,822222222222222
"5679";4936;90;5679;6;5;11;6;0,0666666666666667;0,133333333333333
"5680";4936;90;5680;6;7;17;10;0,0888888888888889;0,2
"5681";4936;90;5681;6;9;15;6;0,111111111111111;0,177777777777778
"5682";4936;90;5682;6;9;17;8;0,111111111111111;0,2
"5683";4936;90;5683;6;11;19;8;0,133333333333333;0,222222222222222
"5684";4936;90;5684;6;68;76;8;0,755555555555556;0,844444444444444
"5685";4936;90;5685;6;66;72;6;0,733333333333333;0,8
"5686";4936;90;5686;6;29;35;6;0,333333333333333;0,4
"5687";4936;90;5687;6;21;31;10;0,244444444444444;0,355555555555556
"5688";4936;90;5688;6;29;37;8;0,333333333333333;0,422222222222222
"5689";4936;90;5689;6;64;70;6;0,711111111111111;0,777777777777778
"5690";4936;90;5690;6;19;25;6;0,222222222222222;0,288888888888889
"5691";5002;63;5691;5;27;39;12;0,4375;0,625
"5692";5002;63;5692;5;11;23;12;0,1875;0,375
"5693";5002;63;5693;5;23;35;12;0,375;0,5625
"5694";5002;63;5694;5;31;43;12;0,5;0,6875
"5695";5002;63;5695;6;27;33;6;0,4375;0,53125
"5696";5002;63;5696;6;55;61;6;0,875;0,96875
"5697";5002;63;5697;6;57;63;6;0,90625;1
"5698";5002;63;5698;6;35;41;6;0,5625;0,65625
"5699";5002;63;5699;6;17;23;6;0,28125;0,375
"5700";5002;63;5700;6;29;35;6;0,46875;0,5625
"5701";5002;63;5701;6;33;39;6;0,53125;0,625
"5702";5002;63;5702;6;41;47;6;0,65625;0,75
"5703";5002;63;5703;6;55;63;8;0,875;1
"5704";5002;63;5704;6;43;49;6;0,6875;0,78125
"5705";5002;63;5705;6;25;31;6;0,40625;0,5
"5706";5002;63;5706;6;23;29;6;0,375;0,46875
"5707";5002;63;5707;6;15;21;6;0,25;0,34375
"5708";5002;63;5708;6;3;9;6;0,0625;0,15625
"5709";5002;63;5709;6;1;7;6;0,03125;0,125
"5710";5002;63;5710;6;27;35;8;0,4375;0,5625
"5711";5002;63;5711;6;31;37;6;0,5;0,59375
"5712";5002;63;5712;6;53;59;6;0,84375;0,9375
"5713";5147;169;5713;3;67;169;102;0,4;1
"5714";5147;169;5714;4;101;152;51;0,6;0,9
"5715";5147;169;5715;4;101;169;68;0,6;1
"5716";5147;169;5716;4;118;169;51;0,7;1
"5717";5147;169;5717;4;84;135;51;0,5;0,8
"5718";5147;169;5718;4;50;101;51;0,3;0,6
"5719";5147;169;5719;4;84;152;68;0,5;0,9
"5720";5147;169;5720;4;67;118;51;0,4;0,7
"5721";5147;169;5721;4;33;84;51;0,2;0,5
"5722";5147;169;5722;5;120;145;25;0,714285714285714;0,857142857142857
"5723";5147;169;5723;5;137;161;24;0,80952380952381;0,952380952380952
"5724";5147;169;5724;5;137;169;32;0,80952380952381;1
"5725";5147;169;5725;5;145;169;24;0,857142857142857;1
"5726";5147;169;5726;5;80;104;24;0,476190476190476;0,619047619047619
"5727";5147;169;5727;5;88;112;24;0,523809523809524;0,666666666666667
"5728";5147;169;5728;5;39;64;25;0,238095238095238;0,380952380952381
"5729";5147;169;5729;5;96;120;24;0,571428571428571;0,714285714285714
"5730";5147;169;5730;5;112;137;25;0,666666666666667;0,80952380952381
"5731";5147;169;5731;5;112;145;33;0,666666666666667;0,857142857142857
"5732";5147;169;5732;5;112;153;41;0,666666666666667;0,904761904761905
"5733";5147;169;5733;5;112;161;49;0,666666666666667;0,952380952380952
"5734";5147;169;5734;5;112;169;57;0,666666666666667;1
"5735";5147;169;5735;5;120;153;33;0,714285714285714;0,904761904761905
"5736";5147;169;5736;5;120;161;41;0,714285714285714;0,952380952380952
"5737";5147;169;5737;5;120;169;49;0,714285714285714;1
"5738";5147;169;5738;5;56;80;24;0,333333333333333;0,476190476190476
"5739";5147;169;5739;5;7;31;24;0,0476190476190476;0,19047619047619
"5740";5147;169;5740;5;15;39;24;0,0952380952380952;0,238095238095238
"5741";5147;169;5741;5;104;129;25;0,619047619047619;0,761904761904762
"5742";5147;169;5742;5;129;153;24;0,761904761904762;0,904761904761905
"5743";5147;169;5743;5;129;161;32;0,761904761904762;0,952380952380952
"5744";5147;169;5744;5;129;169;40;0,761904761904762;1
"5745";5147;169;5745;5;96;129;33;0,571428571428571;0,761904761904762
"5746";5147;169;5746;5;96;137;41;0,571428571428571;0,80952380952381
"5747";5147;169;5747;5;96;145;49;0,571428571428571;0,857142857142857
"5748";5147;169;5748;5;96;153;57;0,571428571428571;0,904761904761905
"5749";5147;169;5749;5;96;161;65;0,571428571428571;0,952380952380952
"5750";5147;169;5750;5;104;137;33;0,619047619047619;0,80952380952381
"5751";5147;169;5751;5;104;145;41;0,619047619047619;0,857142857142857
"5752";5147;169;5752;5;104;153;49;0,619047619047619;0,904761904761905
"5753";5147;169;5753;5;104;161;57;0,619047619047619;0,952380952380952
"5754";5147;169;5754;5;48;72;24;0,285714285714286;0,428571428571429
"5755";5147;169;5755;5;104;169;65;0,619047619047619;1
"5756";5147;169;5756;5;64;88;24;0,380952380952381;0,523809523809524
"5757";5147;169;5757;5;80;112;32;0,476190476190476;0,666666666666667
"5758";5147;169;5758;5;72;96;24;0,428571428571429;0,571428571428571
"5759";5147;169;5759;5;88;120;32;0,523809523809524;0,714285714285714
"5760";5147;169;5760;6;84;96;12;0,5;0,571428571428571
"5761";5147;169;5761;6;100;112;12;0,595238095238095;0,666666666666667
"5762";5147;169;5762;6;112;124;12;0,666666666666667;0,738095238095238
"5763";5147;169;5763;6;112;129;17;0,666666666666667;0,761904761904762
"5764";5147;169;5764;6;120;133;13;0,714285714285714;0,785714285714286
"5765";5147;169;5765;6;141;153;12;0,833333333333333;0,904761904761905
"5766";5147;169;5766;6;145;157;12;0,857142857142857;0,928571428571429
"5767";5147;169;5767;6;157;169;12;0,928571428571429;1
"5768";5147;169;5768;6;39;52;13;0,238095238095238;0,30952380952381
"5769";5147;169;5769;6;84;100;16;0,5;0,595238095238095
"5770";5147;169;5770;6;88;100;12;0,523809523809524;0,595238095238095
"5771";5147;169;5771;6;92;104;12;0,547619047619048;0,619047619047619
"5772";5147;169;5772;6;92;108;16;0,547619047619048;0,642857142857143
"5773";5147;169;5773;6;96;108;12;0,571428571428571;0,642857142857143
"5774";5147;169;5774;6;96;112;16;0,571428571428571;0,666666666666667
"5775";5147;169;5775;6;100;116;16;0,595238095238095;0,69047619047619
"5776";5147;169;5776;6;116;129;13;0,69047619047619;0,761904761904762
"5777";5147;169;5777;6;116;133;17;0,69047619047619;0,785714285714286
"5778";5147;169;5778;6;120;137;17;0,714285714285714;0,80952380952381
"5779";5147;169;5779;6;120;141;21;0,714285714285714;0,833333333333333
"5780";5147;169;5780;6;120;145;25;0,714285714285714;0,857142857142857
"5781";5147;169;5781;6;124;137;13;0,738095238095238;0,80952380952381
"5782";5147;169;5782;6;124;141;17;0,738095238095238;0,833333333333333
"5783";5147;169;5783;6;137;149;12;0,80952380952381;0,880952380952381
"5784";5147;169;5784;6;137;153;16;0,80952380952381;0,904761904761905
"5785";5147;169;5785;6;141;157;16;0,833333333333333;0,928571428571429
"5786";5147;169;5786;6;141;161;20;0,833333333333333;0,952380952380952
"5787";5147;169;5787;6;141;165;24;0,833333333333333;0,976190476190476
"5788";5147;169;5788;6;141;169;28;0,833333333333333;1
"5789";5147;169;5789;6;145;161;16;0,857142857142857;0,952380952380952
"5790";5147;169;5790;6;145;165;20;0,857142857142857;0,976190476190476
"5791";5147;169;5791;6;145;169;24;0,857142857142857;1
"5792";5147;169;5792;6;149;161;12;0,880952380952381;0,952380952380952
"5793";5147;169;5793;6;149;165;16;0,880952380952381;0,976190476190476
"5794";5147;169;5794;6;149;169;20;0,880952380952381;1
"5795";5147;169;5795;6;52;64;12;0,30952380952381;0,380952380952381
"5796";5147;169;5796;6;56;68;12;0,333333333333333;0,404761904761905
"5797";5147;169;5797;6;64;76;12;0,380952380952381;0,452380952380952
"5798";5147;169;5798;6;88;104;16;0,523809523809524;0,619047619047619
"5799";5147;169;5799;6;88;108;20;0,523809523809524;0,642857142857143
"5800";5147;169;5800;6;88;112;24;0,523809523809524;0,666666666666667
"5801";5147;169;5801;6;92;112;20;0,547619047619048;0,666666666666667
"5802";5147;169;5802;6;104;116;12;0,619047619047619;0,69047619047619
"5803";5147;169;5803;6;116;137;21;0,69047619047619;0,80952380952381
"5804";5147;169;5804;6;116;141;25;0,69047619047619;0,833333333333333
"5805";5147;169;5805;6;116;145;29;0,69047619047619;0,857142857142857
"5806";5147;169;5806;6;120;149;29;0,714285714285714;0,880952380952381
"5807";5147;169;5807;6;120;153;33;0,714285714285714;0,904761904761905
"5808";5147;169;5808;6;120;157;37;0,714285714285714;0,928571428571429
"5809";5147;169;5809;6;120;161;41;0,714285714285714;0,952380952380952
"5810";5147;169;5810;6;120;165;45;0,714285714285714;0,976190476190476
"5811";5147;169;5811;6;124;145;21;0,738095238095238;0,857142857142857
"5812";5147;169;5812;6;124;149;25;0,738095238095238;0,880952380952381
"5813";5147;169;5813;6;124;153;29;0,738095238095238;0,904761904761905
"5814";5147;169;5814;6;137;157;20;0,80952380952381;0,928571428571429
"5815";5147;169;5815;6;137;161;24;0,80952380952381;0,952380952380952
"5816";5147;169;5816;6;137;165;28;0,80952380952381;0,976190476190476
"5817";5147;169;5817;6;60;72;12;0,357142857142857;0,428571428571429
"5818";5147;169;5818;6;100;120;20;0,595238095238095;0,714285714285714
"5819";5147;169;5819;6;100;124;24;0,595238095238095;0,738095238095238
"5820";5147;169;5820;6;23;35;12;0,142857142857143;0,214285714285714
"5821";5147;169;5821;6;44;56;12;0,261904761904762;0,333333333333333
"5822";5147;169;5822;6;76;88;12;0,452380952380952;0,523809523809524
"5823";5147;169;5823;6;129;141;12;0,761904761904762;0,833333333333333
"5824";5147;169;5824;6;129;145;16;0,761904761904762;0,857142857142857
"5825";5147;169;5825;6;153;165;12;0,904761904761905;0,976190476190476
"5826";5147;169;5826;6;153;169;16;0,904761904761905;1
"5827";5147;169;5827;6;48;60;12;0,285714285714286;0,357142857142857
"5828";5147;169;5828;6;80;92;12;0,476190476190476;0,547619047619048
"5829";5147;169;5829;6;112;133;21;0,666666666666667;0,785714285714286
"5830";5147;169;5830;6;133;145;12;0,785714285714286;0,857142857142857
"5831";5147;169;5831;6;133;149;16;0,785714285714286;0,880952380952381
"5832";5147;169;5832;6;133;153;20;0,785714285714286;0,904761904761905
"5833";5147;169;5833;6;133;157;24;0,785714285714286;0,928571428571429
"5834";5147;169;5834;6;64;80;16;0,380952380952381;0,476190476190476
"5835";5147;169;5835;6;112;137;25;0,666666666666667;0,80952380952381
"5836";5147;169;5836;6;68;80;12;0,404761904761905;0,476190476190476
"5837";5147;169;5837;6;92;116;24;0,547619047619048;0,69047619047619
"5838";5147;169;5838;6;137;169;32;0,80952380952381;1
"5839";5147;169;5839;6;84;104;20;0,5;0,619047619047619
"5840";5147;169;5840;6;96;116;20;0,571428571428571;0,69047619047619
"5841";5147;169;5841;6;104;120;16;0,619047619047619;0,714285714285714
"5842";5147;169;5842;6;112;141;29;0,666666666666667;0,833333333333333
"5843";5147;169;5843;6;112;145;33;0,666666666666667;0,857142857142857
"5844";5147;169;5844;6;112;149;37;0,666666666666667;0,880952380952381
"5845";5147;169;5845;6;112;153;41;0,666666666666667;0,904761904761905
"5846";5147;169;5846;6;120;169;49;0,714285714285714;1
"5847";5147;169;5847;6;124;157;33;0,738095238095238;0,928571428571429
"5848";5147;169;5848;6;124;161;37;0,738095238095238;0,952380952380952
"5849";5147;169;5849;6;124;165;41;0,738095238095238;0,976190476190476
"5850";5147;169;5850;6;124;169;45;0,738095238095238;1
"5851";5147;169;5851;6;19;31;12;0,119047619047619;0,19047619047619
"5852";5147;169;5852;6;116;149;33;0,69047619047619;0,880952380952381
"5853";5147;169;5853;6;116;153;37;0,69047619047619;0,904761904761905
"5854";5147;169;5854;6;116;157;41;0,69047619047619;0,928571428571429
"5855";5147;169;5855;6;104;124;20;0,619047619047619;0,738095238095238
"5856";5147;169;5856;6;104;129;25;0,619047619047619;0,761904761904762
"5857";5147;169;5857;6;116;161;45;0,69047619047619;0,952380952380952
"5858";5147;169;5858;6;116;165;49;0,69047619047619;0,976190476190476
"5859";5147;169;5859;6;116;169;53;0,69047619047619;1
"5860";5147;169;5860;6;88;116;28;0,523809523809524;0,69047619047619
"5861";5147;169;5861;6;133;161;28;0,785714285714286;0,952380952380952
"5862";5147;169;5862;6;133;165;32;0,785714285714286;0,976190476190476
"5863";5147;169;5863;6;133;169;36;0,785714285714286;1
"5864";5147;169;5864;6;48;64;16;0,285714285714286;0,380952380952381
"5865";5147;169;5865;6;129;149;20;0,761904761904762;0,880952380952381
"5866";5147;169;5866;6;129;153;24;0,761904761904762;0,904761904761905
"5867";5147;169;5867;6;129;157;28;0,761904761904762;0,928571428571429
"5868";5147;169;5868;6;129;161;32;0,761904761904762;0,952380952380952
"5869";5147;169;5869;6;129;165;36;0,761904761904762;0,976190476190476
"5870";5147;169;5870;6;68;84;16;0,404761904761905;0,5
"5871";5147;169;5871;6;27;39;12;0,166666666666667;0,238095238095238
"5872";5147;169;5872;6;96;120;24;0,571428571428571;0,714285714285714
"5873";5147;169;5873;6;52;68;16;0,30952380952381;0,404761904761905
"5874";5147;169;5874;6;92;120;28;0,547619047619048;0,714285714285714
"5875";5147;169;5875;6;72;84;12;0,428571428571429;0,5
"5876";5147;169;5876;6;11;23;12;0,0714285714285714;0,142857142857143
"5877";5147;169;5877;6;80;96;16;0,476190476190476;0,571428571428571
"5878";5147;169;5878;6;129;169;40;0,761904761904762;1
"5879";5163;86;5879;4;16;42;26;0,2;0,5
"5880";5163;86;5880;5;28;40;12;0,333333333333333;0,476190476190476
"5881";5163;86;5881;5;20;32;12;0,238095238095238;0,380952380952381
"5882";5163;86;5882;5;16;28;12;0,19047619047619;0,333333333333333
"5883";5163;86;5883;5;61;74;13;0,714285714285714;0,857142857142857
"5884";5163;86;5884;5;61;78;17;0,714285714285714;0,904761904761905
"5885";5163;86;5885;5;28;45;17;0,333333333333333;0,523809523809524
"5886";5163;86;5886;5;24;36;12;0,285714285714286;0,428571428571429
"5887";5163;86;5887;5;24;40;16;0,285714285714286;0,476190476190476
"5888";5163;86;5888;5;24;45;21;0,285714285714286;0,523809523809524
"5889";5163;86;5889;5;32;45;13;0,380952380952381;0,523809523809524
"5890";5163;86;5890;5;20;36;16;0,238095238095238;0,428571428571429
"5891";5163;86;5891;5;20;40;20;0,238095238095238;0,476190476190476
"5892";5163;86;5892;5;11;24;13;0,142857142857143;0,285714285714286
"5893";5163;86;5893;5;16;32;16;0,19047619047619;0,380952380952381
"5894";5163;86;5894;6;21;27;6;0,255813953488372;0,325581395348837
"5895";5163;86;5895;6;23;29;6;0,27906976744186;0,348837209302326
"5896";5163;86;5896;6;62;68;6;0,720930232558139;0,790697674418605
"5897";5163;86;5897;6;62;70;8;0,720930232558139;0,813953488372093
"5898";5163;86;5898;6;78;84;6;0,906976744186046;0,976744186046512
"5899";5163;86;5899;6;78;86;8;0,906976744186046;1
"5900";5163;86;5900;6;17;23;6;0,209302325581395;0,27906976744186
"5901";5163;86;5901;6;21;29;8;0,255813953488372;0,348837209302326
"5902";5163;86;5902;6;19;25;6;0,232558139534884;0,302325581395349
"5903";5163;86;5903;6;23;31;8;0,27906976744186;0,372093023255814
"5904";5163;86;5904;6;25;31;6;0,302325581395349;0,372093023255814
"5905";5163;86;5905;6;39;46;7;0,465116279069767;0,534883720930233
"5906";5163;86;5906;6;19;27;8;0,232558139534884;0,325581395348837
"5907";5163;86;5907;6;62;72;10;0,720930232558139;0,837209302325581
"5908";5163;86;5908;6;62;74;12;0,720930232558139;0,86046511627907
"5909";5163;86;5909;6;62;76;14;0,720930232558139;0,883720930232558
"5910";5163;86;5910;6;58;64;6;0,674418604651163;0,744186046511628
"5911";5163;86;5911;6;19;29;10;0,232558139534884;0,348837209302326
"5912";5163;86;5912;6;21;31;10;0,255813953488372;0,372093023255814
"5913";5163;86;5913;6;37;44;7;0,441860465116279;0,511627906976744
"5914";5163;86;5914;6;19;31;12;0,232558139534884;0,372093023255814
"5915";5163;86;5915;6;13;19;6;0,162790697674419;0,232558139534884
"5916";5163;86;5916;6;15;21;6;0,186046511627907;0,255813953488372
"5917";5163;86;5917;6;17;25;8;0,209302325581395;0,302325581395349
"5918";5163;86;5918;6;60;66;6;0,697674418604651;0,767441860465116
"5919";5163;86;5919;6;60;68;8;0,697674418604651;0,790697674418605
"5920";5163;86;5920;6;62;78;16;0,720930232558139;0,906976744186046
"5921";5163;86;5921;6;33;39;6;0,395348837209302;0,465116279069767
"5922";5163;86;5922;6;35;41;6;0,418604651162791;0,488372093023256
"5923";5163;86;5923;6;31;37;6;0,372093023255814;0,441860465116279
"5924";5163;86;5924;6;46;52;6;0,534883720930233;0,604651162790698
"5925";5163;86;5925;6;11;17;6;0,13953488372093;0,209302325581395
"5926";5163;86;5926;6;27;33;6;0,325581395348837;0,395348837209302
"5927";5163;86;5927;6;23;33;10;0,27906976744186;0,395348837209302
"5928";5163;86;5928;6;60;70;10;0,697674418604651;0,813953488372093
"5929";5163;86;5929;6;60;72;12;0,697674418604651;0,837209302325581
"5930";5385;146;5930;3;36;146;110;0,25;1
"5931";5385;146;5931;4;48;97;49;0,333333333333333;0,666666666666667
"5932";5385;146;5932;4;81;130;49;0,555555555555556;0,888888888888889
"5933";5385;146;5933;4;32;81;49;0,222222222222222;0,555555555555556
"5934";5385;146;5934;4;64;113;49;0,444444444444444;0,777777777777778
"5935";5385;146;5935;4;15;64;49;0,111111111111111;0,444444444444444
"5936";5385;146;5936;5;113;138;25;0,777777777777778;0,944444444444444
"5937";5385;146;5937;5;40;64;24;0,277777777777778;0,444444444444444
"5938";5385;146;5938;5;64;89;25;0,444444444444444;0,611111111111111
"5939";5385;146;5939;5;32;56;24;0,222222222222222;0,388888888888889
"5940";5385;146;5940;5;24;48;24;0,166666666666667;0,333333333333333
"5941";5385;146;5941;5;24;56;32;0,166666666666667;0,388888888888889
"5942";5385;146;5942;5;32;64;32;0,222222222222222;0,444444444444444
"5943";5385;146;5943;5;56;81;25;0,388888888888889;0,555555555555556
"5944";5385;146;5944;5;56;89;33;0,388888888888889;0,611111111111111
"5945";5385;146;5945;5;122;146;24;0,833333333333333;1
"5946";5385;146;5946;5;72;97;25;0,5;0,666666666666667
"5947";5385;146;5947;5;64;97;33;0,444444444444444;0,666666666666667
"5948";5385;146;5948;5;105;130;25;0,722222222222222;0,888888888888889
"5949";5385;146;5949;5;40;72;32;0,277777777777778;0,5
"5950";5385;146;5950;5;97;122;25;0,666666666666667;0,833333333333333
"5951";5385;146;5951;5;24;64;40;0,166666666666667;0,444444444444444
"5952";5385;146;5952;6;32;44;12;0,222222222222222;0,305555555555556
"5953";5385;146;5953;6;64;77;13;0,444444444444444;0,527777777777778
"5954";5385;146;5954;6;77;89;12;0,527777777777778;0,611111111111111
"5955";5385;146;5955;6;19;32;13;0,138888888888889;0,222222222222222
"5956";5385;146;5956;6;36;48;12;0,25;0,333333333333333
"5957";5385;146;5957;6;40;52;12;0,277777777777778;0,361111111111111
"5958";5385;146;5958;6;60;72;12;0,416666666666667;0,5
"5959";5385;146;5959;6;28;40;12;0,194444444444444;0,277777777777778
"5960";5385;146;5960;6;89;101;12;0,611111111111111;0,694444444444444
"5961";5385;146;5961;6;122;134;12;0,833333333333333;0,916666666666667
"5962";5385;146;5962;6;24;36;12;0,166666666666667;0,25
"5963";5385;146;5963;6;24;40;16;0,166666666666667;0,277777777777778
"5964";5385;146;5964;6;28;44;16;0,194444444444444;0,305555555555556
"5965";5385;146;5965;6;72;85;13;0,5;0,583333333333333
"5966";5385;146;5966;6;126;138;12;0,861111111111111;0,944444444444444
"5967";5385;146;5967;6;40;56;16;0,277777777777778;0,388888888888889
"5968";5385;146;5968;6;40;60;20;0,277777777777778;0,416666666666667
"5969";5385;146;5969;6;48;60;12;0,333333333333333;0,416666666666667
"5970";5385;146;5970;6;68;81;13;0,472222222222222;0,555555555555556
"5971";5385;146;5971;6;68;85;17;0,472222222222222;0,583333333333333
"5972";5385;146;5972;6;105;117;12;0,722222222222222;0,805555555555556
"5973";5385;146;5973;6;105;122;17;0,722222222222222;0,833333333333333
"5974";5385;146;5974;6;105;126;21;0,722222222222222;0,861111111111111
"5975";5385;146;5975;6;117;130;13;0,805555555555556;0,888888888888889
"5976";5385;146;5976;6;134;146;12;0,916666666666667;1
"5977";5385;146;5977;6;101;113;12;0,694444444444444;0,777777777777778
"5978";5385;146;5978;6;44;56;12;0,305555555555556;0,388888888888889
"5979";5385;146;5979;6;44;60;16;0,305555555555556;0,416666666666667
"5980";5385;146;5980;6;101;117;16;0,694444444444444;0,805555555555556
"5981";5385;146;5981;6;126;142;16;0,861111111111111;0,972222222222222
"5982";5385;146;5982;6;15;28;13;0,111111111111111;0,194444444444444
"5983";5385;146;5983;6;32;48;16;0,222222222222222;0,333333333333333
"5984";5385;146;5984;6;40;64;24;0,277777777777778;0,444444444444444
"5985";5385;146;5985;6;56;68;12;0,388888888888889;0,472222222222222
"5986";5385;146;5986;6;56;72;16;0,388888888888889;0,5
"5987";5385;146;5987;6;85;97;12;0,583333333333333;0,666666666666667
"5988";5385;146;5988;6;109;122;13;0,75;0,833333333333333
"5989";5385;146;5989;6;109;126;17;0,75;0,861111111111111
"5990";5385;146;5990;6;130;142;12;0,888888888888889;0,972222222222222
"5991";5385;146;5991;6;28;48;20;0,194444444444444;0,333333333333333
"5992";5385;146;5992;6;68;89;21;0,472222222222222;0,611111111111111
"5993";5385;146;5993;6;72;89;17;0,5;0,611111111111111
"5994";5385;146;5994;6;122;138;16;0,833333333333333;0,944444444444444
"5995";5385;146;5995;6;64;81;17;0,444444444444444;0,555555555555556
"5996";5385;146;5996;6;130;146;16;0,888888888888889;1
"5997";5385;146;5997;6;56;77;21;0,388888888888889;0,527777777777778
"5998";5385;146;5998;6;44;64;20;0,305555555555556;0,444444444444444
"5999";5385;146;5999;6;52;64;12;0,361111111111111;0,444444444444444
"6000";5385;146;6000;6;32;52;20;0,222222222222222;0,361111111111111
"6001";5385;146;6001;6;32;56;24;0,222222222222222;0,388888888888889
"6002";5385;146;6002;6;32;60;28;0,222222222222222;0,416666666666667
"6003";5385;146;6003;6;113;126;13;0,777777777777778;0,861111111111111
"6004";5385;146;6004;6;36;52;16;0,25;0,361111111111111
"6005";5385;146;6005;6;60;77;17;0,416666666666667;0,527777777777778
"6006";5385;146;6006;6;77;93;16;0,527777777777778;0,638888888888889
"6007";5385;146;6007;6;117;134;17;0,805555555555556;0,916666666666667
"6008";5385;146;6008;6;60;81;21;0,416666666666667;0,555555555555556
"6009";5385;146;6009;6;64;85;21;0,444444444444444;0,583333333333333
"6010";5385;146;6010;6;48;64;16;0,333333333333333;0,444444444444444
"6011";5561;158;6011;3;39;158;119;0,25;1
"6012";5561;158;6012;4;105;158;53;0,666666666666667;1
"6013";5561;158;6013;4;70;123;53;0,444444444444444;0,777777777777778
"6014";5561;158;6014;4;52;105;53;0,333333333333333;0,666666666666667
"6015";5561;158;6015;4;87;140;53;0,555555555555556;0,888888888888889
"6016";5561;158;6016;5;74;99;25;0,473684210526316;0,631578947368421
"6017";5561;158;6017;5;83;108;25;0,526315789473684;0,684210526315789
"6018";5561;158;6018;5;58;83;25;0,368421052631579;0,526315789473684
"6019";5561;158;6019;5;66;91;25;0,421052631578947;0,578947368421053
"6020";5561;158;6020;5;116;141;25;0,736842105263158;0,894736842105263
"6021";5561;158;6021;5;116;150;34;0,736842105263158;0,947368421052632
"6022";5561;158;6022;5;49;74;25;0,315789473684211;0,473684210526316
"6023";5561;158;6023;5;74;108;34;0,473684210526316;0,684210526315789
"6024";5561;158;6024;5;83;116;33;0,526315789473684;0,736842105263158
"6025";5561;158;6025;5;74;116;42;0,473684210526316;0,736842105263158
"6026";5561;158;6026;5;108;133;25;0,684210526315789;0,842105263157895
"6027";5561;158;6027;5;125;150;25;0,789473684210526;0,947368421052632
"6028";5561;158;6028;5;133;158;25;0,842105263157895;1
"6029";5561;158;6029;5;99;125;26;0,631578947368421;0,789473684210526
"6030";5561;158;6030;5;91;116;25;0,578947368421053;0,736842105263158
"6031";5561;158;6031;5;108;141;33;0,684210526315789;0,894736842105263
"6032";5561;158;6032;5;108;150;42;0,684210526315789;0,947368421052632
"6033";5561;158;6033;5;116;158;42;0,736842105263158;1
"6034";5561;158;6034;5;66;99;33;0,421052631578947;0,631578947368421
"6035";5561;158;6035;6;68;81;13;0,435897435897436;0,512820512820513
"6036";5561;158;6036;6;48;60;12;0,307692307692308;0,384615384615385
"6037";5561;158;6037;6;117;129;12;0,743589743589744;0,82051282051282
"6038";5561;158;6038;6;117;134;17;0,743589743589744;0,846153846153846
"6039";5561;158;6039;6;125;138;13;0,794871794871795;0,871794871794872
"6040";5561;158;6040;6;60;72;12;0,384615384615385;0,461538461538462
"6041";5561;158;6041;6;76;89;13;0,487179487179487;0,564102564102564
"6042";5561;158;6042;6;89;101;12;0,564102564102564;0,641025641025641
"6043";5561;158;6043;6;93;105;12;0,58974358974359;0,666666666666667
"6044";5561;158;6044;6;93;109;16;0,58974358974359;0,692307692307692
"6045";5561;158;6045;6;97;109;12;0,615384615384615;0,692307692307692
"6046";5561;158;6046;6;101;113;12;0,641025641025641;0,717948717948718
"6047";5561;158;6047;6;105;117;12;0,666666666666667;0,743589743589744
"6048";5561;158;6048;6;125;142;17;0,794871794871795;0,897435897435897
"6049";5561;158;6049;6;129;142;13;0,82051282051282;0,897435897435897
"6050";5561;158;6050;6;129;146;17;0,82051282051282;0,923076923076923
"6051";5561;158;6051;6;64;76;12;0,41025641025641;0,487179487179487
"6052";5561;158;6052;6;93;113;20;0,58974358974359;0,717948717948718
"6053";5561;158;6053;6;97;113;16;0,615384615384615;0,717948717948718
"6054";5561;158;6054;6;113;125;12;0,717948717948718;0,794871794871795
"6055";5561;158;6055;6;113;129;16;0,717948717948718;0,82051282051282
"6056";5561;158;6056;6;117;138;21;0,743589743589744;0,871794871794872
"6057";5561;158;6057;6;64;81;17;0,41025641025641;0,512820512820513
"6058";5561;158;6058;6;125;146;21;0,794871794871795;0,923076923076923
"6059";5561;158;6059;6;134;146;12;0,846153846153846;0,923076923076923
"6060";5561;158;6060;6;138;150;12;0,871794871794872;0,948717948717949
"6061";5561;158;6061;6;44;56;12;0,282051282051282;0,358974358974359
"6062";5561;158;6062;6;48;64;16;0,307692307692308;0,41025641025641
"6063";5561;158;6063;6;52;64;12;0,333333333333333;0,41025641025641
"6064";5561;158;6064;6;60;76;16;0,384615384615385;0,487179487179487
"6065";5561;158;6065;6;134;150;16;0,846153846153846;0,948717948717949
"6066";5561;158;6066;6;15;28;13;0,102564102564103;0,179487179487179
"6067";5561;158;6067;6;11;23;12;0,0769230769230769;0,153846153846154
"6068";5561;158;6068;6;68;85;17;0,435897435897436;0,538461538461538
"6069";5561;158;6069;6;72;85;13;0,461538461538462;0,538461538461538
"6070";5561;158;6070;6;101;117;16;0,641025641025641;0,743589743589744
"6071";5561;158;6071;6;117;142;25;0,743589743589744;0,897435897435897
"6072";5561;158;6072;6;113;134;21;0,717948717948718;0,846153846153846
"6073";5561;158;6073;6;113;138;25;0,717948717948718;0,871794871794872
"6074";5561;158;6074;6;117;146;29;0,743589743589744;0,923076923076923
"6075";5561;158;6075;6;117;150;33;0,743589743589744;0,948717948717949
"6076";5561;158;6076;6;125;150;25;0,794871794871795;0,948717948717949
"6077";5561;158;6077;6;129;150;21;0,82051282051282;0,948717948717949
"6078";5561;158;6078;6;113;142;29;0,717948717948718;0,897435897435897
"6079";5561;158;6079;6;113;146;33;0,717948717948718;0,923076923076923
"6080";5561;158;6080;6;121;134;13;0,769230769230769;0,846153846153846
"6081";5561;158;6081;6;121;138;17;0,769230769230769;0,871794871794872
"6082";5561;158;6082;6;89;105;16;0,564102564102564;0,666666666666667
"6083";5561;158;6083;6;121;142;21;0,769230769230769;0,897435897435897
"6084";5561;158;6084;6;121;146;25;0,769230769230769;0,923076923076923
"6085";5561;158;6085;6;72;89;17;0,461538461538462;0,564102564102564
"6086";5561;158;6086;6;85;97;12;0,538461538461538;0,615384615384615
"6087";5561;158;6087;6;85;101;16;0,538461538461538;0,641025641025641
"6088";5561;158;6088;6;56;68;12;0,358974358974359;0,435897435897436
"6089";5561;158;6089;6;121;150;29;0,769230769230769;0,948717948717949
"6090";5561;158;6090;6;146;158;12;0,923076923076923;1
"6091";5561;158;6091;6;7;19;12;0,0512820512820513;0,128205128205128
"6092";5561;158;6092;6;81;93;12;0,512820512820513;0,58974358974359
"6093";5561;158;6093;6;97;117;20;0,615384615384615;0,743589743589744
"6094";5561;158;6094;6;113;150;37;0,717948717948718;0,948717948717949
"6095";5561;158;6095;6;52;68;16;0,333333333333333;0,435897435897436
"6096";5561;158;6096;6;89;109;20;0,564102564102564;0,692307692307692
"6097";5561;158;6097;6;142;154;12;0,897435897435897;0,974358974358974
"6098";5561;158;6098;6;138;154;16;0,871794871794872;0,974358974358974
"6099";5732;128;6099;5;80;104;24;0,625;0,8125
"6100";5732;128;6100;5;72;96;24;0,5625;0,75
"6101";5732;128;6101;5;104;128;24;0,8125;1
"6102";5732;128;6102;5;88;112;24;0,6875;0,875
"6103";5732;128;6103;6;116;128;12;0,90625;1
"6104";5732;128;6104;6;31;43;12;0,25;0,34375
"6105";5732;128;6105;6;88;100;12;0,6875;0,78125
"6106";5732;128;6106;6;68;80;12;0,53125;0,625
"6107";5732;128;6107;6;51;64;13;0,40625;0,5
"6108";5732;128;6108;6;55;68;13;0,4375;0,53125
"6109";5732;128;6109;6;112;124;12;0,875;0,96875
"6110";5732;128;6110;6;92;104;12;0,71875;0,8125
"6111";5732;128;6111;6;35;47;12;0,28125;0,375
"6112";5732;128;6112;6;100;112;12;0,78125;0,875
"6113";5732;128;6113;6;80;92;12;0,625;0,71875
"6114";5732;128;6114;6;72;84;12;0,5625;0,65625
"6115";5732;128;6115;6;104;116;12;0,8125;0,90625
"6116";5732;128;6116;6;76;88;12;0,59375;0,6875
"6117";5732;128;6117;6;84;96;12;0,65625;0,75
"6118";5732;128;6118;6;112;128;16;0,875;1
"6119";5732;128;6119;7;74;80;6;0,578125;0,625
"6120";5732;128;6120;7;114;120;6;0,890625;0,9375
"6121";5732;128;6121;7;37;43;6;0,296875;0,34375
"6122";5732;128;6122;7;51;57;6;0,40625;0,453125
"6123";5732;128;6123;7;53;59;6;0,421875;0,46875
"6124";5732;128;6124;7;59;66;7;0,46875;0,515625
"6125";5732;128;6125;7;96;102;6;0,75;0,796875
"6126";5732;128;6126;7;104;110;6;0,8125;0,859375
"6127";5732;128;6127;7;116;122;6;0,90625;0,953125
"6128";5732;128;6128;7;116;124;8;0,90625;0,96875
"6129";5732;128;6129;7;116;126;10;0,90625;0,984375
"6130";5732;128;6130;7;33;39;6;0,265625;0,3125
"6131";5732;128;6131;7;94;100;6;0,734375;0,78125
"6132";5732;128;6132;7;94;102;8;0,734375;0,796875
"6133";5732;128;6133;7;118;124;6;0,921875;0,96875
"6134";5732;128;6134;7;35;41;6;0,28125;0,328125
"6135";5732;128;6135;7;35;43;8;0,28125;0,34375
"6136";5732;128;6136;7;76;82;6;0,59375;0,640625
"6137";5732;128;6137;7;116;128;12;0,90625;1
"6138";5732;128;6138;7;118;126;8;0,921875;0,984375
"6139";5732;128;6139;7;118;128;10;0,921875;1
"6140";5732;128;6140;7;31;37;6;0,25;0,296875
"6141";5732;128;6141;7;45;51;6;0,359375;0,40625
"6142";5732;128;6142;7;55;61;6;0,4375;0,484375
"6143";5732;128;6143;7;57;64;7;0,453125;0,5
"6144";5732;128;6144;7;57;66;9;0,453125;0,515625
"6145";5732;128;6145;7;61;68;7;0,484375;0,53125
"6146";5732;128;6146;7;88;94;6;0,6875;0,734375
"6147";5732;128;6147;7;90;96;6;0,703125;0,75
"6148";5732;128;6148;7;68;74;6;0,53125;0,578125
"6149";5732;128;6149;7;78;84;6;0,609375;0,65625
"6150";5732;128;6150;7;13;19;6;0,109375;0,15625
"6151";5732;128;6151;7;27;33;6;0,21875;0,265625
"6152";5732;128;6152;7;29;35;6;0,234375;0,28125
"6153";5732;128;6153;7;29;37;8;0,234375;0,296875
"6154";5732;128;6154;7;88;96;8;0,6875;0,75
"6155";5732;128;6155;7;88;98;10;0,6875;0,765625
"6156";5732;128;6156;7;90;98;8;0,703125;0,765625
"6157";5732;128;6157;7;90;100;10;0,703125;0,78125
"6158";5732;128;6158;7;104;112;8;0,8125;0,875
"6159";5732;128;6159;7;112;118;6;0,875;0,921875
"6160";5732;128;6160;7;1;7;6;0,015625;0,0625
"6161";5732;128;6161;7;33;41;8;0,265625;0,328125
"6162";5732;128;6162;7;39;45;6;0,3125;0,359375
"6163";5732;128;6163;7;102;108;6;0,796875;0,84375
"6164";5732;128;6164;7;102;110;8;0,796875;0,859375
"6165";5732;128;6165;7;82;88;6;0,640625;0,6875
"6166";5732;128;6166;7;33;43;10;0,265625;0,34375
"6167";5732;128;6167;7;43;49;6;0,34375;0,390625
"6168";5732;128;6168;7;43;51;8;0,34375;0,40625
"6169";5732;128;6169;7;86;92;6;0,671875;0,71875
"6170";5732;128;6170;7;114;122;8;0,890625;0,953125
"6171";5732;128;6171;7;114;124;10;0,890625;0,96875
"6172";5732;128;6172;7;59;68;9;0,46875;0,53125
"6173";5732;128;6173;7;70;76;6;0,546875;0,59375
"6174";5732;128;6174;7;114;126;12;0,890625;0,984375
"6175";5732;128;6175;7;114;128;14;0,890625;1
"6176";5732;128;6176;7;25;31;6;0,203125;0,25
"6177";5732;128;6177;7;25;33;8;0,203125;0,265625
"6178";5732;128;6178;7;55;64;9;0,4375;0,5
"6179";5732;128;6179;7;80;86;6;0,625;0,671875
"6180";5950;54;6180;3;8;36;28;0,166666666666667;0,666666666666667
"6181";5950;54;6181;3;8;45;37;0,166666666666667;0,833333333333333
"6182";5950;54;6182;3;17;45;28;0,333333333333333;0,833333333333333
"6183";5950;54;6183;3;17;54;37;0,333333333333333;1
"6184";5950;54;6184;3;26;54;28;0,5;1
"6185";5950;54;6185;3;8;54;46;0,166666666666667;1
"6186";5950;54;6186;4;12;24;12;0,230769230769231;0,461538461538462
"6187";5950;54;6187;4;16;29;13;0,307692307692308;0,538461538461538
"6188";5950;54;6188;4;16;33;17;0,307692307692308;0,615384615384615
"6189";5950;54;6189;4;24;37;13;0,461538461538462;0,692307692307692
"6190";5950;54;6190;4;24;41;17;0,461538461538462;0,769230769230769
"6191";5950;54;6191;4;33;46;13;0,615384615384615;0,846153846153846
"6192";5950;54;6192;4;33;50;17;0,615384615384615;0,923076923076923
"6193";5950;54;6193;4;37;50;13;0,692307692307692;0,923076923076923
"6194";5950;54;6194;4;37;54;17;0,692307692307692;1
"6195";5950;54;6195;4;41;54;13;0,769230769230769;1
"6196";5950;54;6196;4;3;16;13;0,0769230769230769;0,307692307692308
"6197";5950;54;6197;4;3;20;17;0,0769230769230769;0,384615384615385
"6198";5950;54;6198;4;3;24;21;0,0769230769230769;0,461538461538462
"6199";5950;54;6199;4;3;29;26;0,0769230769230769;0,538461538461538
"6200";5950;54;6200;4;12;29;17;0,230769230769231;0,538461538461538
"6201";5950;54;6201;4;12;33;21;0,230769230769231;0,615384615384615
"6202";5950;54;6202;4;12;37;25;0,230769230769231;0,692307692307692
"6203";5950;54;6203;4;12;41;29;0,230769230769231;0,769230769230769
"6204";5950;54;6204;4;12;46;34;0,230769230769231;0,846153846153846
"6205";5950;54;6205;4;12;50;38;0,230769230769231;0,923076923076923
"6206";5950;54;6206;4;16;37;21;0,307692307692308;0,692307692307692
"6207";5950;54;6207;4;16;41;25;0,307692307692308;0,769230769230769
"6208";5950;54;6208;4;16;46;30;0,307692307692308;0,846153846153846
"6209";5950;54;6209;4;20;33;13;0,384615384615385;0,615384615384615
"6210";5950;54;6210;4;24;46;22;0,461538461538462;0,846153846153846
"6211";5950;54;6211;4;29;41;12;0,538461538461538;0,769230769230769
"6212";5950;54;6212;4;29;46;17;0,538461538461538;0,846153846153846
"6213";5950;54;6213;4;7;20;13;0,153846153846154;0,384615384615385
"6214";5950;54;6214;4;16;50;34;0,307692307692308;0,923076923076923
"6215";5950;54;6215;4;16;54;38;0,307692307692308;1
"6216";5950;54;6216;4;20;37;17;0,384615384615385;0,692307692307692
"6217";5950;54;6217;4;20;41;21;0,384615384615385;0,769230769230769
"6218";5950;54;6218;4;20;46;26;0,384615384615385;0,846153846153846
"6219";5950;54;6219;4;20;50;30;0,384615384615385;0,923076923076923
"6220";5950;54;6220;4;20;54;34;0,384615384615385;1
"6221";5950;54;6221;4;24;50;26;0,461538461538462;0,923076923076923
"6222";5950;54;6222;4;24;54;30;0,461538461538462;1
"6223";5950;54;6223;4;29;50;21;0,538461538461538;0,923076923076923
"6224";5950;54;6224;4;29;54;25;0,538461538461538;1
"6225";5950;54;6225;4;33;54;21;0,615384615384615;1
"6226";5950;54;6226;4;7;24;17;0,153846153846154;0,461538461538462
"6227";5950;54;6227;4;7;29;22;0,153846153846154;0,538461538461538
"6228";5950;54;6228;4;12;54;42;0,230769230769231;1
"6229";5950;54;6229;4;7;33;26;0,153846153846154;0,615384615384615
"6230";5950;54;6230;5;1;7;6;0,037037037037037;0,148148148148148
"6231";5950;54;6231;5;7;13;6;0,148148148148148;0,259259259259259
"6232";5950;54;6232;5;13;19;6;0,259259259259259;0,37037037037037
"6233";5950;54;6233;5;17;23;6;0,333333333333333;0,444444444444444
"6234";5950;54;6234;5;17;25;8;0,333333333333333;0,481481481481481
"6235";5950;54;6235;5;19;25;6;0,37037037037037;0,481481481481481
"6236";5950;54;6236;5;23;30;7;0,444444444444444;0,555555555555556
"6237";5950;54;6237;5;25;32;7;0,481481481481481;0,592592592592593
"6238";5950;54;6238;5;25;34;9;0,481481481481481;0,62962962962963
"6239";5950;54;6239;5;34;40;6;0,62962962962963;0,740740740740741
"6240";5950;54;6240;5;34;42;8;0,62962962962963;0,777777777777778
"6241";5950;54;6241;5;36;42;6;0,666666666666667;0,777777777777778
"6242";5950;54;6242;5;42;48;6;0,777777777777778;0,888888888888889
"6243";5950;54;6243;5;42;50;8;0,777777777777778;0,925925925925926
"6244";5950;54;6244;5;44;50;6;0,814814814814815;0,925925925925926
"6245";5950;54;6245;5;3;9;6;0,0740740740740741;0,185185185185185
"6246";5950;54;6246;5;3;11;8;0,0740740740740741;0,222222222222222
"6247";5950;54;6247;5;3;13;10;0,0740740740740741;0,259259259259259
"6248";5950;54;6248;5;3;15;12;0,0740740740740741;0,296296296296296
"6249";5950;54;6249;5;5;11;6;0,111111111111111;0,222222222222222
"6250";5950;54;6250;5;5;13;8;0,111111111111111;0,259259259259259
"6251";5950;54;6251;5;7;15;8;0,148148148148148;0,296296296296296
"6252";5950;54;6252;5;7;17;10;0,148148148148148;0,333333333333333
"6253";5950;54;6253;5;7;19;12;0,148148148148148;0,37037037037037
"6254";5950;54;6254;5;9;15;6;0,185185185185185;0,296296296296296
"6255";5950;54;6255;5;9;17;8;0,185185185185185;0,333333333333333
"6256";5950;54;6256;5;11;17;6;0,222222222222222;0,333333333333333
"6257";5950;54;6257;5;11;19;8;0,222222222222222;0,37037037037037
"6258";5950;54;6258;5;11;21;10;0,222222222222222;0,407407407407407
"6259";5950;54;6259;5;11;23;12;0,222222222222222;0,444444444444444
"6260";5950;54;6260;5;11;25;14;0,222222222222222;0,481481481481481
"6261";5950;54;6261;5;13;21;8;0,259259259259259;0,407407407407407
"6262";5950;54;6262;5;13;23;10;0,259259259259259;0,444444444444444
"6263";5950;54;6263;5;13;25;12;0,259259259259259;0,481481481481481
"6264";5950;54;6264;5;15;21;6;0,296296296296296;0,407407407407407
"6265";5950;54;6265;5;15;23;8;0,296296296296296;0,444444444444444
"6266";5950;54;6266;5;15;25;10;0,296296296296296;0,481481481481481
"6267";5950;54;6267;5;17;28;11;0,333333333333333;0,518518518518518
"6268";5950;54;6268;5;17;30;13;0,333333333333333;0,555555555555556
"6269";5950;54;6269;5;17;32;15;0,333333333333333;0,592592592592593
"6270";5950;54;6270;5;17;34;17;0,333333333333333;0,62962962962963
"6271";5950;54;6271;5;17;36;19;0,333333333333333;0,666666666666667
"6272";5950;54;6272;5;19;28;9;0,37037037037037;0,518518518518518
"6273";5950;54;6273;5;19;30;11;0,37037037037037;0,555555555555556
"6274";5950;54;6274;5;19;32;13;0,37037037037037;0,592592592592593
"6275";5950;54;6275;5;19;34;15;0,37037037037037;0,62962962962963
"6276";5950;54;6276;5;21;28;7;0,407407407407407;0,518518518518518
"6277";5950;54;6277;5;21;30;9;0,407407407407407;0,555555555555556
"6278";5950;54;6278;5;21;32;11;0,407407407407407;0,592592592592593
"6279";5950;54;6279;5;21;34;13;0,407407407407407;0,62962962962963
"6280";5950;54;6280;5;23;32;9;0,444444444444444;0,592592592592593
"6281";5950;54;6281;5;23;34;11;0,444444444444444;0,62962962962963
"6282";5950;54;6282;5;23;36;13;0,444444444444444;0,666666666666667
"6283";5950;54;6283;5;23;38;15;0,444444444444444;0,703703703703704
"6284";5950;54;6284;5;23;40;17;0,444444444444444;0,740740740740741
"6285";5950;54;6285;5;25;36;11;0,481481481481481;0,666666666666667
"6286";5950;54;6286;5;25;38;13;0,481481481481481;0,703703703703704
"6287";5950;54;6287;5;25;40;15;0,481481481481481;0,740740740740741
"6288";5950;54;6288;5;28;34;6;0,518518518518518;0,62962962962963
"6289";5950;54;6289;5;28;36;8;0,518518518518518;0,666666666666667
"6290";5950;54;6290;5;30;36;6;0,555555555555556;0,666666666666667
"6291";5950;54;6291;5;30;38;8;0,555555555555556;0,703703703703704
"6292";5950;54;6292;5;30;40;10;0,555555555555556;0,740740740740741
"6293";5950;54;6293;5;30;42;12;0,555555555555556;0,777777777777778
"6294";5950;54;6294;5;34;44;10;0,62962962962963;0,814814814814815
"6295";5950;54;6295;5;34;46;12;0,62962962962963;0,851851851851852
"6296";5950;54;6296;5;34;48;14;0,62962962962963;0,888888888888889
"6297";5950;54;6297;5;36;44;8;0,666666666666667;0,814814814814815
"6298";5950;54;6298;5;36;46;10;0,666666666666667;0,851851851851852
"6299";5950;54;6299;5;36;48;12;0,666666666666667;0,888888888888889
"6300";5950;54;6300;5;36;50;14;0,666666666666667;0,925925925925926
"6301";5950;54;6301;5;38;44;6;0,703703703703704;0,814814814814815
"6302";5950;54;6302;5;38;46;8;0,703703703703704;0,851851851851852
"6303";5950;54;6303;5;38;48;10;0,703703703703704;0,888888888888889
"6304";5950;54;6304;5;38;50;12;0,703703703703704;0,925925925925926
"6305";5950;54;6305;5;42;52;10;0,777777777777778;0,962962962962963
"6306";5950;54;6306;5;42;54;12;0,777777777777778;1
"6307";5950;54;6307;5;44;52;8;0,814814814814815;0,962962962962963
"6308";5950;54;6308;5;44;54;10;0,814814814814815;1
"6309";5950;54;6309;5;7;21;14;0,148148148148148;0,407407407407407
"6310";5950;54;6310;5;7;23;16;0,148148148148148;0,444444444444444
"6311";5950;54;6311;5;9;19;10;0,185185185185185;0,37037037037037
"6312";5950;54;6312;5;9;21;12;0,185185185185185;0,407407407407407
"6313";5950;54;6313;5;9;23;14;0,185185185185185;0,444444444444444
"6314";5950;54;6314;5;11;28;17;0,222222222222222;0,518518518518518
"6315";5950;54;6315;5;11;30;19;0,222222222222222;0,555555555555556
"6316";5950;54;6316;5;15;28;13;0,296296296296296;0,518518518518518
"6317";5950;54;6317;5;15;30;15;0,296296296296296;0,555555555555556
"6318";5950;54;6318;5;15;32;17;0,296296296296296;0,592592592592593
"6319";5950;54;6319;5;15;34;19;0,296296296296296;0,62962962962963
"6320";5950;54;6320;5;15;36;21;0,296296296296296;0,666666666666667
"6321";5950;54;6321;5;15;38;23;0,296296296296296;0,703703703703704
"6322";5950;54;6322;5;15;40;25;0,296296296296296;0,740740740740741
"6323";5950;54;6323;5;17;38;21;0,333333333333333;0,703703703703704
"6324";5950;54;6324;5;17;40;23;0,333333333333333;0,740740740740741
"6325";5950;54;6325;5;17;42;25;0,333333333333333;0,777777777777778
"6326";5950;54;6326;5;17;44;27;0,333333333333333;0,814814814814815
"6327";5950;54;6327;5;19;36;17;0,37037037037037;0,666666666666667
"6328";5950;54;6328;5;19;38;19;0,37037037037037;0,703703703703704
"6329";5950;54;6329;5;19;40;21;0,37037037037037;0,740740740740741
"6330";5950;54;6330;5;19;42;23;0,37037037037037;0,777777777777778
"6331";5950;54;6331;5;19;44;25;0,37037037037037;0,814814814814815
"6332";5950;54;6332;5;21;36;15;0,407407407407407;0,666666666666667
"6333";5950;54;6333;5;21;38;17;0,407407407407407;0,703703703703704
"6334";5950;54;6334;5;21;40;19;0,407407407407407;0,740740740740741
"6335";5950;54;6335;5;21;42;21;0,407407407407407;0,777777777777778
"6336";5950;54;6336;5;21;44;23;0,407407407407407;0,814814814814815
"6337";5950;54;6337;5;21;46;25;0,407407407407407;0,851851851851852
"6338";5950;54;6338;5;21;48;27;0,407407407407407;0,888888888888889
"6339";5950;54;6339;5;25;42;17;0,481481481481481;0,777777777777778
"6340";5950;54;6340;5;25;44;19;0,481481481481481;0,814814814814815
"6341";5950;54;6341;5;25;46;21;0,481481481481481;0,851851851851852
"6342";5950;54;6342;5;28;38;10;0,518518518518518;0,703703703703704
"6343";5950;54;6343;5;28;40;12;0,518518518518518;0,740740740740741
"6344";5950;54;6344;5;28;42;14;0,518518518518518;0,777777777777778
"6345";5950;54;6345;5;28;44;16;0,518518518518518;0,814814814814815
"6346";5950;54;6346;5;28;46;18;0,518518518518518;0,851851851851852
"6347";5950;54;6347;5;28;48;20;0,518518518518518;0,888888888888889
"6348";5950;54;6348;5;28;50;22;0,518518518518518;0,925925925925926
"6349";5950;54;6349;5;28;52;24;0,518518518518518;0,962962962962963
"6350";5950;54;6350;5;30;44;14;0,555555555555556;0,814814814814815
"6351";5950;54;6351;5;30;46;16;0,555555555555556;0,851851851851852
"6352";5950;54;6352;5;32;38;6;0,592592592592593;0,703703703703704
"6353";5950;54;6353;5;32;40;8;0,592592592592593;0,740740740740741
"6354";5950;54;6354;5;32;42;10;0,592592592592593;0,777777777777778
"6355";5950;54;6355;5;32;44;12;0,592592592592593;0,814814814814815
"6356";5950;54;6356;5;32;46;14;0,592592592592593;0,851851851851852
"6357";5950;54;6357;5;32;48;16;0,592592592592593;0,888888888888889
"6358";5950;54;6358;5;34;50;16;0,62962962962963;0,925925925925926
"6359";5950;54;6359;5;34;52;18;0,62962962962963;0,962962962962963
"6360";5950;54;6360;5;38;52;14;0,703703703703704;0,962962962962963
"6361";5950;54;6361;5;30;48;18;0,555555555555556;0,888888888888889
"6362";5950;54;6362;5;38;54;16;0,703703703703704;1
"6363";5950;54;6363;5;13;28;15;0,259259259259259;0,518518518518518
"6364";5950;54;6364;5;13;30;17;0,259259259259259;0,555555555555556
"6365";5950;54;6365;5;19;46;27;0,37037037037037;0,851851851851852
"6366";5950;54;6366;5;23;42;19;0,444444444444444;0,777777777777778
"6367";5950;54;6367;5;23;44;21;0,444444444444444;0,814814814814815
"6368";5950;54;6368;5;23;46;23;0,444444444444444;0,851851851851852
"6369";5950;54;6369;5;23;48;25;0,444444444444444;0,888888888888889
"6370";5950;54;6370;5;23;50;27;0,444444444444444;0,925925925925926
"6371";5950;54;6371;5;23;52;29;0,444444444444444;0,962962962962963
"6372";5950;54;6372;5;23;54;31;0,444444444444444;1
"6373";5950;54;6373;5;25;48;23;0,481481481481481;0,888888888888889
"6374";5950;54;6374;5;25;50;25;0,481481481481481;0,925925925925926
"6375";5950;54;6375;5;25;52;27;0,481481481481481;0,962962962962963
"6376";5950;54;6376;5;25;54;29;0,481481481481481;1
"6377";5950;54;6377;5;28;54;26;0,518518518518518;1
"6378";5950;54;6378;5;30;50;20;0,555555555555556;0,925925925925926
"6379";5950;54;6379;5;30;52;22;0,555555555555556;0,962962962962963
"6380";5950;54;6380;5;30;54;24;0,555555555555556;1
"6381";5950;54;6381;5;32;50;18;0,592592592592593;0,925925925925926
"6382";5950;54;6382;5;32;52;20;0,592592592592593;0,962962962962963
"6383";5950;54;6383;5;32;54;22;0,592592592592593;1
"6384";5950;54;6384;5;34;54;20;0,62962962962963;1
"6385";5950;54;6385;5;36;52;16;0,666666666666667;0,962962962962963
"6386";5950;54;6386;5;36;54;18;0,666666666666667;1
"6387";5950;54;6387;5;40;46;6;0,740740740740741;0,851851851851852
"6388";5950;54;6388;5;40;48;8;0,740740740740741;0,888888888888889
"6389";5950;54;6389;5;40;50;10;0,740740740740741;0,925925925925926
"6390";5950;54;6390;5;40;52;12;0,740740740740741;0,962962962962963
"6391";5950;54;6391;5;40;54;14;0,740740740740741;1
"6392";5950;54;6392;5;13;32;19;0,259259259259259;0,592592592592593
"6393";5950;54;6393;5;13;34;21;0,259259259259259;0,62962962962963
"6394";5950;54;6394;5;17;46;29;0,333333333333333;0,851851851851852
"6395";5950;54;6395;5;17;48;31;0,333333333333333;0,888888888888889
"6396";5950;54;6396;5;17;50;33;0,333333333333333;0,925925925925926
"6397";5950;54;6397;5;17;52;35;0,333333333333333;0,962962962962963
"6398";5950;54;6398;5;17;54;37;0,333333333333333;1
"6399";5950;54;6399;5;5;15;10;0,111111111111111;0,296296296296296
"6400";5950;54;6400;5;1;9;8;0,037037037037037;0,185185185185185
"6401";5999;120;6401;3;68;120;52;0,571428571428571;1
"6402";5999;120;6402;4;72;96;24;0,6;0,8
"6403";5999;120;6403;4;80;104;24;0,666666666666667;0,866666666666667
"6404";5999;120;6404;4;80;112;32;0,666666666666667;0,933333333333333
"6405";5999;120;6405;4;80;120;40;0,666666666666667;1
"6406";5999;120;6406;4;88;112;24;0,733333333333333;0,933333333333333
"6407";5999;120;6407;4;88;120;32;0,733333333333333;1
"6408";5999;120;6408;4;96;120;24;0,8;1
"6409";5999;120;6409;4;64;88;24;0,533333333333333;0,733333333333333
"6410";5999;120;6410;4;31;55;24;0,266666666666667;0,466666666666667
"6411";5999;120;6411;4;72;104;32;0,6;0,866666666666667
"6412";5999;120;6412;4;72;112;40;0,6;0,933333333333333
"6413";5999;120;6413;4;72;120;48;0,6;1
"6414";5999;120;6414;5;76;88;12;0,633333333333333;0,733333333333333
"6415";5999;120;6415;5;76;92;16;0,633333333333333;0,766666666666667
"6416";5999;120;6416;5;80;92;12;0,666666666666667;0,766666666666667
"6417";5999;120;6417;5;92;104;12;0,766666666666667;0,866666666666667
"6418";5999;120;6418;5;92;108;16;0,766666666666667;0,9
"6419";5999;120;6419;5;96;108;12;0,8;0,9
"6420";5999;120;6420;5;96;112;16;0,8;0,933333333333333
"6421";5999;120;6421;5;96;116;20;0,8;0,966666666666667
"6422";5999;120;6422;5;100;112;12;0,833333333333333;0,933333333333333
"6423";5999;120;6423;5;100;116;16;0,833333333333333;0,966666666666667
"6424";5999;120;6424;5;104;116;12;0,866666666666667;0,966666666666667
"6425";5999;120;6425;5;104;120;16;0,866666666666667;1
"6426";5999;120;6426;5;108;120;12;0,9;1
"6427";5999;120;6427;5;72;84;12;0,6;0,7
"6428";5999;120;6428;5;72;88;16;0,6;0,733333333333333
"6429";5999;120;6429;5;76;96;20;0,633333333333333;0,8
"6430";5999;120;6430;5;76;100;24;0,633333333333333;0,833333333333333
"6431";5999;120;6431;5;76;104;28;0,633333333333333;0,866666666666667
"6432";5999;120;6432;5;80;96;16;0,666666666666667;0,8
"6433";5999;120;6433;5;80;100;20;0,666666666666667;0,833333333333333
"6434";5999;120;6434;5;80;104;24;0,666666666666667;0,866666666666667
"6435";5999;120;6435;5;80;108;28;0,666666666666667;0,9
"6436";5999;120;6436;5;84;96;12;0,7;0,8
"6437";5999;120;6437;5;84;100;16;0,7;0,833333333333333
"6438";5999;120;6438;5;84;104;20;0,7;0,866666666666667
"6439";5999;120;6439;5;84;108;24;0,7;0,9
"6440";5999;120;6440;5;84;112;28;0,7;0,933333333333333
"6441";5999;120;6441;5;84;116;32;0,7;0,966666666666667
"6442";5999;120;6442;5;88;100;12;0,733333333333333;0,833333333333333
"6443";5999;120;6443;5;88;104;16;0,733333333333333;0,866666666666667
"6444";5999;120;6444;5;88;108;20;0,733333333333333;0,9
"6445";5999;120;6445;5;92;112;20;0,766666666666667;0,933333333333333
"6446";5999;120;6446;5;92;116;24;0,766666666666667;0,966666666666667
"6447";5999;120;6447;5;39;51;12;0,333333333333333;0,433333333333333
"6448";5999;120;6448;5;76;108;32;0,633333333333333;0,9
"6449";5999;120;6449;5;76;112;36;0,633333333333333;0,933333333333333
"6450";5999;120;6450;5;80;112;32;0,666666666666667;0,933333333333333
"6451";5999;120;6451;5;80;116;36;0,666666666666667;0,966666666666667
"6452";5999;120;6452;5;80;120;40;0,666666666666667;1
"6453";5999;120;6453;5;84;120;36;0,7;1
"6454";5999;120;6454;5;88;112;24;0,733333333333333;0,933333333333333
"6455";5999;120;6455;5;88;116;28;0,733333333333333;0,966666666666667
"6456";5999;120;6456;5;88;120;32;0,733333333333333;1
"6457";5999;120;6457;5;92;120;28;0,766666666666667;1
"6458";5999;120;6458;5;96;120;24;0,8;1
"6459";5999;120;6459;5;100;120;20;0,833333333333333;1
"6460";5999;120;6460;5;72;92;20;0,6;0,766666666666667
"6461";5999;120;6461;5;68;80;12;0,566666666666667;0,666666666666667
"6462";5999;120;6462;5;64;76;12;0,533333333333333;0,633333333333333
"6463";5999;120;6463;5;68;84;16;0,566666666666667;0,7
"6464";5999;120;6464;5;72;96;24;0,6;0,8
"6465";5999;120;6465;5;60;72;12;0,5;0,6
"6466";5999;120;6466;6;70;76;6;0,583333333333333;0,633333333333333
"6467";5999;120;6467;6;76;82;6;0,633333333333333;0,683333333333333
"6468";5999;120;6468;6;76;84;8;0,633333333333333;0,7
"6469";5999;120;6469;6;76;86;10;0,633333333333333;0,716666666666667
"6470";5999;120;6470;6;80;86;6;0,666666666666667;0,716666666666667
"6471";5999;120;6471;6;80;88;8;0,666666666666667;0,733333333333333
"6472";5999;120;6472;6;80;90;10;0,666666666666667;0,75
"6473";5999;120;6473;6;82;88;6;0,683333333333333;0,733333333333333
"6474";5999;120;6474;6;82;90;8;0,683333333333333;0,75
"6475";5999;120;6475;6;92;98;6;0,766666666666667;0,816666666666667
"6476";5999;120;6476;6;92;100;8;0,766666666666667;0,833333333333333
"6477";5999;120;6477;6;96;102;6;0,8;0,85
"6478";5999;120;6478;6;96;104;8;0,8;0,866666666666667
"6479";5999;120;6479;6;96;106;10;0,8;0,883333333333333
"6480";5999;120;6480;6;98;104;6;0,816666666666667;0,866666666666667
"6481";5999;120;6481;6;104;110;6;0,866666666666667;0,916666666666667
"6482";5999;120;6482;6;104;112;8;0,866666666666667;0,933333333333333
"6483";5999;120;6483;6;106;112;6;0,883333333333333;0,933333333333333
"6484";5999;120;6484;6;106;114;8;0,883333333333333;0,95
"6485";5999;120;6485;6;108;114;6;0,9;0,95
"6486";5999;120;6486;6;114;120;6;0,95;1
"6487";5999;120;6487;6;70;78;8;0,583333333333333;0,65
"6488";5999;120;6488;6;70;80;10;0,583333333333333;0,666666666666667
"6489";5999;120;6489;6;70;82;12;0,583333333333333;0,683333333333333
"6490";5999;120;6490;6;72;78;6;0,6;0,65
"6491";5999;120;6491;6;74;80;6;0,616666666666667;0,666666666666667
"6492";5999;120;6492;6;74;82;8;0,616666666666667;0,683333333333333
"6493";5999;120;6493;6;74;84;10;0,616666666666667;0,7
"6494";5999;120;6494;6;74;86;12;0,616666666666667;0,716666666666667
"6495";5999;120;6495;6;74;88;14;0,616666666666667;0,733333333333333
"6496";5999;120;6496;6;74;90;16;0,616666666666667;0,75
"6497";5999;120;6497;6;76;88;12;0,633333333333333;0,733333333333333
"6498";5999;120;6498;6;78;84;6;0,65;0,7
"6499";5999;120;6499;6;78;86;8;0,65;0,716666666666667
"6500";5999;120;6500;6;78;88;10;0,65;0,733333333333333
"6501";5999;120;6501;6;78;90;12;0,65;0,75
"6502";5999;120;6502;6;78;92;14;0,65;0,766666666666667
"6503";5999;120;6503;6;78;94;16;0,65;0,783333333333333
"6504";5999;120;6504;6;78;96;18;0,65;0,8
"6505";5999;120;6505;6;80;92;12;0,666666666666667;0,766666666666667
"6506";5999;120;6506;6;80;94;14;0,666666666666667;0,783333333333333
"6507";5999;120;6507;6;80;96;16;0,666666666666667;0,8
"6508";5999;120;6508;6;80;98;18;0,666666666666667;0,816666666666667
"6509";5999;120;6509;6;80;100;20;0,666666666666667;0,833333333333333
"6510";5999;120;6510;6;82;92;10;0,683333333333333;0,766666666666667
"6511";5999;120;6511;6;84;90;6;0,7;0,75
"6512";5999;120;6512;6;84;92;8;0,7;0,766666666666667
"6513";5999;120;6513;6;86;92;6;0,716666666666667;0,766666666666667
"6514";5999;120;6514;6;86;94;8;0,716666666666667;0,783333333333333
"6515";5999;120;6515;6;86;96;10;0,716666666666667;0,8
"6516";5999;120;6516;6;88;94;6;0,733333333333333;0,783333333333333
"6517";5999;120;6517;6;88;96;8;0,733333333333333;0,8
"6518";5999;120;6518;6;88;98;10;0,733333333333333;0,816666666666667
"6519";5999;120;6519;6;88;100;12;0,733333333333333;0,833333333333333
"6520";5999;120;6520;6;88;102;14;0,733333333333333;0,85
"6521";5999;120;6521;6;88;104;16;0,733333333333333;0,866666666666667
"6522";5999;120;6522;6;88;106;18;0,733333333333333;0,883333333333333
"6523";5999;120;6523;6;90;96;6;0,75;0,8
"6524";5999;120;6524;6;90;98;8;0,75;0,816666666666667
"6525";5999;120;6525;6;90;100;10;0,75;0,833333333333333
"6526";5999;120;6526;6;92;102;10;0,766666666666667;0,85
"6527";5999;120;6527;6;92;104;12;0,766666666666667;0,866666666666667
"6528";5999;120;6528;6;92;106;14;0,766666666666667;0,883333333333333
"6529";5999;120;6529;6;92;108;16;0,766666666666667;0,9
"6530";5999;120;6530;6;92;110;18;0,766666666666667;0,916666666666667
"6531";5999;120;6531;6;92;112;20;0,766666666666667;0,933333333333333
"6532";5999;120;6532;6;92;114;22;0,766666666666667;0,95
"6533";5999;120;6533;6;94;100;6;0,783333333333333;0,833333333333333
"6534";5999;120;6534;6;94;102;8;0,783333333333333;0,85
"6535";5999;120;6535;6;94;104;10;0,783333333333333;0,866666666666667
"6536";5999;120;6536;6;94;106;12;0,783333333333333;0,883333333333333
"6537";5999;120;6537;6;94;108;14;0,783333333333333;0,9
"6538";5999;120;6538;6;94;110;16;0,783333333333333;0,916666666666667
"6539";5999;120;6539;6;94;112;18;0,783333333333333;0,933333333333333
"6540";5999;120;6540;6;96;108;12;0,8;0,9
"6541";5999;120;6541;6;96;110;14;0,8;0,916666666666667
"6542";5999;120;6542;6;98;106;8;0,816666666666667;0,883333333333333
"6543";5999;120;6543;6;98;108;10;0,816666666666667;0,9
"6544";5999;120;6544;6;98;110;12;0,816666666666667;0,916666666666667
"6545";5999;120;6545;6;98;112;14;0,816666666666667;0,933333333333333
"6546";5999;120;6546;6;98;114;16;0,816666666666667;0,95
"6547";5999;120;6547;6;98;116;18;0,816666666666667;0,966666666666667
"6548";5999;120;6548;6;98;118;20;0,816666666666667;0,983333333333333
"6549";5999;120;6549;6;100;106;6;0,833333333333333;0,883333333333333
"6550";5999;120;6550;6;100;108;8;0,833333333333333;0,9
"6551";5999;120;6551;6;100;110;10;0,833333333333333;0,916666666666667
"6552";5999;120;6552;6;102;108;6;0,85;0,9
"6553";5999;120;6553;6;104;114;10;0,866666666666667;0,95
"6554";5999;120;6554;6;104;116;12;0,866666666666667;0,966666666666667
"6555";5999;120;6555;6;106;116;10;0,883333333333333;0,966666666666667
"6556";5999;120;6556;6;108;116;8;0,9;0,966666666666667
"6557";5999;120;6557;6;108;118;10;0,9;0,983333333333333
"6558";5999;120;6558;6;45;51;6;0,383333333333333;0,433333333333333
"6559";5999;120;6559;6;57;64;7;0,483333333333333;0,533333333333333
"6560";5999;120;6560;6;76;90;14;0,633333333333333;0,75
"6561";5999;120;6561;6;76;92;16;0,633333333333333;0,766666666666667
"6562";5999;120;6562;6;76;94;18;0,633333333333333;0,783333333333333
"6563";5999;120;6563;6;78;98;20;0,65;0,816666666666667
"6564";5999;120;6564;6;78;100;22;0,65;0,833333333333333
"6565";5999;120;6565;6;80;102;22;0,666666666666667;0,85
"6566";5999;120;6566;6;80;104;24;0,666666666666667;0,866666666666667
"6567";5999;120;6567;6;80;106;26;0,666666666666667;0,883333333333333
"6568";5999;120;6568;6;82;94;12;0,683333333333333;0,783333333333333
"6569";5999;120;6569;6;82;96;14;0,683333333333333;0,8
"6570";5999;120;6570;6;82;98;16;0,683333333333333;0,816666666666667
"6571";5999;120;6571;6;84;94;10;0,7;0,783333333333333
"6572";5999;120;6572;6;84;96;12;0,7;0,8
"6573";5999;120;6573;6;84;98;14;0,7;0,816666666666667
"6574";5999;120;6574;6;84;100;16;0,7;0,833333333333333
"6575";5999;120;6575;6;84;102;18;0,7;0,85
"6576";5999;120;6576;6;86;98;12;0,716666666666667;0,816666666666667
"6577";5999;120;6577;6;86;100;14;0,716666666666667;0,833333333333333
"6578";5999;120;6578;6;86;102;16;0,716666666666667;0,85
"6579";5999;120;6579;6;86;104;18;0,716666666666667;0,866666666666667
"6580";5999;120;6580;6;86;106;20;0,716666666666667;0,883333333333333
"6581";5999;120;6581;6;88;108;20;0,733333333333333;0,9
"6582";5999;120;6582;6;88;110;22;0,733333333333333;0,916666666666667
"6583";5999;120;6583;6;88;112;24;0,733333333333333;0,933333333333333
"6584";5999;120;6584;6;88;114;26;0,733333333333333;0,95
"6585";5999;120;6585;6;90;102;12;0,75;0,85
"6586";5999;120;6586;6;90;104;14;0,75;0,866666666666667
"6587";5999;120;6587;6;90;106;16;0,75;0,883333333333333
"6588";5999;120;6588;6;90;108;18;0,75;0,9
"6589";5999;120;6589;6;90;110;20;0,75;0,916666666666667
"6590";5999;120;6590;6;90;112;22;0,75;0,933333333333333
"6591";5999;120;6591;6;92;116;24;0,766666666666667;0,966666666666667
"6592";5999;120;6592;6;94;114;20;0,783333333333333;0,95
"6593";5999;120;6593;6;94;116;22;0,783333333333333;0,966666666666667
"6594";5999;120;6594;6;96;112;16;0,8;0,933333333333333
"6595";5999;120;6595;6;96;114;18;0,8;0,95
"6596";5999;120;6596;6;96;116;20;0,8;0,966666666666667
"6597";5999;120;6597;6;96;118;22;0,8;0,983333333333333
"6598";5999;120;6598;6;100;112;12;0,833333333333333;0,933333333333333
"6599";5999;120;6599;6;100;114;14;0,833333333333333;0,95
"6600";5999;120;6600;6;100;116;16;0,833333333333333;0,966666666666667
"6601";5999;120;6601;6;100;118;18;0,833333333333333;0,983333333333333
"6602";5999;120;6602;6;102;110;8;0,85;0,916666666666667
"6603";5999;120;6603;6;102;112;10;0,85;0,933333333333333
"6604";5999;120;6604;6;102;114;12;0,85;0,95
"6605";5999;120;6605;6;104;118;14;0,866666666666667;0,983333333333333
"6606";5999;120;6606;6;106;118;12;0,883333333333333;0,983333333333333
"6607";5999;120;6607;6;110;116;6;0,916666666666667;0,966666666666667
"6608";5999;120;6608;6;110;118;8;0,916666666666667;0,983333333333333
"6609";5999;120;6609;6;62;68;6;0,516666666666667;0,566666666666667
"6610";5999;120;6610;6;57;66;9;0,483333333333333;0,55
"6611";5999;120;6611;6;66;72;6;0,55;0,6
"6612";5999;120;6612;6;1;7;6;0,0166666666666667;0,0666666666666667
"6613";5999;120;6613;6;68;74;6;0,566666666666667;0,616666666666667
"6614";5999;120;6614;6;68;76;8;0,566666666666667;0,633333333333333
"6615";5999;120;6615;6;72;80;8;0,6;0,666666666666667
"6616";5999;120;6616;6;72;82;10;0,6;0,683333333333333
"6617";5999;120;6617;6;9;15;6;0,0833333333333333;0,133333333333333
"6618";5999;120;6618;6;64;70;6;0,533333333333333;0,583333333333333
"6619";5999;120;6619;6;82;100;18;0,683333333333333;0,833333333333333
"6620";5999;120;6620;6;82;102;20;0,683333333333333;0,85
"6621";5999;120;6621;6;82;104;22;0,683333333333333;0,866666666666667
"6622";5999;120;6622;6;82;106;24;0,683333333333333;0,883333333333333
"6623";5999;120;6623;6;82;108;26;0,683333333333333;0,9
"6624";5999;120;6624;6;82;110;28;0,683333333333333;0,916666666666667
"6625";5999;120;6625;6;104;120;16;0,866666666666667;1
"6626";5999;120;6626;6;106;120;14;0,883333333333333;1
"6627";5999;120;6627;6;108;120;12;0,9;1
"6628";5999;120;6628;6;7;13;6;0,0666666666666667;0,116666666666667
"6629";5999;120;6629;6;92;118;26;0,766666666666667;0,983333333333333
"6630";5999;120;6630;6;92;120;28;0,766666666666667;1
"6631";5999;120;6631;6;94;118;24;0,783333333333333;0,983333333333333
"6632";5999;120;6632;6;96;120;24;0,8;1
"6633";5999;120;6633;6;98;120;22;0,816666666666667;1
"6634";5999;120;6634;6;100;120;20;0,833333333333333;1
"6635";5999;120;6635;6;102;116;14;0,85;0,966666666666667
"6636";5999;120;6636;6;102;118;16;0,85;0,983333333333333
"6637";5999;120;6637;6;102;120;18;0,85;1
"6638";5999;120;6638;6;110;120;10;0,916666666666667;1
"6639";5999;120;6639;6;112;118;6;0,933333333333333;0,983333333333333
"6640";5999;120;6640;6;112;120;8;0,933333333333333;1
"6641";5999;120;6641;6;72;84;12;0,6;0,7
"6642";5999;120;6642;6;72;86;14;0,6;0,716666666666667
"6643";5999;120;6643;6;37;43;6;0,316666666666667;0,366666666666667
"6644";5999;120;6644;6;43;49;6;0,366666666666667;0,416666666666667
"6645";5999;120;6645;6;60;66;6;0,5;0,55
"6646";5999;120;6646;6;53;60;7;0,45;0,5
"6647";5999;120;6647;6;47;53;6;0,4;0,45
"6648";5999;120;6648;6;94;120;26;0,783333333333333;1
"6649";6368;88;6649;3;35;88;53;0,4;1
"6650";6368;88;6650;4;48;72;24;0,545454545454545;0,818181818181818
"6651";6368;88;6651;4;56;80;24;0,636363636363636;0,909090909090909
"6652";6368;88;6652;4;7;31;24;0,0909090909090909;0,363636363636364
"6653";6368;88;6653;4;39;64;25;0,454545454545455;0,727272727272727
"6654";6368;88;6654;4;64;88;24;0,727272727272727;1
"6655";6368;88;6655;4;31;56;25;0,363636363636364;0,636363636363636
"6656";6368;88;6656;4;15;39;24;0,181818181818182;0,454545454545455
"6657";6368;88;6657;5;44;56;12;0,5;0,636363636363636
"6658";6368;88;6658;5;15;27;12;0,181818181818182;0,318181818181818
"6659";6368;88;6659;5;27;39;12;0,318181818181818;0,454545454545455
"6660";6368;88;6660;5;48;60;12;0,545454545454545;0,681818181818182
"6661";6368;88;6661;5;52;64;12;0,590909090909091;0,727272727272727
"6662";6368;88;6662;5;56;68;12;0,636363636363636;0,772727272727273
"6663";6368;88;6663;5;76;88;12;0,863636363636364;1
"6664";6368;88;6664;5;39;52;13;0,454545454545455;0,590909090909091
"6665";6368;88;6665;5;3;15;12;0,0454545454545455;0,181818181818182
"6666";6368;88;6666;5;7;19;12;0,0909090909090909;0,227272727272727
"6667";6368;88;6667;5;11;23;12;0,136363636363636;0,272727272727273
"6668";6368;88;6668;5;19;31;12;0,227272727272727;0,363636363636364
"6669";6368;88;6669;5;72;84;12;0,818181818181818;0,954545454545455
"6670";6368;88;6670;5;64;76;12;0,727272727272727;0,863636363636364
"6671";6368;88;6671;5;23;35;12;0,272727272727273;0,409090909090909
"6672";6368;88;6672;5;68;80;12;0,772727272727273;0,909090909090909
"6673";6368;88;6673;5;60;72;12;0,681818181818182;0,818181818181818
"6674";6368;88;6674;5;52;68;16;0,590909090909091;0,772727272727273
"6675";6368;88;6675;6;3;9;6;0,0454545454545455;0,113636363636364
"6676";6368;88;6676;6;23;29;6;0,272727272727273;0,340909090909091
"6677";6368;88;6677;6;25;31;6;0,295454545454545;0,363636363636364
"6678";6368;88;6678;6;25;33;8;0,295454545454545;0,386363636363636
"6679";6368;88;6679;6;27;33;6;0,318181818181818;0,386363636363636
"6680";6368;88;6680;6;44;50;6;0,5;0,568181818181818
"6681";6368;88;6681;6;78;84;6;0,886363636363636;0,954545454545455
"6682";6368;88;6682;6;5;11;6;0,0681818181818182;0,136363636363636
"6683";6368;88;6683;6;7;13;6;0,0909090909090909;0,159090909090909
"6684";6368;88;6684;6;9;15;6;0,113636363636364;0,181818181818182
"6685";6368;88;6685;6;13;19;6;0,159090909090909;0,227272727272727
"6686";6368;88;6686;6;15;21;6;0,181818181818182;0,25
"6687";6368;88;6687;6;17;23;6;0,204545454545455;0,272727272727273
"6688";6368;88;6688;6;19;25;6;0,227272727272727;0,295454545454545
"6689";6368;88;6689;6;29;35;6;0,340909090909091;0,409090909090909
"6690";6368;88;6690;6;41;48;7;0,477272727272727;0,545454545454545
"6691";6368;88;6691;6;46;52;6;0,522727272727273;0,590909090909091
"6692";6368;88;6692;6;58;64;6;0,659090909090909;0,727272727272727
"6693";6368;88;6693;6;58;66;8;0,659090909090909;0,75
"6694";6368;88;6694;6;64;70;6;0,727272727272727;0,795454545454545
"6695";6368;88;6695;6;66;72;6;0,75;0,818181818181818
"6696";6368;88;6696;6;15;23;8;0,181818181818182;0,272727272727273
"6697";6368;88;6697;6;50;56;6;0,568181818181818;0,636363636363636
"6698";6368;88;6698;6;82;88;6;0,931818181818182;1
"6699";6368;88;6699;6;60;66;6;0,681818181818182;0,75
"6700";6368;88;6700;6;74;80;6;0,840909090909091;0,909090909090909
"6701";6368;88;6701;6;21;27;6;0,25;0,318181818181818
"6702";6368;88;6702;6;41;50;9;0,477272727272727;0,568181818181818
"6703";6368;88;6703;6;44;52;8;0,5;0,590909090909091
"6704";6368;88;6704;6;52;58;6;0,590909090909091;0,659090909090909
"6705";6368;88;6705;6;68;74;6;0,772727272727273;0,840909090909091
"6706";6368;88;6706;6;76;82;6;0,863636363636364;0,931818181818182
"6707";6368;88;6707;6;39;46;7;0,454545454545455;0,522727272727273
"6708";6368;88;6708;6;33;39;6;0,386363636363636;0,454545454545455
"6709";6368;88;6709;6;80;86;6;0,909090909090909;0,977272727272727
"6710";6368;88;6710;6;1;7;6;0,0227272727272727;0,0909090909090909
"6711";6368;88;6711;6;50;58;8;0,568181818181818;0,659090909090909
"6712";6368;88;6712;6;39;48;9;0,454545454545455;0,545454545454545
"6713";6368;88;6713;6;68;76;8;0,772727272727273;0,863636363636364
"6714";6368;88;6714;6;70;76;6;0,795454545454545;0,863636363636364
"6715";6368;88;6715;6;1;9;8;0,0227272727272727;0,113636363636364
"6716";6368;88;6716;6;31;37;6;0,363636363636364;0,431818181818182
"6717";6368;88;6717;6;17;25;8;0,204545454545455;0,295454545454545
"6718";6368;88;6718;6;54;60;6;0,613636363636364;0,681818181818182
"6719";6368;88;6719;6;80;88;8;0,909090909090909;1
"6720";6368;88;6720;6;27;35;8;0,318181818181818;0,409090909090909
"6721";6368;88;6721;6;56;62;6;0,636363636363636;0,704545454545455
"6722";6368;88;6722;6;48;54;6;0,545454545454545;0,613636363636364
"6723";6368;88;6723;6;56;64;8;0,636363636363636;0,727272727272727
"6724";6368;88;6724;6;72;78;6;0,818181818181818;0,886363636363636
"6725";6368;88;6725;6;74;82;8;0,840909090909091;0,931818181818182
"6726";6368;88;6726;6;5;13;8;0,0681818181818182;0,159090909090909
"6727";6368;88;6727;6;62;68;6;0,704545454545455;0,772727272727273
"6728";6368;88;6728;6;11;17;6;0,136363636363636;0,204545454545455
"6729";6368;88;6729;6;78;86;8;0,886363636363636;0,977272727272727
"6730";6368;88;6730;6;78;88;10;0,886363636363636;1
"6731";6368;88;6731;6;23;31;8;0,272727272727273;0,363636363636364
"6732";6368;88;6732;6;54;62;8;0,613636363636364;0,704545454545455
"6733";6368;88;6733;6;66;74;8;0,75;0,840909090909091
"6734";6368;88;6734;6;76;84;8;0,863636363636364;0,954545454545455
"6735";6368;88;6735;6;7;15;8;0,0909090909090909;0,181818181818182
"6736";6368;88;6736;6;3;11;8;0,0454545454545455;0,136363636363636
"6737";6368;88;6737;6;60;68;8;0,681818181818182;0,772727272727273
"6738";6368;88;6738;6;9;17;8;0,113636363636364;0,204545454545455
"6739";6368;88;6739;6;48;56;8;0,545454545454545;0,636363636363636
"6740";6368;88;6740;6;31;39;8;0,363636363636364;0,454545454545455
"6741";6491;146;6741;5;113;138;25;0,777777777777778;0,944444444444444
"6742";6491;146;6742;5;122;146;24;0,833333333333333;1
"6743";6491;146;6743;5;89;113;24;0,611111111111111;0,777777777777778
"6744";6491;146;6744;5;64;89;25;0,444444444444444;0,611111111111111
"6745";6491;146;6745;6;52;64;12;0,361111111111111;0,444444444444444
"6746";6491;146;6746;6;113;126;13;0,777777777777778;0,861111111111111
"6747";6491;146;6747;6;117;130;13;0,805555555555556;0,888888888888889
"6748";6491;146;6748;6;122;134;12;0,833333333333333;0,916666666666667
"6749";6491;146;6749;6;126;138;12;0,861111111111111;0,944444444444444
"6750";6491;146;6750;6;64;77;13;0,444444444444444;0,527777777777778
"6751";6491;146;6751;6;122;138;16;0,833333333333333;0,944444444444444
"6752";6491;146;6752;6;93;105;12;0,638888888888889;0,722222222222222
"6753";6491;146;6753;6;122;142;20;0,833333333333333;0,972222222222222
"6754";6491;146;6754;6;126;142;16;0,861111111111111;0,972222222222222
"6755";6491;146;6755;6;117;134;17;0,805555555555556;0,916666666666667
"6756";6491;146;6756;6;15;28;13;0,111111111111111;0,194444444444444
"6757";6491;146;6757;6;72;85;13;0,5;0,583333333333333
"6758";6491;146;6758;6;81;93;12;0,555555555555556;0,638888888888889
"6759";6491;146;6759;6;130;142;12;0,888888888888889;0,972222222222222
"6760";6491;146;6760;6;134;146;12;0,916666666666667;1
"6761";6491;146;6761;6;32;44;12;0,222222222222222;0,305555555555556
"6762";6491;146;6762;6;97;109;12;0,666666666666667;0,75
"6763";6491;146;6763;6;68;81;13;0,472222222222222;0,555555555555556
"6764";6491;146;6764;6;48;60;12;0,333333333333333;0,416666666666667
"6765";6491;146;6765;6;89;101;12;0,611111111111111;0,694444444444444
"6766";6491;146;6766;6;117;138;21;0,805555555555556;0,944444444444444
"6767";6491;146;6767;6;28;40;12;0,194444444444444;0,277777777777778
"6768";6491;146;6768;6;85;97;12;0,583333333333333;0,666666666666667
"6769";6491;146;6769;6;56;68;12;0,388888888888889;0,472222222222222
"6770";6491;146;6770;6;24;36;12;0,166666666666667;0,25
"6771";6491;146;6771;6;77;89;12;0,527777777777778;0,611111111111111
"6772";6559;121;6772;3;69;121;52;0,571428571428571;1
"6773";6559;121;6773;3;51;104;53;0,428571428571429;0,857142857142857
"6774";6559;121;6774;3;51;121;70;0,428571428571429;1
"6775";6559;121;6775;3;34;86;52;0,285714285714286;0,714285714285714
"6776";6559;121;6776;3;34;104;70;0,285714285714286;0,857142857142857
"6777";6559;121;6777;4;56;80;24;0,466666666666667;0,666666666666667
"6778";6559;121;6778;4;40;64;24;0,333333333333333;0,533333333333333
"6779";6559;121;6779;4;80;105;25;0,666666666666667;0,866666666666667
"6780";6559;121;6780;4;80;113;33;0,666666666666667;0,933333333333333
"6781";6559;121;6781;4;88;113;25;0,733333333333333;0,933333333333333
"6782";6559;121;6782;4;48;72;24;0,4;0,6
"6783";6559;121;6783;4;48;80;32;0,4;0,666666666666667
"6784";6559;121;6784;4;64;88;24;0,533333333333333;0,733333333333333
"6785";6559;121;6785;4;80;121;41;0,666666666666667;1
"6786";6559;121;6786;4;88;121;33;0,733333333333333;1
"6787";6559;121;6787;4;97;121;24;0,8;1
"6788";6559;121;6788;4;40;72;32;0,333333333333333;0,6
"6789";6559;121;6789;4;72;97;25;0,6;0,8
"6790";6559;121;6790;4;72;105;33;0,6;0,866666666666667
"6791";6559;121;6791;4;72;113;41;0,6;0,933333333333333
"6792";6559;121;6792;4;56;88;32;0,466666666666667;0,733333333333333
"6793";6559;121;6793;4;64;97;33;0,533333333333333;0,8
"6794";6559;121;6794;4;48;88;40;0,4;0,733333333333333
"6795";6559;121;6795;4;56;97;41;0,466666666666667;0,8
"6796";6559;121;6796;4;56;105;49;0,466666666666667;0,866666666666667
"6797";6559;121;6797;4;32;56;24;0,266666666666667;0,466666666666667
"6798";6559;121;6798;4;64;105;41;0,533333333333333;0,866666666666667
"6799";6559;121;6799;4;23;48;25;0,2;0,4
"6800";6559;121;6800;4;40;80;40;0,333333333333333;0,666666666666667
"6801";6559;121;6801;4;15;40;25;0,133333333333333;0,333333333333333
"6802";6559;121;6802;4;64;113;49;0,533333333333333;0,933333333333333
"6803";6559;121;6803;5;80;93;13;0,666666666666667;0,766666666666667
"6804";6559;121;6804;5;88;101;13;0,733333333333333;0,833333333333333
"6805";6559;121;6805;5;88;105;17;0,733333333333333;0,866666666666667
"6806";6559;121;6806;5;40;52;12;0,333333333333333;0,433333333333333
"6807";6559;121;6807;5;44;56;12;0,366666666666667;0,466666666666667
"6808";6559;121;6808;5;56;68;12;0,466666666666667;0,566666666666667
"6809";6559;121;6809;5;64;76;12;0,533333333333333;0,633333333333333
"6810";6559;121;6810;5;64;80;16;0,533333333333333;0,666666666666667
"6811";6559;121;6811;5;68;80;12;0,566666666666667;0,666666666666667
"6812";6559;121;6812;5;76;88;12;0,633333333333333;0,733333333333333
"6813";6559;121;6813;5;76;93;17;0,633333333333333;0,766666666666667
"6814";6559;121;6814;5;84;97;13;0,7;0,8
"6815";6559;121;6815;5;84;101;17;0,7;0,833333333333333
"6816";6559;121;6816;5;84;105;21;0,7;0,866666666666667
"6817";6559;121;6817;5;93;105;12;0,766666666666667;0,866666666666667
"6818";6559;121;6818;5;93;109;16;0,766666666666667;0,9
"6819";6559;121;6819;5;93;113;20;0,766666666666667;0,933333333333333
"6820";6559;121;6820;5;97;109;12;0,8;0,9
"6821";6559;121;6821;5;97;113;16;0,8;0,933333333333333
"6822";6559;121;6822;5;101;113;12;0,833333333333333;0,933333333333333
"6823";6559;121;6823;5;101;117;16;0,833333333333333;0,966666666666667
"6824";6559;121;6824;5;23;36;13;0,2;0,3
"6825";6559;121;6825;5;40;56;16;0,333333333333333;0,466666666666667
"6826";6559;121;6826;5;40;60;20;0,333333333333333;0,5
"6827";6559;121;6827;5;40;64;24;0,333333333333333;0,533333333333333
"6828";6559;121;6828;5;44;60;16;0,366666666666667;0,5
"6829";6559;121;6829;5;56;72;16;0,466666666666667;0,6
"6830";6559;121;6830;5;56;76;20;0,466666666666667;0,633333333333333
"6831";6559;121;6831;5;56;80;24;0,466666666666667;0,666666666666667
"6832";6559;121;6832;5;60;72;12;0,5;0,6
"6833";6559;121;6833;5;60;76;16;0,5;0,633333333333333
"6834";6559;121;6834;5;60;80;20;0,5;0,666666666666667
"6835";6559;121;6835;5;80;97;17;0,666666666666667;0,8
"6836";6559;121;6836;5;84;109;25;0,7;0,9
"6837";6559;121;6837;5;84;113;29;0,7;0,933333333333333
"6838";6559;121;6838;5;88;109;21;0,733333333333333;0,9
"6839";6559;121;6839;5;88;113;25;0,733333333333333;0,933333333333333
"6840";6559;121;6840;5;88;117;29;0,733333333333333;0,966666666666667
"6841";6559;121;6841;5;93;117;24;0,766666666666667;0,966666666666667
"6842";6559;121;6842;5;97;117;20;0,8;0,966666666666667
"6843";6559;121;6843;5;44;64;20;0,366666666666667;0,533333333333333
"6844";6559;121;6844;5;44;68;24;0,366666666666667;0,566666666666667
"6845";6559;121;6845;5;48;60;12;0,4;0,5
"6846";6559;121;6846;5;48;64;16;0,4;0,533333333333333
"6847";6559;121;6847;5;48;68;20;0,4;0,566666666666667
"6848";6559;121;6848;5;48;72;24;0,4;0,6
"6849";6559;121;6849;5;48;76;28;0,4;0,633333333333333
"6850";6559;121;6850;5;64;84;20;0,533333333333333;0,7
"6851";6559;121;6851;5;80;101;21;0,666666666666667;0,833333333333333
"6852";6559;121;6852;5;80;105;25;0,666666666666667;0,866666666666667
"6853";6559;121;6853;5;80;109;29;0,666666666666667;0,9
"6854";6559;121;6854;5;80;113;33;0,666666666666667;0,933333333333333
"6855";6559;121;6855;5;80;117;37;0,666666666666667;0,966666666666667
"6856";6559;121;6856;5;80;121;41;0,666666666666667;1
"6857";6559;121;6857;5;84;117;33;0,7;0,966666666666667
"6858";6559;121;6858;5;84;121;37;0,7;1
"6859";6559;121;6859;5;88;121;33;0,733333333333333;1
"6860";6559;121;6860;5;93;121;28;0,766666666666667;1
"6861";6559;121;6861;5;97;121;24;0,8;1
"6862";6559;121;6862;5;101;121;20;0,833333333333333;1
"6863";6559;121;6863;5;19;32;13;0,166666666666667;0,266666666666667
"6864";6559;121;6864;5;19;36;17;0,166666666666667;0,3
"6865";6559;121;6865;5;44;72;28;0,366666666666667;0,6
"6866";6559;121;6866;5;44;76;32;0,366666666666667;0,633333333333333
"6867";6559;121;6867;5;60;84;24;0,5;0,7
"6868";6559;121;6868;5;64;88;24;0,533333333333333;0,733333333333333
"6869";6559;121;6869;5;64;93;29;0,533333333333333;0,766666666666667
"6870";6559;121;6870;5;64;97;33;0,533333333333333;0,8
"6871";6559;121;6871;5;68;84;16;0,566666666666667;0,7
"6872";6559;121;6872;5;76;97;21;0,633333333333333;0,8
"6873";6559;121;6873;5;36;48;12;0,3;0,4
"6874";6559;121;6874;5;27;40;13;0,233333333333333;0,333333333333333
"6875";6559;121;6875;5;76;101;25;0,633333333333333;0,833333333333333
"6876";6559;121;6876;5;52;64;12;0,433333333333333;0,533333333333333
"6877";6559;121;6877;5;56;84;28;0,466666666666667;0,7
"6878";6559;121;6878;5;11;23;12;0,1;0,2
"6879";6559;121;6879;5;15;27;12;0,133333333333333;0,233333333333333
"6880";6559;121;6880;5;60;88;28;0,5;0,733333333333333
"6881";6559;121;6881;5;44;80;36;0,366666666666667;0,666666666666667
"6882";6559;121;6882;5;68;88;20;0,566666666666667;0,733333333333333
"6883";6559;121;6883;5;52;68;16;0,433333333333333;0,566666666666667
"6884";6559;121;6884;5;36;52;16;0,3;0,433333333333333
"6885";6559;121;6885;5;36;56;20;0,3;0,466666666666667
"6886";6559;121;6886;5;40;68;28;0,333333333333333;0,566666666666667
"6887";6559;121;6887;5;56;88;32;0,466666666666667;0,733333333333333
"6888";6559;121;6888;6;47;53;6;0,39344262295082;0,442622950819672
"6889";6559;121;6889;6;97;103;6;0,80327868852459;0,852459016393443
"6890";6559;121;6890;6;13;19;6;0,114754098360656;0,163934426229508
"6891";6559;121;6891;6;17;23;6;0,147540983606557;0,19672131147541
"6892";6559;121;6892;6;27;33;6;0,229508196721311;0,278688524590164
"6893";6559;121;6893;6;29;35;6;0,245901639344262;0,295081967213115
"6894";6559;121;6894;6;29;37;8;0,245901639344262;0,311475409836066
"6895";6559;121;6895;6;31;37;6;0,262295081967213;0,311475409836066
"6896";6559;121;6896;6;39;45;6;0,327868852459016;0,377049180327869
"6897";6559;121;6897;6;39;47;8;0,327868852459016;0,39344262295082
"6898";6559;121;6898;6;41;47;6;0,344262295081967;0,39344262295082
"6899";6559;121;6899;6;41;49;8;0,344262295081967;0,409836065573771
"6900";6559;121;6900;6;43;49;6;0,360655737704918;0,409836065573771
"6901";6559;121;6901;6;43;51;8;0,360655737704918;0,426229508196721
"6902";6559;121;6902;6;49;55;6;0,409836065573771;0,459016393442623
"6903";6559;121;6903;6;49;57;8;0,409836065573771;0,475409836065574
"6904";6559;121;6904;6;57;63;6;0,475409836065574;0,524590163934426
"6905";6559;121;6905;6;57;65;8;0,475409836065574;0,540983606557377
"6906";6559;121;6906;6;61;67;6;0,508196721311475;0,557377049180328
"6907";6559;121;6907;6;61;69;8;0,508196721311475;0,573770491803279
"6908";6559;121;6908;6;61;71;10;0,508196721311475;0,590163934426229
"6909";6559;121;6909;6;61;73;12;0,508196721311475;0,60655737704918
"6910";6559;121;6910;6;63;69;6;0,524590163934426;0,573770491803279
"6911";6559;121;6911;6;63;71;8;0,524590163934426;0,590163934426229
"6912";6559;121;6912;6;63;73;10;0,524590163934426;0,60655737704918
"6913";6559;121;6913;6;65;71;6;0,540983606557377;0,590163934426229
"6914";6559;121;6914;6;65;73;8;0,540983606557377;0,60655737704918
"6915";6559;121;6915;6;67;73;6;0,557377049180328;0,60655737704918
"6916";6559;121;6916;6;67;75;8;0,557377049180328;0,622950819672131
"6917";6559;121;6917;6;67;77;10;0,557377049180328;0,639344262295082
"6918";6559;121;6918;6;69;75;6;0,573770491803279;0,622950819672131
"6919";6559;121;6919;6;69;77;8;0,573770491803279;0,639344262295082
"6920";6559;121;6920;6;79;85;6;0,655737704918033;0,704918032786885
"6921";6559;121;6921;6;81;87;6;0,672131147540984;0,721311475409836
"6922";6559;121;6922;6;85;91;6;0,704918032786885;0,754098360655738
"6923";6559;121;6923;6;85;93;8;0,704918032786885;0,770491803278688
"6924";6559;121;6924;6;87;93;6;0,721311475409836;0,770491803278688
"6925";6559;121;6925;6;87;95;8;0,721311475409836;0,786885245901639
"6926";6559;121;6926;6;93;99;6;0,770491803278688;0,819672131147541
"6927";6559;121;6927;6;95;101;6;0,786885245901639;0,836065573770492
"6928";6559;121;6928;6;95;103;8;0,786885245901639;0,852459016393443
"6929";6559;121;6929;6;95;105;10;0,786885245901639;0,868852459016393
"6930";6559;121;6930;6;99;105;6;0,819672131147541;0,868852459016393
"6931";6559;121;6931;6;99;107;8;0,819672131147541;0,885245901639344
"6932";6559;121;6932;6;101;107;6;0,836065573770492;0,885245901639344
"6933";6559;121;6933;6;101;109;8;0,836065573770492;0,901639344262295
"6934";6559;121;6934;6;115;121;6;0,950819672131147;1
"6935";6559;121;6935;6;27;35;8;0,229508196721311;0,295081967213115
"6936";6559;121;6936;6;27;37;10;0,229508196721311;0,311475409836066
"6937";6559;121;6937;6;41;51;10;0,344262295081967;0,426229508196721
"6938";6559;121;6938;6;43;53;10;0,360655737704918;0,442622950819672
"6939";6559;121;6939;6;43;55;12;0,360655737704918;0,459016393442623
"6940";6559;121;6940;6;43;57;14;0,360655737704918;0,475409836065574
"6941";6559;121;6941;6;47;55;8;0,39344262295082;0,459016393442623
"6942";6559;121;6942;6;47;57;10;0,39344262295082;0,475409836065574
"6943";6559;121;6943;6;57;67;10;0,475409836065574;0,557377049180328
"6944";6559;121;6944;6;57;69;12;0,475409836065574;0,573770491803279
"6945";6559;121;6945;6;57;71;14;0,475409836065574;0,590163934426229
"6946";6559;121;6946;6;57;73;16;0,475409836065574;0,60655737704918
"6947";6559;121;6947;6;57;75;18;0,475409836065574;0,622950819672131
"6948";6559;121;6948;6;61;75;14;0,508196721311475;0,622950819672131
"6949";6559;121;6949;6;63;75;12;0,524590163934426;0,622950819672131
"6950";6559;121;6950;6;63;77;14;0,524590163934426;0,639344262295082
"6951";6559;121;6951;6;63;79;16;0,524590163934426;0,655737704918033
"6952";6559;121;6952;6;65;75;10;0,540983606557377;0,622950819672131
"6953";6559;121;6953;6;65;77;12;0,540983606557377;0,639344262295082
"6954";6559;121;6954;6;65;79;14;0,540983606557377;0,655737704918033
"6955";6559;121;6955;6;67;79;12;0,557377049180328;0,655737704918033
"6956";6559;121;6956;6;69;79;10;0,573770491803279;0,655737704918033
"6957";6559;121;6957;6;79;87;8;0,655737704918033;0,721311475409836
"6958";6559;121;6958;6;79;89;10;0,655737704918033;0,737704918032787
"6959";6559;121;6959;6;79;91;12;0,655737704918033;0,754098360655738
"6960";6559;121;6960;6;81;89;8;0,672131147540984;0,737704918032787
"6961";6559;121;6961;6;81;91;10;0,672131147540984;0,754098360655738
"6962";6559;121;6962;6;81;93;12;0,672131147540984;0,770491803278688
"6963";6559;121;6963;6;85;95;10;0,704918032786885;0,786885245901639
"6964";6559;121;6964;6;85;97;12;0,704918032786885;0,80327868852459
"6965";6559;121;6965;6;85;99;14;0,704918032786885;0,819672131147541
"6966";6559;121;6966;6;85;101;16;0,704918032786885;0,836065573770492
"6967";6559;121;6967;6;85;103;18;0,704918032786885;0,852459016393443
"6968";6559;121;6968;6;85;105;20;0,704918032786885;0,868852459016393
"6969";6559;121;6969;6;87;97;10;0,721311475409836;0,80327868852459
"6970";6559;121;6970;6;87;99;12;0,721311475409836;0,819672131147541
"6971";6559;121;6971;6;87;101;14;0,721311475409836;0,836065573770492
"6972";6559;121;6972;6;93;101;8;0,770491803278688;0,836065573770492
"6973";6559;121;6973;6;93;103;10;0,770491803278688;0,852459016393443
"6974";6559;121;6974;6;93;105;12;0,770491803278688;0,868852459016393
"6975";6559;121;6975;6;93;107;14;0,770491803278688;0,885245901639344
"6976";6559;121;6976;6;93;109;16;0,770491803278688;0,901639344262295
"6977";6559;121;6977;6;93;111;18;0,770491803278688;0,918032786885246
"6978";6559;121;6978;6;93;113;20;0,770491803278688;0,934426229508197
"6979";6559;121;6979;6;95;107;12;0,786885245901639;0,885245901639344
"6980";6559;121;6980;6;95;109;14;0,786885245901639;0,901639344262295
"6981";6559;121;6981;6;95;111;16;0,786885245901639;0,918032786885246
"6982";6559;121;6982;6;95;113;18;0,786885245901639;0,934426229508197
"6983";6559;121;6983;6;97;105;8;0,80327868852459;0,868852459016393
"6984";6559;121;6984;6;97;107;10;0,80327868852459;0,885245901639344
"6985";6559;121;6985;6;97;109;12;0,80327868852459;0,901639344262295
"6986";6559;121;6986;6;97;111;14;0,80327868852459;0,918032786885246
"6987";6559;121;6987;6;97;113;16;0,80327868852459;0,934426229508197
"6988";6559;121;6988;6;99;109;10;0,819672131147541;0,901639344262295
"6989";6559;121;6989;6;99;111;12;0,819672131147541;0,918032786885246
"6990";6559;121;6990;6;99;113;14;0,819672131147541;0,934426229508197
"6991";6559;121;6991;6;99;115;16;0,819672131147541;0,950819672131147
"6992";6559;121;6992;6;101;111;10;0,836065573770492;0,918032786885246
"6993";6559;121;6993;6;101;113;12;0,836065573770492;0,934426229508197
"6994";6559;121;6994;6;101;115;14;0,836065573770492;0,950819672131147
"6995";6559;121;6995;6;101;117;16;0,836065573770492;0,967213114754098
"6996";6559;121;6996;6;15;21;6;0,131147540983607;0,180327868852459
"6997";6559;121;6997;6;37;43;6;0,311475409836066;0,360655737704918
"6998";6559;121;6998;6;39;49;10;0,327868852459016;0,409836065573771
"6999";6559;121;6999;6;39;51;12;0,327868852459016;0,426229508196721
"7000";6559;121;7000;6;39;53;14;0,327868852459016;0,442622950819672
"7001";6559;121;7001;6;41;53;12;0,344262295081967;0,442622950819672
"7002";6559;121;7002;6;41;55;14;0,344262295081967;0,459016393442623
"7003";6559;121;7003;6;41;57;16;0,344262295081967;0,475409836065574
"7004";6559;121;7004;6;43;59;16;0,360655737704918;0,491803278688525
"7005";6559;121;7005;6;43;61;18;0,360655737704918;0,508196721311475
"7006";6559;121;7006;6;43;63;20;0,360655737704918;0,524590163934426
"7007";6559;121;7007;6;45;51;6;0,377049180327869;0,426229508196721
"7008";6559;121;7008;6;45;53;8;0,377049180327869;0,442622950819672
"7009";6559;121;7009;6;45;55;10;0,377049180327869;0,459016393442623
"7010";6559;121;7010;6;45;57;12;0,377049180327869;0,475409836065574
"7011";6559;121;7011;6;47;59;12;0,39344262295082;0,491803278688525
"7012";6559;121;7012;6;47;61;14;0,39344262295082;0,508196721311475
"7013";6559;121;7013;6;47;63;16;0,39344262295082;0,524590163934426
"7014";6559;121;7014;6;47;65;18;0,39344262295082;0,540983606557377
"7015";6559;121;7015;6;49;59;10;0,409836065573771;0,491803278688525
"7016";6559;121;7016;6;49;61;12;0,409836065573771;0,508196721311475
"7017";6559;121;7017;6;57;77;20;0,475409836065574;0,639344262295082
"7018";6559;121;7018;6;57;79;22;0,475409836065574;0,655737704918033
"7019";6559;121;7019;6;57;81;24;0,475409836065574;0,672131147540984
"7020";6559;121;7020;6;63;81;18;0,524590163934426;0,672131147540984
"7021";6559;121;7021;6;63;83;20;0,524590163934426;0,688524590163934
"7022";6559;121;7022;6;65;81;16;0,540983606557377;0,672131147540984
"7023";6559;121;7023;6;67;81;14;0,557377049180328;0,672131147540984
"7024";6559;121;7024;6;67;83;16;0,557377049180328;0,688524590163934
"7025";6559;121;7025;6;67;85;18;0,557377049180328;0,704918032786885
"7026";6559;121;7026;6;69;81;12;0,573770491803279;0,672131147540984
"7027";6559;121;7027;6;79;93;14;0,655737704918033;0,770491803278688
"7028";6559;121;7028;6;79;95;16;0,655737704918033;0,786885245901639
"7029";6559;121;7029;6;79;97;18;0,655737704918033;0,80327868852459
"7030";6559;121;7030;6;79;99;20;0,655737704918033;0,819672131147541
"7031";6559;121;7031;6;81;95;14;0,672131147540984;0,786885245901639
"7032";6559;121;7032;6;81;97;16;0,672131147540984;0,80327868852459
"7033";6559;121;7033;6;81;99;18;0,672131147540984;0,819672131147541
"7034";6559;121;7034;6;81;101;20;0,672131147540984;0,836065573770492
"7035";6559;121;7035;6;81;103;22;0,672131147540984;0,852459016393443
"7036";6559;121;7036;6;81;105;24;0,672131147540984;0,868852459016393
"7037";6559;121;7037;6;81;107;26;0,672131147540984;0,885245901639344
"7038";6559;121;7038;6;81;109;28;0,672131147540984;0,901639344262295
"7039";6559;121;7039;6;81;111;30;0,672131147540984;0,918032786885246
"7040";6559;121;7040;6;81;113;32;0,672131147540984;0,934426229508197
"7041";6559;121;7041;6;81;115;34;0,672131147540984;0,950819672131147
"7042";6559;121;7042;6;85;107;22;0,704918032786885;0,885245901639344
"7043";6559;121;7043;6;85;109;24;0,704918032786885;0,901639344262295
"7044";6559;121;7044;6;85;111;26;0,704918032786885;0,918032786885246
"7045";6559;121;7045;6;85;113;28;0,704918032786885;0,934426229508197
"7046";6559;121;7046;6;85;115;30;0,704918032786885;0,950819672131147
"7047";6559;121;7047;6;85;117;32;0,704918032786885;0,967213114754098
"7048";6559;121;7048;6;85;119;34;0,704918032786885;0,983606557377049
"7049";6559;121;7049;6;87;103;16;0,721311475409836;0,852459016393443
"7050";6559;121;7050;6;87;105;18;0,721311475409836;0,868852459016393
"7051";6559;121;7051;6;87;107;20;0,721311475409836;0,885245901639344
"7052";6559;121;7052;6;87;109;22;0,721311475409836;0,901639344262295
"7053";6559;121;7053;6;87;111;24;0,721311475409836;0,918032786885246
"7054";6559;121;7054;6;87;113;26;0,721311475409836;0,934426229508197
"7055";6559;121;7055;6;87;115;28;0,721311475409836;0,950819672131147
"7056";6559;121;7056;6;89;95;6;0,737704918032787;0,786885245901639
"7057";6559;121;7057;6;89;97;8;0,737704918032787;0,80327868852459
"7058";6559;121;7058;6;89;99;10;0,737704918032787;0,819672131147541
"7059";6559;121;7059;6;89;101;12;0,737704918032787;0,836065573770492
"7060";6559;121;7060;6;89;103;14;0,737704918032787;0,852459016393443
"7061";6559;121;7061;6;89;105;16;0,737704918032787;0,868852459016393
"7062";6559;121;7062;6;89;107;18;0,737704918032787;0,885245901639344
"7063";6559;121;7063;6;89;109;20;0,737704918032787;0,901639344262295
"7064";6559;121;7064;6;93;115;22;0,770491803278688;0,950819672131147
"7065";6559;121;7065;6;93;117;24;0,770491803278688;0,967213114754098
"7066";6559;121;7066;6;93;119;26;0,770491803278688;0,983606557377049
"7067";6559;121;7067;6;95;115;20;0,786885245901639;0,950819672131147
"7068";6559;121;7068;6;95;117;22;0,786885245901639;0,967213114754098
"7069";6559;121;7069;6;95;119;24;0,786885245901639;0,983606557377049
"7070";6559;121;7070;6;97;115;18;0,80327868852459;0,950819672131147
"7071";6559;121;7071;6;97;117;20;0,80327868852459;0,967213114754098
"7072";6559;121;7072;6;97;119;22;0,80327868852459;0,983606557377049
"7073";6559;121;7073;6;99;117;18;0,819672131147541;0,967213114754098
"7074";6559;121;7074;6;99;119;20;0,819672131147541;0,983606557377049
"7075";6559;121;7075;6;49;63;14;0,409836065573771;0,524590163934426
"7076";6559;121;7076;6;55;61;6;0,459016393442623;0,508196721311475
"7077";6559;121;7077;6;55;63;8;0,459016393442623;0,524590163934426
"7078";6559;121;7078;6;97;121;24;0,80327868852459;1
"7079";6559;121;7079;6;99;121;22;0,819672131147541;1
"7080";6559;121;7080;6;101;119;18;0,836065573770492;0,983606557377049
"7081";6559;121;7081;6;101;121;20;0,836065573770492;1
"7082";6559;121;7082;6;25;31;6;0,213114754098361;0,262295081967213
"7083";6559;121;7083;6;91;97;6;0,754098360655738;0,80327868852459
"7084";6559;121;7084;6;91;99;8;0,754098360655738;0,819672131147541
"7085";6559;121;7085;6;91;101;10;0,754098360655738;0,836065573770492
"7086";6559;121;7086;6;91;103;12;0,754098360655738;0,852459016393443
"7087";6559;121;7087;6;49;65;16;0,409836065573771;0,540983606557377
"7088";6559;121;7088;6;61;77;16;0,508196721311475;0,639344262295082
"7089";6559;121;7089;6;61;79;18;0,508196721311475;0,655737704918033
"7090";6559;121;7090;6;69;83;14;0,573770491803279;0,688524590163934
"7091";6559;121;7091;6;69;85;16;0,573770491803279;0,704918032786885
"7092";6559;121;7092;6;91;105;14;0,754098360655738;0,868852459016393
"7093";6559;121;7093;6;91;107;16;0,754098360655738;0,885245901639344
"7094";6559;121;7094;6;95;121;26;0,786885245901639;1
"7095";6559;121;7095;6;25;33;8;0,213114754098361;0,278688524590164
"7096";6559;121;7096;6;55;65;10;0,459016393442623;0,540983606557377
"7097";6559;121;7097;6;37;45;8;0,311475409836066;0,377049180327869
"7098";6559;121;7098;6;43;65;22;0,360655737704918;0,540983606557377
"7099";6559;121;7099;6;65;83;18;0,540983606557377;0,688524590163934
"7100";6559;121;7100;6;85;121;36;0,704918032786885;1
"7101";6559;121;7101;6;87;117;30;0,721311475409836;0,967213114754098
"7102";6559;121;7102;6;87;119;32;0,721311475409836;0,983606557377049
"7103";6559;121;7103;6;93;121;28;0,770491803278688;1
"7104";6559;121;7104;6;23;29;6;0,19672131147541;0,245901639344262
"7105";6559;121;7105;6;15;23;8;0,131147540983607;0,19672131147541
"7106";6559;121;7106;6;25;35;10;0,213114754098361;0,295081967213115
"7107";6559;121;7107;6;25;37;12;0,213114754098361;0,311475409836066
"7108";6559;121;7108;6;55;67;12;0,459016393442623;0,557377049180328
"7109";6559;121;7109;6;41;59;18;0,344262295081967;0,491803278688525
"7110";6559;121;7110;6;41;61;20;0,344262295081967;0,508196721311475
"7111";6559;121;7111;6;89;111;22;0,737704918032787;0,918032786885246
"7112";6559;121;7112;6;55;69;14;0,459016393442623;0,573770491803279
"7113";6559;121;7113;6;55;71;16;0,459016393442623;0,590163934426229
"7114";6559;121;7114;6;39;55;16;0,327868852459016;0,459016393442623
"7115";6559;121;7115;6;39;57;18;0,327868852459016;0,475409836065574
"7116";6559;121;7116;6;87;121;34;0,721311475409836;1
"7117";6559;121;7117;6;45;59;14;0,377049180327869;0,491803278688525
"7118";6559;121;7118;6;45;61;16;0,377049180327869;0,508196721311475
"7119";6869;67;7119;3;16;67;51;0,25;1
"7120";6869;67;7120;4;24;50;26;0,375;0,75
"7121";6869;67;7121;4;24;58;34;0,375;0,875
"7122";6869;67;7122;4;33;58;25;0,5;0,875
"7123";6869;67;7123;4;42;67;25;0,625;1
"7124";6869;67;7124;4;33;67;34;0,5;1
"7125";6869;67;7125;4;16;42;26;0,25;0,625
"7126";6869;67;7126;4;16;50;34;0,25;0,75
"7127";6869;67;7127;4;8;33;25;0,125;0,5
"7128";6869;67;7128;4;24;67;43;0,375;1
"7129";6869;67;7129;4;16;58;42;0,25;0,875
"7130";6869;67;7130;5;35;47;12;0,529411764705882;0,705882352941177
"7131";6869;67;7131;5;35;51;16;0,529411764705882;0,764705882352941
"7132";6869;67;7132;5;39;51;12;0,588235294117647;0,764705882352941
"7133";6869;67;7133;5;55;67;12;0,823529411764706;1
"7134";6869;67;7134;5;19;31;12;0,294117647058824;0,470588235294118
"7135";6869;67;7135;5;43;55;12;0,647058823529412;0,823529411764706
"7136";6869;67;7136;5;43;59;16;0,647058823529412;0,882352941176471
"7137";6869;67;7137;5;43;63;20;0,647058823529412;0,941176470588235
"7138";6869;67;7138;5;27;39;12;0,411764705882353;0,588235294117647
"7139";6869;67;7139;5;39;55;16;0,588235294117647;0,823529411764706
"7140";6869;67;7140;5;39;59;20;0,588235294117647;0,882352941176471
"7141";6869;67;7141;5;39;63;24;0,588235294117647;0,941176470588235
"7142";6869;67;7142;5;39;67;28;0,588235294117647;1
"7143";6869;67;7143;5;43;67;24;0,647058823529412;1
"7144";6869;67;7144;5;47;59;12;0,705882352941177;0,882352941176471
"7145";6869;67;7145;5;47;63;16;0,705882352941177;0,941176470588235
"7146";6869;67;7146;5;47;67;20;0,705882352941177;1
"7147";6869;67;7147;5;51;63;12;0,764705882352941;0,941176470588235
"7148";6869;67;7148;5;51;67;16;0,764705882352941;1
"7149";6869;67;7149;5;23;35;12;0,352941176470588;0,529411764705882
"7150";6869;67;7150;5;31;43;12;0,470588235294118;0,647058823529412
"7151";6869;67;7151;5;31;47;16;0,470588235294118;0,705882352941177
"7152";6869;67;7152;5;31;51;20;0,470588235294118;0,764705882352941
"7153";6869;67;7153;5;11;23;12;0,176470588235294;0,352941176470588
"7154";6869;67;7154;5;23;39;16;0,352941176470588;0,588235294117647
"7155";6869;67;7155;5;31;55;24;0,470588235294118;0,823529411764706
"7156";6869;67;7156;5;31;59;28;0,470588235294118;0,882352941176471
"7157";6869;67;7157;5;35;55;20;0,529411764705882;0,823529411764706
"7158";6869;67;7158;5;35;59;24;0,529411764705882;0,882352941176471
"7159";6869;67;7159;5;35;63;28;0,529411764705882;0,941176470588235
"7160";6869;67;7160;5;27;43;16;0,411764705882353;0,647058823529412
"7161";6869;67;7161;5;27;47;20;0,411764705882353;0,705882352941177
"7162";6869;67;7162;5;35;67;32;0,529411764705882;1
"7163";6869;67;7163;5;23;43;20;0,352941176470588;0,647058823529412
"7164";6869;67;7164;5;19;35;16;0,294117647058824;0,529411764705882
"7165";6869;67;7165;5;15;27;12;0,235294117647059;0,411764705882353
"7166";6869;67;7166;5;7;19;12;0,117647058823529;0,294117647058824
"7167";6869;67;7167;5;11;27;16;0,176470588235294;0,411764705882353
"7168";6869;67;7168;6;21;27;6;0,323529411764706;0,411764705882353
"7169";6869;67;7169;6;21;29;8;0,323529411764706;0,441176470588235
"7170";6869;67;7170;6;23;29;6;0,352941176470588;0,441176470588235
"7171";6869;67;7171;6;31;37;6;0,470588235294118;0,558823529411765
"7172";6869;67;7172;6;37;43;6;0,558823529411765;0,647058823529412
"7173";6869;67;7173;6;37;45;8;0,558823529411765;0,676470588235294
"7174";6869;67;7174;6;41;47;6;0,617647058823529;0,705882352941177
"7175";6869;67;7175;6;55;61;6;0,823529411764706;0,911764705882353
"7176";6869;67;7176;6;55;63;8;0,823529411764706;0,941176470588235
"7177";6869;67;7177;6;57;63;6;0,852941176470588;0,941176470588235
"7178";6869;67;7178;6;19;25;6;0,294117647058824;0,382352941176471
"7179";6869;67;7179;6;37;47;10;0,558823529411765;0,705882352941177
"7180";6869;67;7180;6;37;49;12;0,558823529411765;0,735294117647059
"7181";6869;67;7181;6;37;51;14;0,558823529411765;0,764705882352941
"7182";6869;67;7182;6;41;49;8;0,617647058823529;0,735294117647059
"7183";6869;67;7183;6;41;51;10;0,617647058823529;0,764705882352941
"7184";6869;67;7184;6;41;53;12;0,617647058823529;0,794117647058823
"7185";6869;67;7185;6;43;49;6;0,647058823529412;0,735294117647059
"7186";6869;67;7186;6;43;51;8;0,647058823529412;0,764705882352941
"7187";6869;67;7187;6;45;51;6;0,676470588235294;0,764705882352941
"7188";6869;67;7188;6;45;53;8;0,676470588235294;0,794117647058823
"7189";6869;67;7189;6;45;55;10;0,676470588235294;0,823529411764706
"7190";6869;67;7190;6;45;57;12;0,676470588235294;0,852941176470588
"7191";6869;67;7191;6;47;53;6;0,705882352941177;0,794117647058823
"7192";6869;67;7192;6;47;55;8;0,705882352941177;0,823529411764706
"7193";6869;67;7193;6;47;57;10;0,705882352941177;0,852941176470588
"7194";6869;67;7194;6;47;59;12;0,705882352941177;0,882352941176471
"7195";6869;67;7195;6;49;55;6;0,735294117647059;0,823529411764706
"7196";6869;67;7196;6;49;57;8;0,735294117647059;0,852941176470588
"7197";6869;67;7197;6;51;57;6;0,764705882352941;0,852941176470588
"7198";6869;67;7198;6;51;59;8;0,764705882352941;0,882352941176471
"7199";6869;67;7199;6;53;59;6;0,794117647058823;0,882352941176471
"7200";6869;67;7200;6;53;61;8;0,794117647058823;0,911764705882353
"7201";6869;67;7201;6;53;63;10;0,794117647058823;0,941176470588235
"7202";6869;67;7202;6;53;65;12;0,794117647058823;0,970588235294118
"7203";6869;67;7203;6;55;65;10;0,823529411764706;0,970588235294118
"7204";6869;67;7204;6;55;67;12;0,823529411764706;1
"7205";6869;67;7205;6;57;65;8;0,852941176470588;0,970588235294118
"7206";6869;67;7206;6;57;67;10;0,852941176470588;1
"7207";6869;67;7207;6;15;21;6;0,235294117647059;0,323529411764706
"7208";6869;67;7208;6;23;31;8;0,352941176470588;0,470588235294118
"7209";6869;67;7209;6;25;31;6;0,382352941176471;0,470588235294118
"7210";6869;67;7210;6;41;55;14;0,617647058823529;0,823529411764706
"7211";6869;67;7211;6;41;57;16;0,617647058823529;0,852941176470588
"7212";6869;67;7212;6;41;59;18;0,617647058823529;0,882352941176471
"7213";6869;67;7213;6;41;61;20;0,617647058823529;0,911764705882353
"7214";6869;67;7214;6;41;63;22;0,617647058823529;0,941176470588235
"7215";6869;67;7215;6;43;53;10;0,647058823529412;0,794117647058823
"7216";6869;67;7216;6;43;55;12;0,647058823529412;0,823529411764706
"7217";6869;67;7217;6;43;57;14;0,647058823529412;0,852941176470588
"7218";6869;67;7218;6;43;59;16;0,647058823529412;0,882352941176471
"7219";6869;67;7219;6;43;61;18;0,647058823529412;0,911764705882353
"7220";6869;67;7220;6;45;59;14;0,676470588235294;0,882352941176471
"7221";6869;67;7221;6;45;61;16;0,676470588235294;0,911764705882353
"7222";6869;67;7222;6;45;63;18;0,676470588235294;0,941176470588235
"7223";6869;67;7223;6;45;65;20;0,676470588235294;0,970588235294118
"7224";6869;67;7224;6;47;61;14;0,705882352941177;0,911764705882353
"7225";6869;67;7225;6;49;59;10;0,735294117647059;0,882352941176471
"7226";6869;67;7226;6;49;61;12;0,735294117647059;0,911764705882353
"7227";6869;67;7227;6;49;63;14;0,735294117647059;0,941176470588235
"7228";6869;67;7228;6;49;65;16;0,735294117647059;0,970588235294118
"7229";6869;67;7229;6;7;13;6;0,117647058823529;0,205882352941176
"7230";6869;67;7230;6;17;23;6;0,264705882352941;0,352941176470588
"7231";6869;67;7231;6;13;19;6;0,205882352941176;0,294117647058824
"7232";6869;67;7232;6;17;25;8;0,264705882352941;0,382352941176471
"7233";6869;67;7233;6;19;27;8;0,294117647058824;0,411764705882353
"7234";6869;67;7234;6;19;29;10;0,294117647058824;0,441176470588235
"7235";6869;67;7235;6;19;31;12;0,294117647058824;0,470588235294118
"7236";6869;67;7236;6;21;31;10;0,323529411764706;0,470588235294118
"7237";6869;67;7237;6;31;39;8;0,470588235294118;0,588235294117647
"7238";6869;67;7238;6;31;41;10;0,470588235294118;0,617647058823529
"7239";6869;67;7239;6;31;43;12;0,470588235294118;0,647058823529412
"7240";6869;67;7240;6;53;67;14;0,794117647058823;1
"7241";6869;67;7241;6;17;27;10;0,264705882352941;0,411764705882353
"7242";6869;67;7242;6;29;35;6;0,441176470588235;0,529411764705882
"7243";6869;67;7243;6;23;33;10;0,352941176470588;0,5
"7244";6869;67;7244;6;27;33;6;0,411764705882353;0,5
"7245";6869;67;7245;6;35;41;6;0,529411764705882;0,617647058823529
"7246";6869;67;7246;6;23;35;12;0,352941176470588;0,529411764705882
"7247";6869;67;7247;6;23;37;14;0,352941176470588;0,558823529411765
"7248";6869;67;7248;6;29;37;8;0,441176470588235;0,558823529411765
"7249";6869;67;7249;6;37;53;16;0,558823529411765;0,794117647058823
"7250";6869;67;7250;6;37;55;18;0,558823529411765;0,823529411764706
"7251";6869;67;7251;6;37;57;20;0,558823529411765;0,852941176470588
"7252";6869;67;7252;6;37;59;22;0,558823529411765;0,882352941176471
"7253";6869;67;7253;6;37;61;24;0,558823529411765;0,911764705882353
"7254";6869;67;7254;6;37;63;26;0,558823529411765;0,941176470588235
"7255";6869;67;7255;6;37;65;28;0,558823529411765;0,970588235294118
"7256";6869;67;7256;6;37;67;30;0,558823529411765;1
"7257";6869;67;7257;6;41;65;24;0,617647058823529;0,970588235294118
"7258";6869;67;7258;6;43;63;20;0,647058823529412;0,941176470588235
"7259";6869;67;7259;6;45;67;22;0,676470588235294;1
"7260";6869;67;7260;6;47;63;16;0,705882352941177;0,941176470588235
"7261";6869;67;7261;6;47;65;18;0,705882352941177;0,970588235294118
"7262";6869;67;7262;6;47;67;20;0,705882352941177;1
"7263";6869;67;7263;6;51;61;10;0,764705882352941;0,911764705882353
"7264";6869;67;7264;6;51;63;12;0,764705882352941;0,941176470588235
"7265";6869;67;7265;6;51;65;14;0,764705882352941;0,970588235294118
"7266";6869;67;7266;6;13;21;8;0,205882352941176;0,323529411764706
"7267";6869;67;7267;6;25;33;8;0,382352941176471;0,5
"7268";6869;67;7268;6;49;67;18;0,735294117647059;1
"7269";6869;67;7269;6;51;67;16;0,764705882352941;1
"7270";6869;67;7270;6;9;15;6;0,147058823529412;0,235294117647059
"7271";6869;67;7271;6;11;17;6;0,176470588235294;0,264705882352941
"7272";6869;67;7272;6;41;67;26;0,617647058823529;1
"7273";6869;67;7273;6;27;35;8;0,411764705882353;0,529411764705882
"7274";7198;87;7274;3;34;87;53;0,4;1
"7275";7198;87;7275;3;17;69;52;0,2;0,8
"7276";7198;87;7276;4;47;71;24;0,545454545454545;0,818181818181818
"7277";7198;87;7277;4;23;47;24;0,272727272727273;0,545454545454545
"7278";7198;87;7278;4;31;55;24;0,363636363636364;0,636363636363636
"7279";7198;87;7279;4;7;31;24;0,0909090909090909;0,363636363636364
"7280";7198;87;7280;4;55;79;24;0,636363636363636;0,909090909090909
"7281";7198;87;7281;4;55;87;32;0,636363636363636;1
"7282";7198;87;7282;4;63;87;24;0,727272727272727;1
"7283";7198;87;7283;4;15;39;24;0,181818181818182;0,454545454545455
"7284";7198;87;7284;4;23;55;32;0,272727272727273;0,636363636363636
"7285";7198;87;7285;4;15;47;32;0,181818181818182;0,545454545454545
"7286";7198;87;7286;5;27;39;12;0,318181818181818;0,454545454545455
"7287";7198;87;7287;5;71;83;12;0,818181818181818;0,954545454545455
"7288";7198;87;7288;5;71;87;16;0,818181818181818;1
"7289";7198;87;7289;5;11;23;12;0,136363636363636;0,272727272727273
"7290";7198;87;7290;5;43;55;12;0,5;0,636363636363636
"7291";7198;87;7291;5;63;75;12;0,727272727272727;0,863636363636364
"7292";7198;87;7292;5;63;79;16;0,727272727272727;0,909090909090909
"7293";7198;87;7293;5;3;15;12;0,0454545454545455;0,181818181818182
"7294";7198;87;7294;5;7;19;12;0,0909090909090909;0,227272727272727
"7295";7198;87;7295;5;19;31;12;0,227272727272727;0,363636363636364
"7296";7198;87;7296;5;23;35;12;0,272727272727273;0,409090909090909
"7297";7198;87;7297;5;35;47;12;0,409090909090909;0,545454545454545
"7298";7198;87;7298;5;55;67;12;0,636363636363636;0,772727272727273
"7299";7198;87;7299;5;55;71;16;0,636363636363636;0,818181818181818
"7300";7198;87;7300;5;55;75;20;0,636363636363636;0,863636363636364
"7301";7198;87;7301;5;59;71;12;0,681818181818182;0,818181818181818
"7302";7198;87;7302;5;67;79;12;0,772727272727273;0,909090909090909
"7303";7198;87;7303;5;67;83;16;0,772727272727273;0,954545454545455
"7304";7198;87;7304;5;75;87;12;0,863636363636364;1
"7305";7198;87;7305;5;35;51;16;0,409090909090909;0,590909090909091
"7306";7198;87;7306;5;59;75;16;0,681818181818182;0,863636363636364
"7307";7198;87;7307;5;47;59;12;0,545454545454545;0,681818181818182
"7308";7198;87;7308;5;31;43;12;0,363636363636364;0,5
"7309";7198;87;7309;5;31;47;16;0,363636363636364;0,545454545454545
"7310";7198;87;7310;5;63;83;20;0,727272727272727;0,954545454545455
"7311";7198;87;7311;5;51;63;12;0,590909090909091;0,727272727272727
"7312";7198;87;7312;5;7;23;16;0,0909090909090909;0,272727272727273
"7313";7198;87;7313;5;3;19;16;0,0454545454545455;0,227272727272727
"7314";7198;87;7314;5;27;43;16;0,318181818181818;0,5
"7315";7198;87;7315;5;15;27;12;0,181818181818182;0,318181818181818
"7316";7198;87;7316;5;19;35;16;0,227272727272727;0,409090909090909
"7317";7198;87;7317;5;35;55;20;0,409090909090909;0,636363636363636
"7318";7198;87;7318;5;39;51;12;0,454545454545455;0,590909090909091
"7319";7198;87;7319;5;59;79;20;0,681818181818182;0,909090909090909
"7320";7198;87;7320;5;23;39;16;0,272727272727273;0,454545454545455
"7321";7198;87;7321;6;5;11;6;0,0681818181818182;0,136363636363636
"7322";7198;87;7322;6;11;17;6;0,136363636363636;0,204545454545455
"7323";7198;87;7323;6;53;59;6;0,613636363636364;0,681818181818182
"7324";7198;87;7324;6;63;69;6;0,727272727272727;0,795454545454545
"7325";7198;87;7325;6;63;71;8;0,727272727272727;0,818181818181818
"7326";7198;87;7326;6;65;71;6;0,75;0,818181818181818
"7327";7198;87;7327;6;67;73;6;0,772727272727273;0,840909090909091
"7328";7198;87;7328;6;81;87;6;0,931818181818182;1
"7329";7198;87;7329;6;3;9;6;0,0454545454545455;0,113636363636364
"7330";7198;87;7330;6;3;11;8;0,0454545454545455;0,136363636363636
"7331";7198;87;7331;6;5;13;8;0,0681818181818182;0,159090909090909
"7332";7198;87;7332;6;13;19;6;0,159090909090909;0,227272727272727
"7333";7198;87;7333;6;43;49;6;0,5;0,568181818181818
"7334";7198;87;7334;6;43;51;8;0,5;0,590909090909091
"7335";7198;87;7335;6;45;51;6;0,522727272727273;0,590909090909091
"7336";7198;87;7336;6;57;63;6;0,659090909090909;0,727272727272727
"7337";7198;87;7337;6;57;65;8;0,659090909090909;0,75
"7338";7198;87;7338;6;57;67;10;0,659090909090909;0,772727272727273
"7339";7198;87;7339;6;59;65;6;0,681818181818182;0,75
"7340";7198;87;7340;6;69;75;6;0,795454545454545;0,863636363636364
"7341";7198;87;7341;6;71;77;6;0,818181818181818;0,886363636363636
"7342";7198;87;7342;6;75;81;6;0,863636363636364;0,931818181818182
"7343";7198;87;7343;6;77;83;6;0,886363636363636;0,954545454545455
"7344";7198;87;7344;6;79;85;6;0,909090909090909;0,977272727272727
"7345";7198;87;7345;6;1;7;6;0,0227272727272727;0,0909090909090909
"7346";7198;87;7346;6;1;9;8;0,0227272727272727;0,113636363636364
"7347";7198;87;7347;6;7;13;6;0,0909090909090909;0,159090909090909
"7348";7198;87;7348;6;9;15;6;0,113636363636364;0,181818181818182
"7349";7198;87;7349;6;9;17;8;0,113636363636364;0,204545454545455
"7350";7198;87;7350;6;9;19;10;0,113636363636364;0,227272727272727
"7351";7198;87;7351;6;9;21;12;0,113636363636364;0,25
"7352";7198;87;7352;6;11;19;8;0,136363636363636;0,227272727272727
"7353";7198;87;7353;6;13;21;8;0,159090909090909;0,25
"7354";7198;87;7354;6;15;21;6;0,181818181818182;0,25
"7355";7198;87;7355;6;31;37;6;0,363636363636364;0,431818181818182
"7356";7198;87;7356;6;33;39;6;0,386363636363636;0,454545454545455
"7357";7198;87;7357;6;41;47;6;0,477272727272727;0,545454545454545
"7358";7198;87;7358;6;41;49;8;0,477272727272727;0,568181818181818
"7359";7198;87;7359;6;41;51;10;0,477272727272727;0,590909090909091
"7360";7198;87;7360;6;43;53;10;0,5;0,613636363636364
"7361";7198;87;7361;6;45;53;8;0,522727272727273;0,613636363636364
"7362";7198;87;7362;6;47;53;6;0,545454545454545;0,613636363636364
"7363";7198;87;7363;6;55;61;6;0,636363636363636;0,704545454545455
"7364";7198;87;7364;6;61;67;6;0,704545454545455;0,772727272727273
"7365";7198;87;7365;6;61;69;8;0,704545454545455;0,795454545454545
"7366";7198;87;7366;6;61;71;10;0,704545454545455;0,818181818181818
"7367";7198;87;7367;6;61;73;12;0,704545454545455;0,840909090909091
"7368";7198;87;7368;6;61;75;14;0,704545454545455;0,863636363636364
"7369";7198;87;7369;6;69;77;8;0,795454545454545;0,886363636363636
"7370";7198;87;7370;6;69;79;10;0,795454545454545;0,909090909090909
"7371";7198;87;7371;6;69;81;12;0,795454545454545;0,931818181818182
"7372";7198;87;7372;6;71;79;8;0,818181818181818;0,909090909090909
"7373";7198;87;7373;6;73;79;6;0,840909090909091;0,909090909090909
"7374";7198;87;7374;6;73;81;8;0,840909090909091;0,931818181818182
"7375";7198;87;7375;6;59;67;8;0,681818181818182;0,772727272727273
"7376";7198;87;7376;6;11;21;10;0,136363636363636;0,25
"7377";7198;87;7377;6;35;41;6;0,409090909090909;0,477272727272727
"7378";7198;87;7378;6;35;43;8;0,409090909090909;0,5
"7379";7198;87;7379;6;35;45;10;0,409090909090909;0,522727272727273
"7380";7198;87;7380;6;35;47;12;0,409090909090909;0,545454545454545
"7381";7198;87;7381;6;59;69;10;0,681818181818182;0,795454545454545
"7382";7198;87;7382;6;59;71;12;0,681818181818182;0,818181818181818
"7383";7198;87;7383;6;59;73;14;0,681818181818182;0,840909090909091
"7384";7198;87;7384;6;63;73;10;0,727272727272727;0,840909090909091
"7385";7198;87;7385;6;75;83;8;0,863636363636364;0,954545454545455
"7386";7198;87;7386;6;75;85;10;0,863636363636364;0,977272727272727
"7387";7198;87;7387;6;37;43;6;0,431818181818182;0,5
"7388";7198;87;7388;6;41;53;12;0,477272727272727;0,613636363636364
"7389";7198;87;7389;6;47;55;8;0,545454545454545;0,636363636363636
"7390";7198;87;7390;6;5;15;10;0,0681818181818182;0,181818181818182
"7391";7198;87;7391;6;71;81;10;0,818181818181818;0,931818181818182
"7392";7198;87;7392;6;77;85;8;0,886363636363636;0,977272727272727
"7393";7198;87;7393;6;79;87;8;0,909090909090909;1
"7394";7198;87;7394;6;3;13;10;0,0454545454545455;0,159090909090909
"7395";7198;87;7395;6;21;27;6;0,25;0,318181818181818
"7396";7198;87;7396;6;49;55;6;0,568181818181818;0,636363636363636
"7397";7198;87;7397;6;65;73;8;0,75;0,840909090909091
"7398";7198;87;7398;6;65;75;10;0,75;0,863636363636364
"7399";7198;87;7399;6;65;77;12;0,75;0,886363636363636
"7400";7198;87;7400;6;65;79;14;0,75;0,909090909090909
"7401";7198;87;7401;6;71;83;12;0,818181818181818;0,954545454545455
"7402";7198;87;7402;6;71;85;14;0,818181818181818;0,977272727272727
"7403";7198;87;7403;6;73;83;10;0,840909090909091;0,954545454545455
"7404";7198;87;7404;6;77;87;10;0,886363636363636;1
"7405";7198;87;7405;6;39;45;6;0,454545454545455;0,522727272727273
"7406";7198;87;7406;6;67;75;8;0,772727272727273;0,863636363636364
"7407";7198;87;7407;6;31;39;8;0,363636363636364;0,454545454545455
"7408";7198;87;7408;6;63;75;12;0,727272727272727;0,863636363636364
"7409";7198;87;7409;6;73;85;12;0,840909090909091;0,977272727272727
"7410";7198;87;7410;6;1;11;10;0,0227272727272727;0,136363636363636
"7411";7198;87;7411;6;1;13;12;0,0227272727272727;0,159090909090909
"7412";7198;87;7412;6;63;77;14;0,727272727272727;0,886363636363636
"7413";7198;87;7413;6;63;79;16;0,727272727272727;0,909090909090909
"7414";7198;87;7414;6;67;77;10;0,772727272727273;0,886363636363636
"7415";7198;87;7415;6;7;15;8;0,0909090909090909;0,181818181818182
"7416";7198;87;7416;6;29;35;6;0,340909090909091;0,409090909090909
"7417";7198;87;7417;6;33;41;8;0,386363636363636;0,477272727272727
"7418";7198;87;7418;6;37;45;8;0,431818181818182;0,522727272727273
"7419";7198;87;7419;6;37;47;10;0,431818181818182;0,545454545454545
"7420";7198;87;7420;6;39;47;8;0,454545454545455;0,545454545454545
"7421";7198;87;7421;6;57;69;12;0,659090909090909;0,795454545454545
"7422";7198;87;7422;6;3;15;12;0,0454545454545455;0,181818181818182
"7423";7198;87;7423;6;55;63;8;0,636363636363636;0,727272727272727
"7424";7198;87;7424;6;7;17;10;0,0909090909090909;0,204545454545455
"7425";7198;87;7425;6;7;19;12;0,0909090909090909;0,227272727272727
"7426";7198;87;7426;6;49;57;8;0,568181818181818;0,659090909090909
"7427";7198;87;7427;6;57;71;14;0,659090909090909;0,818181818181818
"7428";7198;87;7428;6;33;43;10;0,386363636363636;0,5
"7429";7198;87;7429;6;33;45;12;0,386363636363636;0,522727272727273
"7430";7198;87;7430;6;35;49;14;0,409090909090909;0,568181818181818
"7431";7198;87;7431;6;53;61;8;0,613636363636364;0,704545454545455
"7432";7198;87;7432;6;53;63;10;0,613636363636364;0,727272727272727
"7433";7198;87;7433;6;73;87;14;0,840909090909091;1
"7434";7198;87;7434;6;55;65;10;0,636363636363636;0,75
"7435";7198;87;7435;6;39;49;10;0,454545454545455;0,568181818181818
"7436";7198;87;7436;6;39;51;12;0,454545454545455;0,590909090909091
"7437";7299;65;7437;3;16;65;49;0,25;1
"7438";7299;65;7438;4;24;48;24;0,375;0,75
"7439";7299;65;7439;4;32;57;25;0,5;0,875
"7440";7299;65;7440;4;32;65;33;0,5;1
"7441";7299;65;7441;4;40;65;25;0,625;1
"7442";7299;65;7442;4;24;57;33;0,375;0,875
"7443";7299;65;7443;4;16;40;24;0,25;0,625
"7444";7299;65;7444;4;24;65;41;0,375;1
"7445";7299;65;7445;5;24;36;12;0,375;0,5625
"7446";7299;65;7446;5;32;44;12;0,5;0,6875
"7447";7299;65;7447;5;32;48;16;0,5;0,75
"7448";7299;65;7448;5;36;48;12;0,5625;0,75
"7449";7299;65;7449;5;48;61;13;0,75;0,9375
"7450";7299;65;7450;5;53;65;12;0,8125;1
"7451";7299;65;7451;5;36;53;17;0,5625;0,8125
"7452";7299;65;7452;5;44;57;13;0,6875;0,875
"7453";7299;65;7453;5;32;53;21;0,5;0,8125
"7454";7299;65;7454;5;36;57;21;0,5625;0,875
"7455";7299;65;7455;5;36;61;25;0,5625;0,9375
"7456";7299;65;7456;5;36;65;29;0,5625;1
"7457";7299;65;7457;5;40;53;13;0,625;0,8125
"7458";7299;65;7458;5;40;57;17;0,625;0,875
"7459";7299;65;7459;5;40;61;21;0,625;0,9375
"7460";7299;65;7460;5;44;61;17;0,6875;0,9375
"7461";7299;65;7461;5;44;65;21;0,6875;1
"7462";7299;65;7462;5;48;65;17;0,75;1
"7463";7299;65;7463;5;20;32;12;0,3125;0,5
"7464";7299;65;7464;5;16;28;12;0,25;0,4375
"7465";7299;65;7465;5;32;57;25;0,5;0,875
"7466";7299;65;7466;5;32;61;29;0,5;0,9375
"7467";7299;65;7467;5;11;24;13;0,1875;0,375
"7468";7299;65;7468;5;24;40;16;0,375;0,625
"7469";7299;65;7469;5;32;65;33;0,5;1
"7470";7299;65;7470;5;28;40;12;0,4375;0,625
"7471";7299;65;7471;5;20;36;16;0,3125;0,5625
"7472";7299;65;7472;5;20;40;20;0,3125;0,625
"7473";7299;65;7473;5;24;44;20;0,375;0,6875
"7474";7299;65;7474;6;23;29;6;0,363636363636364;0,454545454545455
"7475";7299;65;7475;6;49;55;6;0,757575757575758;0,848484848484849
"7476";7299;65;7476;6;51;57;6;0,787878787878788;0,878787878787879
"7477";7299;65;7477;6;51;59;8;0,787878787878788;0,909090909090909
"7478";7299;65;7478;6;55;61;6;0,848484848484849;0,939393939393939
"7479";7299;65;7479;6;1;7;6;0,0303030303030303;0,121212121212121
"7480";7299;65;7480;6;25;31;6;0,393939393939394;0,484848484848485
"7481";7299;65;7481;6;25;33;8;0,393939393939394;0,515151515151515
"7482";7299;65;7482;6;33;39;6;0,515151515151515;0,606060606060606
"7483";7299;65;7483;6;35;41;6;0,545454545454545;0,636363636363636
"7484";7299;65;7484;6;35;43;8;0,545454545454545;0,666666666666667
"7485";7299;65;7485;6;41;47;6;0,636363636363636;0,727272727272727
"7486";7299;65;7486;6;41;49;8;0,636363636363636;0,757575757575758
"7487";7299;65;7487;6;41;51;10;0,636363636363636;0,787878787878788
"7488";7299;65;7488;6;41;53;12;0,636363636363636;0,818181818181818
"7489";7299;65;7489;6;45;51;6;0,696969696969697;0,787878787878788
"7490";7299;65;7490;6;45;53;8;0,696969696969697;0,818181818181818
"7491";7299;65;7491;6;45;55;10;0,696969696969697;0,848484848484849
"7492";7299;65;7492;6;47;53;6;0,727272727272727;0,818181818181818
"7493";7299;65;7493;6;47;55;8;0,727272727272727;0,848484848484849
"7494";7299;65;7494;6;47;57;10;0,727272727272727;0,878787878787879
"7495";7299;65;7495;6;49;57;8;0,757575757575758;0,878787878787879
"7496";7299;65;7496;6;49;59;10;0,757575757575758;0,909090909090909
"7497";7299;65;7497;6;49;61;12;0,757575757575758;0,939393939393939
"7498";7299;65;7498;6;49;63;14;0,757575757575758;0,96969696969697
"7499";7299;65;7499;6;51;61;10;0,787878787878788;0,939393939393939
"7500";7299;65;7500;6;51;63;12;0,787878787878788;0,96969696969697
"7501";7299;65;7501;6;51;65;14;0,787878787878788;1
"7502";7299;65;7502;6;55;63;8;0,848484848484849;0,96969696969697
"7503";7299;65;7503;6;55;65;10;0,848484848484849;1
"7504";7299;65;7504;6;57;63;6;0,878787878787879;0,96969696969697
"7505";7299;65;7505;6;57;65;8;0,878787878787879;1
"7506";7299;65;7506;6;33;41;8;0,515151515151515;0,636363636363636
"7507";7299;65;7507;6;33;43;10;0,515151515151515;0,666666666666667
"7508";7299;65;7508;6;33;45;12;0,515151515151515;0,696969696969697
"7509";7299;65;7509;6;35;45;10;0,545454545454545;0,696969696969697
"7510";7299;65;7510;6;45;57;12;0,696969696969697;0,878787878787879
"7511";7299;65;7511;6;45;59;14;0,696969696969697;0,909090909090909
"7512";7299;65;7512;6;45;61;16;0,696969696969697;0,939393939393939
"7513";7299;65;7513;6;45;63;18;0,696969696969697;0,96969696969697
"7514";7299;65;7514;6;31;37;6;0,484848484848485;0,575757575757576
"7515";7299;65;7515;6;13;19;6;0,212121212121212;0,303030303030303
"7516";7299;65;7516;6;21;27;6;0,333333333333333;0,424242424242424
"7517";7299;65;7517;6;21;29;8;0,333333333333333;0,454545454545455
"7518";7299;65;7518;6;47;59;12;0,727272727272727;0,909090909090909
"7519";7299;65;7519;6;47;61;14;0,727272727272727;0,939393939393939
"7520";7299;65;7520;6;47;63;16;0,727272727272727;0,96969696969697
"7521";7299;65;7521;6;49;65;16;0,757575757575758;1
"7522";7299;65;7522;6;7;13;6;0,121212121212121;0,212121212121212
"7523";7299;65;7523;6;17;23;6;0,272727272727273;0,363636363636364
"7524";7299;65;7524;6;17;25;8;0,272727272727273;0,393939393939394
"7525";7299;65;7525;6;19;25;6;0,303030303030303;0,393939393939394
"7526";7299;65;7526;6;33;47;14;0,515151515151515;0,727272727272727
"7527";7299;65;7527;6;33;49;16;0,515151515151515;0,757575757575758
"7528";7299;65;7528;6;35;47;12;0,545454545454545;0,727272727272727
"7529";7299;65;7529;6;35;49;14;0,545454545454545;0,757575757575758
"7530";7299;65;7530;6;35;51;16;0,545454545454545;0,787878787878788
"7531";7299;65;7531;6;27;33;6;0,424242424242424;0,515151515151515
"7532";7299;65;7532;6;33;51;18;0,515151515151515;0,787878787878788
"7533";7299;65;7533;6;33;53;20;0,515151515151515;0,818181818181818
"7534";7299;65;7534;6;33;55;22;0,515151515151515;0,848484848484849
"7535";7299;65;7535;6;33;57;24;0,515151515151515;0,878787878787879
"7536";7299;65;7536;6;33;59;26;0,515151515151515;0,909090909090909
"7537";7299;65;7537;6;35;53;18;0,545454545454545;0,818181818181818
"7538";7299;65;7538;6;35;55;20;0,545454545454545;0,848484848484849
"7539";7299;65;7539;6;35;57;22;0,545454545454545;0,878787878787879
"7540";7299;65;7540;6;35;59;24;0,545454545454545;0,909090909090909
"7541";7299;65;7541;6;35;61;26;0,545454545454545;0,939393939393939
"7542";7299;65;7542;6;41;55;14;0,636363636363636;0,848484848484849
"7543";7299;65;7543;6;41;57;16;0,636363636363636;0,878787878787879
"7544";7299;65;7544;6;47;65;18;0,727272727272727;1
"7545";7299;65;7545;6;23;31;8;0,363636363636364;0,484848484848485
"7546";7299;65;7546;6;15;21;6;0,242424242424242;0,333333333333333
"7547";7299;65;7547;6;45;65;20;0,696969696969697;1
"7548";7299;65;7548;6;29;35;6;0,454545454545455;0,545454545454545
"7549";7299;65;7549;6;21;31;10;0,333333333333333;0,484848484848485
"7550";7299;65;7550;6;19;27;8;0,303030303030303;0,424242424242424
"7551";7299;65;7551;6;23;33;10;0,363636363636364;0,515151515151515
"7552";7329;156;7552;3;38;156;118;0,25;1
"7553";7329;156;7553;4;86;139;53;0,555555555555556;0,888888888888889
"7554";7329;156;7554;4;86;156;70;0,555555555555556;1
"7555";7329;156;7555;4;51;104;53;0,333333333333333;0,666666666666667
"7556";7329;156;7556;4;69;121;52;0,444444444444444;0,777777777777778
"7557";7329;156;7557;4;16;69;53;0,111111111111111;0,444444444444444
"7558";7329;156;7558;4;104;156;52;0,666666666666667;1
"7559";7329;156;7559;4;69;139;70;0,444444444444444;0,888888888888889
"7560";7329;156;7560;5;115;139;24;0,736842105263158;0,894736842105263
"7561";7329;156;7561;5;40;65;25;0,263157894736842;0,421052631578947
"7562";7329;156;7562;5;106;131;25;0,684210526315789;0,842105263157895
"7563";7329;156;7563;5;106;139;33;0,684210526315789;0,894736842105263
"7564";7329;156;7564;5;106;148;42;0,684210526315789;0,947368421052632
"7565";7329;156;7565;5;115;148;33;0,736842105263158;0,947368421052632
"7566";7329;156;7566;5;115;156;41;0,736842105263158;1
"7567";7329;156;7567;5;123;148;25;0,789473684210526;0,947368421052632
"7568";7329;156;7568;5;123;156;33;0,789473684210526;1
"7569";7329;156;7569;5;131;156;25;0,842105263157895;1
"7570";7329;156;7570;5;16;40;24;0,105263157894737;0,263157894736842
"7571";7329;156;7571;5;24;49;25;0,157894736842105;0,315789473684211
"7572";7329;156;7572;5;32;57;25;0,210526315789474;0,368421052631579
"7573";7329;156;7573;5;32;65;33;0,210526315789474;0,421052631578947
"7574";7329;156;7574;5;98;123;25;0,631578947368421;0,789473684210526
"7575";7329;156;7575;5;106;156;50;0,684210526315789;1
"7576";7329;156;7576;6;35;47;12;0,230769230769231;0,307692307692308
"7577";7329;156;7577;6;35;51;16;0,230769230769231;0,333333333333333
"7578";7329;156;7578;6;104;116;12;0,666666666666667;0,743589743589744
"7579";7329;156;7579;6;108;120;12;0,692307692307692;0,769230769230769
"7580";7329;156;7580;6;108;124;16;0,692307692307692;0,794871794871795
"7581";7329;156;7581;6;112;124;12;0,717948717948718;0,794871794871795
"7582";7329;156;7582;6;112;128;16;0,717948717948718;0,82051282051282
"7583";7329;156;7583;6;112;132;20;0,717948717948718;0,846153846153846
"7584";7329;156;7584;6;116;128;12;0,743589743589744;0,82051282051282
"7585";7329;156;7585;6;116;132;16;0,743589743589744;0,846153846153846
"7586";7329;156;7586;6;116;136;20;0,743589743589744;0,871794871794872
"7587";7329;156;7587;6;120;132;12;0,769230769230769;0,846153846153846
"7588";7329;156;7588;6;120;136;16;0,769230769230769;0,871794871794872
"7589";7329;156;7589;6;124;136;12;0,794871794871795;0,871794871794872
"7590";7329;156;7590;6;128;140;12;0,82051282051282;0,897435897435897
"7591";7329;156;7591;6;128;144;16;0,82051282051282;0,923076923076923
"7592";7329;156;7592;6;132;144;12;0,846153846153846;0,923076923076923
"7593";7329;156;7593;6;136;148;12;0,871794871794872;0,948717948717949
"7594";7329;156;7594;6;136;152;16;0,871794871794872;0,974358974358974
"7595";7329;156;7595;6;144;156;12;0,923076923076923;1
"7596";7329;156;7596;6;23;35;12;0,153846153846154;0,230769230769231
"7597";7329;156;7597;6;39;51;12;0,256410256410256;0,333333333333333
"7598";7329;156;7598;6;116;140;24;0,743589743589744;0,897435897435897
"7599";7329;156;7599;6;116;144;28;0,743589743589744;0,923076923076923
"7600";7329;156;7600;6;120;140;20;0,769230769230769;0,897435897435897
"7601";7329;156;7601;6;128;148;20;0,82051282051282;0,948717948717949
"7602";7329;156;7602;6;128;152;24;0,82051282051282;0,974358974358974
"7603";7329;156;7603;6;96;108;12;0,615384615384615;0,692307692307692
"7604";7329;156;7604;6;19;31;12;0,128205128205128;0,205128205128205
"7605";7329;156;7605;6;59;71;12;0,384615384615385;0,461538461538462
"7606";7329;156;7606;6;104;120;16;0,666666666666667;0,769230769230769
"7607";7329;156;7607;6;35;55;20;0,230769230769231;0,358974358974359
"7608";7329;156;7608;6;39;55;16;0,256410256410256;0,358974358974359
"7609";7329;156;7609;6;47;59;12;0,307692307692308;0,384615384615385
"7610";7329;156;7610;6;112;136;24;0,717948717948718;0,871794871794872
"7611";7329;156;7611;6;112;140;28;0,717948717948718;0,897435897435897
"7612";7329;156;7612;6;120;144;24;0,769230769230769;0,923076923076923
"7613";7329;156;7613;6;120;148;28;0,769230769230769;0,948717948717949
"7614";7329;156;7614;6;124;140;16;0,794871794871795;0,897435897435897
"7615";7329;156;7615;6;124;144;20;0,794871794871795;0,923076923076923
"7616";7329;156;7616;6;132;148;16;0,846153846153846;0,948717948717949
"7617";7329;156;7617;6;132;152;20;0,846153846153846;0,974358974358974
"7618";7329;156;7618;6;136;156;20;0,871794871794872;1
"7619";7329;156;7619;6;3;15;12;0,0256410256410256;0,102564102564103
"7620";7329;156;7620;6;51;63;12;0,333333333333333;0,41025641025641
"7621";7329;156;7621;6;15;27;12;0,102564102564103;0,179487179487179
"7622";7329;156;7622;6;31;43;12;0,205128205128205;0,282051282051282
"7623";7329;156;7623;6;104;124;20;0,666666666666667;0,794871794871795
"7624";7329;156;7624;6;108;128;20;0,692307692307692;0,82051282051282
"7625";7329;156;7625;6;108;132;24;0,692307692307692;0,846153846153846
"7626";7329;156;7626;6;112;144;32;0,717948717948718;0,923076923076923
"7627";7329;156;7627;6;112;148;36;0,717948717948718;0,948717948717949
"7628";7329;156;7628;6;120;152;32;0,769230769230769;0,974358974358974
"7629";7329;156;7629;6;120;156;36;0,769230769230769;1
"7630";7329;156;7630;6;128;156;28;0,82051282051282;1
"7631";7329;156;7631;6;132;156;24;0,846153846153846;1
"7632";7329;156;7632;6;27;39;12;0,179487179487179;0,256410256410256
"7633";7329;156;7633;6;23;39;16;0,153846153846154;0,256410256410256
"7634";7329;156;7634;6;100;112;12;0,641025641025641;0,717948717948718
"7635";7329;156;7635;6;140;152;12;0,897435897435897;0,974358974358974
"7636";7329;156;7636;6;31;47;16;0,205128205128205;0,307692307692308
"7637";7329;156;7637;6;31;51;20;0,205128205128205;0,333333333333333
"7638";7329;156;7638;6;140;156;16;0,897435897435897;1
"7639";7329;156;7639;6;11;23;12;0,0769230769230769;0,153846153846154
"7640";7329;156;7640;6;108;136;28;0,692307692307692;0,871794871794872
"7641";7329;156;7641;6;124;148;24;0,794871794871795;0,948717948717949
"7642";7329;156;7642;6;116;148;32;0,743589743589744;0,948717948717949
"7643";7329;156;7643;6;124;152;28;0,794871794871795;0,974358974358974
"7644";7329;156;7644;6;124;156;32;0,794871794871795;1
"7645";7329;156;7645;6;51;67;16;0,333333333333333;0,435897435897436
"7646";7329;156;7646;6;116;152;36;0,743589743589744;0,974358974358974
"7647";7329;156;7647;6;116;156;40;0,743589743589744;1
"7648";7329;156;7648;6;55;67;12;0,358974358974359;0,435897435897436
"7649";7858;133;7649;4;16;66;50;0,125;0,5
"7650";7858;133;7650;4;49;100;51;0,375;0,75
"7651";7858;133;7651;4;32;83;51;0,25;0,625
"7652";7858;133;7652;5;74;100;26;0,5625;0,75
"7653";7858;133;7653;5;108;133;25;0,8125;1
"7654";7858;133;7654;5;49;74;25;0,375;0,5625
"7655";7858;133;7655;5;32;58;26;0,25;0,4375
"7656";7858;133;7656;5;66;91;25;0,5;0,6875
"7657";7858;133;7657;5;41;66;25;0,3125;0,5
"7658";7858;133;7658;5;66;100;34;0,5;0,75
"7659";7858;133;7659;5;24;49;25;0,1875;0,375
"7660";7858;133;7660;5;58;83;25;0,4375;0,625
"7661";7858;133;7661;5;16;41;25;0,125;0,3125
"7662";7858;133;7662;6;23;36;13;0,181818181818182;0,272727272727273
"7663";7858;133;7663;6;113;125;12;0,848484848484849;0,939393939393939
"7664";7858;133;7664;6;44;56;12;0,333333333333333;0,424242424242424
"7665";7858;133;7665;6;56;68;12;0,424242424242424;0,515151515151515
"7666";7858;133;7666;6;15;27;12;0,121212121212121;0,212121212121212
"7667";7858;133;7667;6;19;31;12;0,151515151515152;0,242424242424242
"7668";7858;133;7668;6;48;60;12;0,363636363636364;0,454545454545455
"7669";7858;133;7669;6;68;80;12;0,515151515151515;0,606060606060606
"7670";7858;133;7670;6;52;64;12;0,393939393939394;0,484848484848485
"7671";7858;133;7671;6;27;40;13;0,212121212121212;0,303030303030303
"7672";7858;133;7672;6;48;64;16;0,363636363636364;0,484848484848485
"7673";7858;133;7673;6;72;84;12;0,545454545454545;0,636363636363636
"7674";7858;133;7674;6;40;52;12;0,303030303030303;0,393939393939394
"7675";7858;133;7675;6;52;68;16;0,393939393939394;0,515151515151515
"7676";7858;133;7676;6;68;84;16;0,515151515151515;0,636363636363636
"7677";7858;133;7677;6;60;72;12;0,454545454545455;0,545454545454545
"7678";7858;133;7678;6;31;44;13;0,242424242424242;0,333333333333333
"7679";7858;133;7679;6;76;88;12;0,575757575757576;0,666666666666667
"7680";7858;133;7680;6;36;48;12;0,272727272727273;0,363636363636364
"7681";7858;133;7681;6;84;96;12;0,636363636363636;0,727272727272727
"7682";7858;133;7682;6;64;76;12;0,484848484848485;0,575757575757576
"7683";7858;133;7683;6;113;129;16;0,848484848484849;0,96969696969697
"7684";7858;133;7684;6;109;121;12;0,818181818181818;0,909090909090909
"7685";7858;133;7685;6;109;125;16;0,818181818181818;0,939393939393939
"7686";7858;133;7686;6;109;129;20;0,818181818181818;0,96969696969697
"7687";7858;133;7687;6;109;133;24;0,818181818181818;1
"7688";7858;133;7688;6;72;88;16;0,545454545454545;0,666666666666667
"7689";7858;133;7689;6;113;133;20;0,848484848484849;1
"7690";7858;133;7690;6;101;113;12;0,757575757575758;0,848484848484849
"7691";8258;86;7691;4;51;77;26;0,6;0,9
"7692";8258;86;7692;4;60;86;26;0,7;1
"7693";8258;86;7693;4;16;42;26;0,2;0,5
"7694";8258;86;7694;4;25;51;26;0,3;0,6
"7695";8258;86;7695;4;34;60;26;0,4;0,7
"7696";8258;86;7696;4;42;69;27;0,5;0,8
"7697";8258;86;7697;5;49;61;12;0,571428571428571;0,714285714285714
"7698";8258;86;7698;5;74;86;12;0,857142857142857;1
"7699";8258;86;7699;5;57;69;12;0,666666666666667;0,80952380952381
"7700";8258;86;7700;5;69;82;13;0,80952380952381;0,952380952380952
"7701";8258;86;7701;5;69;86;17;0,80952380952381;1
"7702";8258;86;7702;5;20;32;12;0,238095238095238;0,380952380952381
"7703";8258;86;7703;5;53;65;12;0,619047619047619;0,761904761904762
"7704";8258;86;7704;5;24;36;12;0,285714285714286;0,428571428571429
"7705";8258;86;7705;5;65;78;13;0,761904761904762;0,904761904761905
"7706";8258;86;7706;5;61;74;13;0,714285714285714;0,857142857142857
"7707";8258;86;7707;5;61;78;17;0,714285714285714;0,904761904761905
"7708";8258;86;7708;5;53;69;16;0,619047619047619;0,80952380952381
"7709";8258;86;7709;5;28;40;12;0,333333333333333;0,476190476190476
"7710";8258;86;7710;6;23;29;6;0,27906976744186;0,348837209302326
"7711";8258;86;7711;6;76;82;6;0,883720930232558;0,953488372093023
"7712";8258;86;7712;6;15;21;6;0,186046511627907;0,255813953488372
"7713";8258;86;7713;6;50;56;6;0,581395348837209;0,651162790697674
"7714";8258;86;7714;6;52;58;6;0,604651162790698;0,674418604651163
"7715";8258;86;7715;6;58;64;6;0,674418604651163;0,744186046511628
"7716";8258;86;7716;6;58;66;8;0,674418604651163;0,767441860465116
"7717";8258;86;7717;6;60;66;6;0,697674418604651;0,767441860465116
"7718";8258;86;7718;6;60;68;8;0,697674418604651;0,790697674418605
"7719";8258;86;7719;6;62;68;6;0,720930232558139;0,790697674418605
"7720";8258;86;7720;6;70;76;6;0,813953488372093;0,883720930232558
"7721";8258;86;7721;6;31;37;6;0,372093023255814;0,441860465116279
"7722";8258;86;7722;6;48;54;6;0,558139534883721;0,627906976744186
"7723";8258;86;7723;6;54;60;6;0,627906976744186;0,697674418604651
"7724";8258;86;7724;6;78;84;6;0,906976744186046;0,976744186046512
"7725";8258;86;7725;6;80;86;6;0,930232558139535;1
"7726";8258;86;7726;6;58;68;10;0,674418604651163;0,790697674418605
"7727";8258;86;7727;6;76;84;8;0,883720930232558;0,976744186046512
"7728";8258;86;7728;6;33;39;6;0,395348837209302;0,465116279069767
"7729";8258;86;7729;6;50;58;8;0,581395348837209;0,674418604651163
"7730";8258;86;7730;6;76;86;10;0,883720930232558;1
"7731";8258;86;7731;6;78;86;8;0,906976744186046;1
"7732";8258;86;7732;6;29;35;6;0,348837209302326;0,418604651162791
"7733";8258;86;7733;6;52;60;8;0,604651162790698;0,697674418604651
"7734";8258;86;7734;6;68;74;6;0,790697674418605;0,86046511627907
"7735";8258;86;7735;6;68;76;8;0,790697674418605;0,883720930232558
"7736";8258;86;7736;6;21;27;6;0,255813953488372;0,325581395348837
"7737";8258;86;7737;6;52;62;10;0,604651162790698;0,720930232558139
"7738";8258;86;7738;6;72;78;6;0,837209302325581;0,906976744186046
"7739";8258;86;7739;6;62;70;8;0,720930232558139;0,813953488372093
"7740";8258;86;7740;6;70;78;8;0,813953488372093;0,906976744186046
"7741";8258;86;7741;6;35;41;6;0,418604651162791;0,488372093023256
"7742";8258;86;7742;6;25;31;6;0,302325581395349;0,372093023255814
"7743";8258;86;7743;6;11;17;6;0,13953488372093;0,209302325581395
"7744";8258;86;7744;6;13;19;6;0,162790697674419;0,232558139534884
"7745";8258;86;7745;6;72;80;8;0,837209302325581;0,930232558139535
"7746";8258;86;7746;6;72;82;10;0,837209302325581;0,953488372093023
"7747";8258;86;7747;6;60;70;10;0,697674418604651;0,813953488372093
"7748";8391;51;7748;4;35;47;12;0,692307692307692;0,923076923076923
"7749";8391;51;7749;4;39;51;12;0,769230769230769;1
"7750";8391;51;7750;4;35;51;16;0,692307692307692;1
"7751";8391;51;7751;4;3;15;12;0,0769230769230769;0,307692307692308
"7752";8391;51;7752;4;31;43;12;0,615384615384615;0,846153846153846
"7753";8391;51;7753;5;1;7;6;0,0384615384615385;0,153846153846154
"7754";8391;51;7754;5;35;41;6;0,692307692307692;0,807692307692308
"7755";8391;51;7755;5;39;45;6;0,769230769230769;0,884615384615385
"7756";8391;51;7756;5;41;47;6;0,807692307692308;0,923076923076923
"7757";8391;51;7757;5;3;9;6;0,0769230769230769;0,192307692307692
"7758";8391;51;7758;5;3;11;8;0,0769230769230769;0,230769230769231
"7759";8391;51;7759;5;35;43;8;0,692307692307692;0,846153846153846
"7760";8391;51;7760;5;37;43;6;0,730769230769231;0,846153846153846
"7761";8391;51;7761;5;5;11;6;0,115384615384615;0,230769230769231
"7762";8391;51;7762;5;43;49;6;0,846153846153846;0,961538461538462
"7763";8391;51;7763;5;43;51;8;0,846153846153846;1
"7764";8391;51;7764;5;45;51;6;0,884615384615385;1
"7765";8391;51;7765;5;1;9;8;0,0384615384615385;0,192307692307692
"7766";8391;51;7766;5;1;11;10;0,0384615384615385;0,230769230769231
"7767";8391;51;7767;5;23;29;6;0,461538461538462;0,576923076923077
"7768";8391;51;7768;5;33;39;6;0,653846153846154;0,769230769230769
"7769";8391;51;7769;5;37;45;8;0,730769230769231;0,884615384615385
"7770";8391;51;7770;5;37;47;10;0,730769230769231;0,923076923076923
"7771";8391;51;7771;5;39;47;8;0,769230769230769;0,923076923076923
"7772";8391;51;7772;5;39;49;10;0,769230769230769;0,961538461538462
"7773";8391;51;7773;5;39;51;12;0,769230769230769;1
"7774";8391;51;7774;5;41;49;8;0,807692307692308;0,961538461538462
"7775";8391;51;7775;5;35;45;10;0,692307692307692;0,884615384615385
"7776";8391;51;7776;5;35;47;12;0,692307692307692;0,923076923076923
"7777";8391;51;7777;5;37;49;12;0,730769230769231;0,961538461538462
"7778";8391;51;7778;5;37;51;14;0,730769230769231;1
"7779";8391;51;7779;5;41;51;10;0,807692307692308;1
"7780";8391;51;7780;5;11;17;6;0,230769230769231;0,346153846153846
"7781";8391;51;7781;5;7;13;6;0,153846153846154;0,269230769230769
"7782";8391;51;7782;5;21;27;6;0,423076923076923;0,538461538461538
"7783";8391;51;7783;5;13;19;6;0,269230769230769;0,384615384615385
"7784";8391;51;7784;5;31;37;6;0,615384615384615;0,730769230769231
"7785";8391;51;7785;5;33;41;8;0,653846153846154;0,807692307692308
"7786";8391;51;7786;5;33;43;10;0,653846153846154;0,846153846153846
"7787";8391;51;7787;5;35;49;14;0,692307692307692;0,961538461538462
"7788";8391;51;7788;5;35;51;16;0,692307692307692;1
"7789";8576;122;7789;3;17;69;52;0,142857142857143;0,571428571428571
"7790";8576;122;7790;3;69;122;53;0,571428571428571;1
"7791";8576;122;7791;3;52;104;52;0,428571428571429;0,857142857142857
"7792";8576;122;7792;3;34;87;53;0,285714285714286;0,714285714285714
"7793";8576;122;7793;3;52;122;70;0,428571428571429;1
"7794";8576;122;7794;3;34;104;70;0,285714285714286;0,857142857142857
"7795";8576;122;7795;4;48;73;25;0,4;0,6
"7796";8576;122;7796;4;81;106;25;0,666666666666667;0,866666666666667
"7797";8576;122;7797;4;48;81;33;0,4;0,666666666666667
"7798";8576;122;7798;4;89;114;25;0,733333333333333;0,933333333333333
"7799";8576;122;7799;4;40;65;25;0,333333333333333;0,533333333333333
"7800";8576;122;7800;4;56;81;25;0,466666666666667;0,666666666666667
"7801";8576;122;7801;4;73;97;24;0,6;0,8
"7802";8576;122;7802;4;81;114;33;0,666666666666667;0,933333333333333
"7803";8576;122;7803;4;81;122;41;0,666666666666667;1
"7804";8576;122;7804;4;89;122;33;0,733333333333333;1
"7805";8576;122;7805;4;97;122;25;0,8;1
"7806";8576;122;7806;4;32;56;24;0,266666666666667;0,466666666666667
"7807";8576;122;7807;4;56;89;33;0,466666666666667;0,733333333333333
"7808";8576;122;7808;4;65;89;24;0,533333333333333;0,733333333333333
"7809";8576;122;7809;4;65;97;32;0,533333333333333;0,8
"7810";8576;122;7810;4;73;106;33;0,6;0,866666666666667
"7811";8576;122;7811;4;73;114;41;0,6;0,933333333333333
"7812";8576;122;7812;4;73;122;49;0,6;1
"7813";8576;122;7813;4;65;106;41;0,533333333333333;0,866666666666667
"7814";8576;122;7814;4;24;48;24;0,2;0,4
"7815";8576;122;7815;4;40;73;33;0,333333333333333;0,6
"7816";8576;122;7816;4;65;114;49;0,533333333333333;0,933333333333333
"7817";8576;122;7817;4;56;97;41;0,466666666666667;0,8
"7818";8576;122;7818;4;15;40;25;0,133333333333333;0,333333333333333
"7819";8576;122;7819;4;32;65;33;0,266666666666667;0,533333333333333
"7820";8576;122;7820;5;56;69;13;0,466666666666667;0,566666666666667
"7821";8576;122;7821;5;97;110;13;0,8;0,9
"7822";8576;122;7822;5;36;48;12;0,3;0,4
"7823";8576;122;7823;5;48;60;12;0,4;0,5
"7824";8576;122;7824;5;56;73;17;0,466666666666667;0,6
"7825";8576;122;7825;5;56;77;21;0,466666666666667;0,633333333333333
"7826";8576;122;7826;5;60;73;13;0,5;0,6
"7827";8576;122;7827;5;60;77;17;0,5;0,633333333333333
"7828";8576;122;7828;5;69;81;12;0,566666666666667;0,666666666666667
"7829";8576;122;7829;5;89;102;13;0,733333333333333;0,833333333333333
"7830";8576;122;7830;5;89;106;17;0,733333333333333;0,866666666666667
"7831";8576;122;7831;5;93;106;13;0,766666666666667;0,866666666666667
"7832";8576;122;7832;5;93;110;17;0,766666666666667;0,9
"7833";8576;122;7833;5;102;114;12;0,833333333333333;0,933333333333333
"7834";8576;122;7834;5;110;122;12;0,9;1
"7835";8576;122;7835;5;28;40;12;0,233333333333333;0,333333333333333
"7836";8576;122;7836;5;40;52;12;0,333333333333333;0,433333333333333
"7837";8576;122;7837;5;40;56;16;0,333333333333333;0,466666666666667
"7838";8576;122;7838;5;40;60;20;0,333333333333333;0,5
"7839";8576;122;7839;5;44;56;12;0,366666666666667;0,466666666666667
"7840";8576;122;7840;5;52;65;13;0,433333333333333;0,533333333333333
"7841";8576;122;7841;5;60;81;21;0,5;0,666666666666667
"7842";8576;122;7842;5;69;85;16;0,566666666666667;0,7
"7843";8576;122;7843;5;69;89;20;0,566666666666667;0,733333333333333
"7844";8576;122;7844;5;69;93;24;0,566666666666667;0,766666666666667
"7845";8576;122;7845;5;73;85;12;0,6;0,7
"7846";8576;122;7846;5;81;93;12;0,666666666666667;0,766666666666667
"7847";8576;122;7847;5;85;97;12;0,7;0,8
"7848";8576;122;7848;5;89;110;21;0,733333333333333;0,9
"7849";8576;122;7849;5;89;114;25;0,733333333333333;0,933333333333333
"7850";8576;122;7850;5;89;118;29;0,733333333333333;0,966666666666667
"7851";8576;122;7851;5;93;114;21;0,766666666666667;0,933333333333333
"7852";8576;122;7852;5;97;114;17;0,8;0,933333333333333
"7853";8576;122;7853;5;97;118;21;0,8;0,966666666666667
"7854";8576;122;7854;5;102;118;16;0,833333333333333;0,966666666666667
"7855";8576;122;7855;5;106;118;12;0,866666666666667;0,966666666666667
"7856";8576;122;7856;5;28;44;16;0,233333333333333;0,366666666666667
"7857";8576;122;7857;5;32;44;12;0,266666666666667;0,366666666666667
"7858";8576;122;7858;5;36;52;16;0,3;0,433333333333333
"7859";8576;122;7859;5;36;56;20;0,3;0,466666666666667
"7860";8576;122;7860;5;48;65;17;0,4;0,533333333333333
"7861";8576;122;7861;5;60;85;25;0,5;0,7
"7862";8576;122;7862;5;65;77;12;0,533333333333333;0,633333333333333
"7863";8576;122;7863;5;65;81;16;0,533333333333333;0,666666666666667
"7864";8576;122;7864;5;73;89;16;0,6;0,733333333333333
"7865";8576;122;7865;5;77;89;12;0,633333333333333;0,733333333333333
"7866";8576;122;7866;5;77;93;16;0,633333333333333;0,766666666666667
"7867";8576;122;7867;5;77;97;20;0,633333333333333;0,8
"7868";8576;122;7868;5;77;102;25;0,633333333333333;0,833333333333333
"7869";8576;122;7869;5;77;106;29;0,633333333333333;0,866666666666667
"7870";8576;122;7870;5;81;97;16;0,666666666666667;0,8
"7871";8576;122;7871;5;85;102;17;0,7;0,833333333333333
"7872";8576;122;7872;5;85;106;21;0,7;0,866666666666667
"7873";8576;122;7873;5;89;122;33;0,733333333333333;1
"7874";8576;122;7874;5;93;118;25;0,766666666666667;0,966666666666667
"7875";8576;122;7875;5;93;122;29;0,766666666666667;1
"7876";8576;122;7876;5;97;122;25;0,8;1
"7877";8576;122;7877;5;102;122;20;0,833333333333333;1
"7878";8576;122;7878;5;106;122;16;0,866666666666667;1
"7879";8576;122;7879;5;81;102;21;0,666666666666667;0,833333333333333
"7880";8576;122;7880;5;7;20;13;0,0666666666666667;0,166666666666667
"7881";8576;122;7881;5;15;28;13;0,133333333333333;0,233333333333333
"7882";8576;122;7882;5;24;36;12;0,2;0,3
"7883";8576;122;7883;5;44;60;16;0,366666666666667;0,5
"7884";8576;122;7884;5;81;106;25;0,666666666666667;0,866666666666667
"7885";8576;122;7885;5;81;110;29;0,666666666666667;0,9
"7886";8576;122;7886;5;32;48;16;0,266666666666667;0,4
"7887";8576;122;7887;5;65;85;20;0,533333333333333;0,7
"7888";8576;122;7888;5;69;97;28;0,566666666666667;0,8
"7889";8576;122;7889;5;85;110;25;0,7;0,9
"7890";8576;122;7890;5;85;114;29;0,7;0,933333333333333
"7891";8576;122;7891;5;85;118;33;0,7;0,966666666666667
"7892";8576;122;7892;5;85;122;37;0,7;1
"7893";8576;122;7893;5;20;32;12;0,166666666666667;0,266666666666667
"7894";8576;122;7894;5;81;114;33;0,666666666666667;0,933333333333333
"7895";8576;122;7895;5;81;118;37;0,666666666666667;0,966666666666667
"7896";8576;122;7896;5;81;122;41;0,666666666666667;1
"7897";8576;122;7897;5;56;81;25;0,466666666666667;0,666666666666667
"7898";8576;122;7898;5;60;89;29;0,5;0,733333333333333
"7899";8576;122;7899;5;56;85;29;0,466666666666667;0,7
"7900";8576;122;7900;5;52;69;17;0,433333333333333;0,566666666666667
"7901";8576;122;7901;5;52;73;21;0,433333333333333;0,6
"7902";8576;122;7902;5;3;15;12;0,0333333333333333;0,133333333333333
"7903";8576;122;7903;5;24;40;16;0,2;0,333333333333333
"7904";8576;122;7904;6;15;21;6;0,131147540983607;0,180327868852459
"7905";8576;122;7905;6;41;47;6;0,344262295081967;0,39344262295082
"7906";8576;122;7906;6;47;53;6;0,39344262295082;0,442622950819672
"7907";8576;122;7907;6;72;78;6;0,590163934426229;0,639344262295082
"7908";8576;122;7908;6;82;88;6;0,672131147540984;0,721311475409836
"7909";8576;122;7909;6;110;116;6;0,901639344262295;0,950819672131147
"7910";8576;122;7910;6;23;29;6;0,19672131147541;0,245901639344262
"7911";8576;122;7911;6;25;31;6;0,213114754098361;0,262295081967213
"7912";8576;122;7912;6;25;33;8;0,213114754098361;0,278688524590164
"7913";8576;122;7913;6;25;35;10;0,213114754098361;0,295081967213115
"7914";8576;122;7914;6;27;33;6;0,229508196721311;0,278688524590164
"7915";8576;122;7915;6;27;35;8;0,229508196721311;0,295081967213115
"7916";8576;122;7916;6;29;35;6;0,245901639344262;0,295081967213115
"7917";8576;122;7917;6;37;43;6;0,311475409836066;0,360655737704918
"7918";8576;122;7918;6;45;51;6;0,377049180327869;0,426229508196721
"7919";8576;122;7919;6;45;53;8;0,377049180327869;0,442622950819672
"7920";8576;122;7920;6;45;55;10;0,377049180327869;0,459016393442623
"7921";8576;122;7921;6;47;55;8;0,39344262295082;0,459016393442623
"7922";8576;122;7922;6;49;55;6;0,409836065573771;0,459016393442623
"7923";8576;122;7923;6;55;62;7;0,459016393442623;0,508196721311475
"7924";8576;122;7924;6;68;74;6;0,557377049180328;0,60655737704918
"7925";8576;122;7925;6;68;76;8;0,557377049180328;0,622950819672131
"7926";8576;122;7926;6;70;76;6;0,573770491803279;0,622950819672131
"7927";8576;122;7927;6;70;78;8;0,573770491803279;0,639344262295082
"7928";8576;122;7928;6;72;80;8;0,590163934426229;0,655737704918033
"7929";8576;122;7929;6;74;80;6;0,60655737704918;0,655737704918033
"7930";8576;122;7930;6;82;90;8;0,672131147540984;0,737704918032787
"7931";8576;122;7931;6;84;90;6;0,688524590163934;0,737704918032787
"7932";8576;122;7932;6;88;94;6;0,721311475409836;0,770491803278688
"7933";8576;122;7933;6;88;96;8;0,721311475409836;0,786885245901639
"7934";8576;122;7934;6;88;98;10;0,721311475409836;0,80327868852459
"7935";8576;122;7935;6;88;100;12;0,721311475409836;0,819672131147541
"7936";8576;122;7936;6;90;96;6;0,737704918032787;0,786885245901639
"7937";8576;122;7937;6;92;98;6;0,754098360655738;0,80327868852459
"7938";8576;122;7938;6;92;100;8;0,754098360655738;0,819672131147541
"7939";8576;122;7939;6;98;104;6;0,80327868852459;0,852459016393443
"7940";8576;122;7940;6;100;106;6;0,819672131147541;0,868852459016393
"7941";8576;122;7941;6;104;110;6;0,852459016393443;0,901639344262295
"7942";8576;122;7942;6;104;112;8;0,852459016393443;0,918032786885246
"7943";8576;122;7943;6;106;112;6;0,868852459016393;0,918032786885246
"7944";8576;122;7944;6;112;118;6;0,918032786885246;0,967213114754098
"7945";8576;122;7945;6;116;122;6;0,950819672131147;1
"7946";8576;122;7946;6;11;17;6;0,0983606557377049;0,147540983606557
"7947";8576;122;7947;6;13;19;6;0,114754098360656;0,163934426229508
"7948";8576;122;7948;6;17;23;6;0,147540983606557;0,19672131147541
"7949";8576;122;7949;6;37;45;8;0,311475409836066;0,377049180327869
"7950";8576;122;7950;6;39;45;6;0,327868852459016;0,377049180327869
"7951";8576;122;7951;6;39;47;8;0,327868852459016;0,39344262295082
"7952";8576;122;7952;6;41;49;8;0,344262295081967;0,409836065573771
"7953";8576;122;7953;6;43;49;6;0,360655737704918;0,409836065573771
"7954";8576;122;7954;6;43;51;8;0,360655737704918;0,426229508196721
"7955";8576;122;7955;6;55;64;9;0,459016393442623;0,524590163934426
"7956";8576;122;7956;6;55;66;11;0,459016393442623;0,540983606557377
"7957";8576;122;7957;6;57;64;7;0,475409836065574;0,524590163934426
"7958";8576;122;7958;6;57;66;9;0,475409836065574;0,540983606557377
"7959";8576;122;7959;6;59;66;7;0,491803278688525;0,540983606557377
"7960";8576;122;7960;6;68;78;10;0,557377049180328;0,639344262295082
"7961";8576;122;7961;6;68;80;12;0,557377049180328;0,655737704918033
"7962";8576;122;7962;6;68;82;14;0,557377049180328;0,672131147540984
"7963";8576;122;7963;6;70;80;10;0,573770491803279;0,655737704918033
"7964";8576;122;7964;6;70;82;12;0,573770491803279;0,672131147540984
"7965";8576;122;7965;6;70;84;14;0,573770491803279;0,688524590163934
"7966";8576;122;7966;6;72;82;10;0,590163934426229;0,672131147540984
"7967";8576;122;7967;6;72;84;12;0,590163934426229;0,688524590163934
"7968";8576;122;7968;6;74;82;8;0,60655737704918;0,672131147540984
"7969";8576;122;7969;6;74;84;10;0,60655737704918;0,688524590163934
"7970";8576;122;7970;6;80;86;6;0,655737704918033;0,704918032786885
"7971";8576;122;7971;6;80;88;8;0,655737704918033;0,721311475409836
"7972";8576;122;7972;6;80;90;10;0,655737704918033;0,737704918032787
"7973";8576;122;7973;6;82;92;10;0,672131147540984;0,754098360655738
"7974";8576;122;7974;6;82;94;12;0,672131147540984;0,770491803278688
"7975";8576;122;7975;6;84;92;8;0,688524590163934;0,754098360655738
"7976";8576;122;7976;6;84;94;10;0,688524590163934;0,770491803278688
"7977";8576;122;7977;6;86;92;6;0,704918032786885;0,754098360655738
"7978";8576;122;7978;6;86;94;8;0,704918032786885;0,770491803278688
"7979";8576;122;7979;6;86;96;10;0,704918032786885;0,786885245901639
"7980";8576;122;7980;6;86;98;12;0,704918032786885;0,80327868852459
"7981";8576;122;7981;6;86;100;14;0,704918032786885;0,819672131147541
"7982";8576;122;7982;6;86;102;16;0,704918032786885;0,836065573770492
"7983";8576;122;7983;6;86;104;18;0,704918032786885;0,852459016393443
"7984";8576;122;7984;6;86;106;20;0,704918032786885;0,868852459016393
"7985";8576;122;7985;6;90;98;8;0,737704918032787;0,80327868852459
"7986";8576;122;7986;6;90;100;10;0,737704918032787;0,819672131147541
"7987";8576;122;7987;6;90;102;12;0,737704918032787;0,836065573770492
"7988";8576;122;7988;6;90;104;14;0,737704918032787;0,852459016393443
"7989";8576;122;7989;6;90;106;16;0,737704918032787;0,868852459016393
"7990";8576;122;7990;6;92;102;10;0,754098360655738;0,836065573770492
"7991";8576;122;7991;6;92;104;12;0,754098360655738;0,852459016393443
"7992";8576;122;7992;6;92;106;14;0,754098360655738;0,868852459016393
"7993";8576;122;7993;6;92;108;16;0,754098360655738;0,885245901639344
"7994";8576;122;7994;6;98;106;8;0,80327868852459;0,868852459016393
"7995";8576;122;7995;6;98;108;10;0,80327868852459;0,885245901639344
"7996";8576;122;7996;6;98;110;12;0,80327868852459;0,901639344262295
"7997";8576;122;7997;6;98;112;14;0,80327868852459;0,918032786885246
"7998";8576;122;7998;6;100;108;8;0,819672131147541;0,885245901639344
"7999";8576;122;7999;6;100;110;10;0,819672131147541;0,901639344262295
"8000";8576;122;8000;6;100;112;12;0,819672131147541;0,918032786885246
"8001";8576;122;8001;6;102;108;6;0,836065573770492;0,885245901639344
"8002";8576;122;8002;6;102;110;8;0,836065573770492;0,901639344262295
"8003";8576;122;8003;6;104;114;10;0,852459016393443;0,934426229508197
"8004";8576;122;8004;6;104;116;12;0,852459016393443;0,950819672131147
"8005";8576;122;8005;6;106;114;8;0,868852459016393;0,934426229508197
"8006";8576;122;8006;6;106;116;10;0,868852459016393;0,950819672131147
"8007";8576;122;8007;6;106;118;12;0,868852459016393;0,967213114754098
"8008";8576;122;8008;6;108;114;6;0,885245901639344;0,934426229508197
"8009";8576;122;8009;6;108;116;8;0,885245901639344;0,950819672131147
"8010";8576;122;8010;6;108;118;10;0,885245901639344;0,967213114754098
"8011";8576;122;8011;6;108;120;12;0,885245901639344;0,983606557377049
"8012";8576;122;8012;6;110;118;8;0,901639344262295;0,967213114754098
"8013";8576;122;8013;6;110;120;10;0,901639344262295;0,983606557377049
"8014";8576;122;8014;6;110;122;12;0,901639344262295;1
"8015";8576;122;8015;6;112;120;8;0,918032786885246;0,983606557377049
"8016";8576;122;8016;6;112;122;10;0,918032786885246;1
"8017";8576;122;8017;6;114;120;6;0,934426229508197;0,983606557377049
"8018";8576;122;8018;6;114;122;8;0,934426229508197;1
"8019";8576;122;8019;6;31;37;6;0,262295081967213;0,311475409836066
"8020";8576;122;8020;6;31;39;8;0,262295081967213;0,327868852459016
"8021";8576;122;8021;6;33;39;6;0,278688524590164;0,327868852459016
"8022";8576;122;8022;6;35;41;6;0,295081967213115;0,344262295081967
"8023";8576;122;8023;6;39;49;10;0,327868852459016;0,409836065573771
"8024";8576;122;8024;6;62;68;6;0,508196721311475;0,557377049180328
"8025";8576;122;8025;6;62;70;8;0,508196721311475;0,573770491803279
"8026";8576;122;8026;6;62;72;10;0,508196721311475;0,590163934426229
"8027";8576;122;8027;6;62;74;12;0,508196721311475;0,60655737704918
"8028";8576;122;8028;6;62;76;14;0,508196721311475;0,622950819672131
"8029";8576;122;8029;6;64;70;6;0,524590163934426;0,573770491803279
"8030";8576;122;8030;6;64;72;8;0,524590163934426;0,590163934426229
"8031";8576;122;8031;6;68;84;16;0,557377049180328;0,688524590163934
"8032";8576;122;8032;6;68;86;18;0,557377049180328;0,704918032786885
"8033";8576;122;8033;6;70;86;16;0,573770491803279;0,704918032786885
"8034";8576;122;8034;6;70;88;18;0,573770491803279;0,721311475409836
"8035";8576;122;8035;6;70;90;20;0,573770491803279;0,737704918032787
"8036";8576;122;8036;6;72;86;14;0,590163934426229;0,704918032786885
"8037";8576;122;8037;6;72;88;16;0,590163934426229;0,721311475409836
"8038";8576;122;8038;6;72;90;18;0,590163934426229;0,737704918032787
"8039";8576;122;8039;6;74;86;12;0,60655737704918;0,704918032786885
"8040";8576;122;8040;6;74;88;14;0,60655737704918;0,721311475409836
"8041";8576;122;8041;6;74;90;16;0,60655737704918;0,737704918032787
"8042";8576;122;8042;6;80;92;12;0,655737704918033;0,754098360655738
"8043";8576;122;8043;6;90;108;18;0,737704918032787;0,885245901639344
"8044";8576;122;8044;6;90;110;20;0,737704918032787;0,901639344262295
"8045";8576;122;8045;6;90;112;22;0,737704918032787;0,918032786885246
"8046";8576;122;8046;6;90;114;24;0,737704918032787;0,934426229508197
"8047";8576;122;8047;6;90;116;26;0,737704918032787;0,950819672131147
"8048";8576;122;8048;6;90;118;28;0,737704918032787;0,967213114754098
"8049";8576;122;8049;6;90;120;30;0,737704918032787;0,983606557377049
"8050";8576;122;8050;6;98;114;16;0,80327868852459;0,934426229508197
"8051";8576;122;8051;6;98;116;18;0,80327868852459;0,950819672131147
"8052";8576;122;8052;6;98;118;20;0,80327868852459;0,967213114754098
"8053";8576;122;8053;6;98;120;22;0,80327868852459;0,983606557377049
"8054";8576;122;8054;6;100;114;14;0,819672131147541;0,934426229508197
"8055";8576;122;8055;6;100;116;16;0,819672131147541;0,950819672131147
"8056";8576;122;8056;6;100;118;18;0,819672131147541;0,967213114754098
"8057";8576;122;8057;6;104;118;14;0,852459016393443;0,967213114754098
"8058";8576;122;8058;6;104;120;16;0,852459016393443;0,983606557377049
"8059";8576;122;8059;6;106;120;14;0,868852459016393;0,983606557377049
"8060";8576;122;8060;6;23;31;8;0,19672131147541;0,262295081967213
"8061";8576;122;8061;6;29;37;8;0,245901639344262;0,311475409836066
"8062";8576;122;8062;6;47;57;10;0,39344262295082;0,475409836065574
"8063";8576;122;8063;6;21;27;6;0,180327868852459;0,229508196721311
"8064";8576;122;8064;6;41;51;10;0,344262295081967;0,426229508196721
"8065";8576;122;8065;6;49;57;8;0,409836065573771;0,475409836065574
"8066";8576;122;8066;6;59;68;9;0,491803278688525;0,557377049180328
"8067";8576;122;8067;6;9;15;6;0,0819672131147541;0,131147540983607
"8068";8576;122;8068;6;21;29;8;0,180327868852459;0,245901639344262
"8069";8576;122;8069;6;35;43;8;0,295081967213115;0,360655737704918
"8070";8576;122;8070;6;35;45;10;0,295081967213115;0,377049180327869
"8071";8576;122;8071;6;66;72;6;0,540983606557377;0,590163934426229
"8072";8576;122;8072;6;37;47;10;0,311475409836066;0,39344262295082
"8073";8576;122;8073;6;37;49;12;0,311475409836066;0,409836065573771
"8074";8576;122;8074;6;51;57;6;0,426229508196721;0,475409836065574
"8075";8576;122;8075;6;82;96;14;0,672131147540984;0,786885245901639
"8076";8576;122;8076;6;84;96;12;0,688524590163934;0,786885245901639
"8077";8576;122;8077;6;84;98;14;0,688524590163934;0,80327868852459
"8078";8576;122;8078;6;84;100;16;0,688524590163934;0,819672131147541
"8079";8576;122;8079;6;88;102;14;0,721311475409836;0,836065573770492
"8080";8576;122;8080;6;88;104;16;0,721311475409836;0,852459016393443
"8081";8576;122;8081;6;92;110;18;0,754098360655738;0,901639344262295
"8082";8576;122;8082;6;92;112;20;0,754098360655738;0,918032786885246
"8083";8576;122;8083;6;102;112;10;0,836065573770492;0,918032786885246
"8084";8576;122;8084;6;102;114;12;0,836065573770492;0,934426229508197
"8085";8576;122;8085;6;102;116;14;0,836065573770492;0,950819672131147
"8086";8576;122;8086;6;102;118;16;0,836065573770492;0,967213114754098
"8087";8576;122;8087;6;102;120;18;0,836065573770492;0,983606557377049
"8088";8576;122;8088;6;108;122;14;0,885245901639344;1
"8089";8576;122;8089;6;41;53;12;0,344262295081967;0,442622950819672
"8090";8576;122;8090;6;43;53;10;0,360655737704918;0,442622950819672
"8091";8576;122;8091;6;43;55;12;0,360655737704918;0,459016393442623
"8092";8576;122;8092;6;82;98;16;0,672131147540984;0,80327868852459
"8093";8576;122;8093;6;82;100;18;0,672131147540984;0,819672131147541
"8094";8576;122;8094;6;82;102;20;0,672131147540984;0,836065573770492
"8095";8576;122;8095;6;53;59;6;0,442622950819672;0,491803278688525
"8096";8576;122;8096;6;53;62;9;0,442622950819672;0,508196721311475
"8097";8576;122;8097;6;66;74;8;0,540983606557377;0,60655737704918
"8098";8576;122;8098;6;66;76;10;0,540983606557377;0,622950819672131
"8099";8576;122;8099;6;104;122;18;0,852459016393443;1
"8100";8576;122;8100;6;106;122;16;0,868852459016393;1
"8101";8576;122;8101;6;33;41;8;0,278688524590164;0,344262295081967
"8102";8576;122;8102;6;7;13;6;0,0655737704918033;0,114754098360656
"8103";8576;122;8103;6;66;78;12;0,540983606557377;0,639344262295082
"8104";8576;122;8104;6;66;80;14;0,540983606557377;0,655737704918033
"8105";8576;122;8105;6;27;37;10;0,229508196721311;0,311475409836066
"8106";8576;122;8106;6;84;102;18;0,688524590163934;0,836065573770492
"8107";8576;122;8107;6;84;104;20;0,688524590163934;0,852459016393443
"8108";8576;122;8108;6;84;106;22;0,688524590163934;0,868852459016393
"8109";8576;122;8109;6;84;108;24;0,688524590163934;0,885245901639344
"8110";8576;122;8110;6;92;114;22;0,754098360655738;0,934426229508197
"8111";8576;122;8111;6;92;116;24;0,754098360655738;0,950819672131147
"8112";8576;122;8112;6;98;122;24;0,80327868852459;1
"8113";8576;122;8113;6;100;120;20;0,819672131147541;0,983606557377049
"8114";8576;122;8114;6;100;122;22;0,819672131147541;1
"8115";8576;122;8115;6;92;118;26;0,754098360655738;0,967213114754098
"8116";8576;122;8116;6;92;120;28;0,754098360655738;0,983606557377049
"8117";8576;122;8117;6;92;122;30;0,754098360655738;1
"8118";8576;122;8118;6;19;25;6;0,163934426229508;0,213114754098361
"8119";8576;122;8119;6;84;110;26;0,688524590163934;0,901639344262295
"8120";8576;122;8120;6;84;112;28;0,688524590163934;0,918032786885246
"8121";8576;122;8121;6;90;122;32;0,737704918032787;1
"8122";8576;122;8122;6;35;47;12;0,295081967213115;0,39344262295082
"8123";8576;122;8123;6;68;88;20;0,557377049180328;0,721311475409836
"8124";8576;122;8124;6;68;90;22;0,557377049180328;0,737704918032787
"8125";8576;122;8125;6;74;92;18;0,60655737704918;0,754098360655738
"8126";8576;122;8126;6;102;122;20;0,836065573770492;1
"8127";8576;122;8127;6;51;59;8;0,426229508196721;0,491803278688525
"8128";8615;56;8128;3;32;56;24;0,571428571428571;1
"8129";8615;56;8129;4;40;52;12;0,714285714285714;0,928571428571429
"8130";8615;56;8130;4;36;48;12;0,642857142857143;0,857142857142857
"8131";8615;56;8131;4;40;56;16;0,714285714285714;1
"8132";8615;56;8132;4;36;52;16;0,642857142857143;0,928571428571429
"8133";8615;56;8133;4;15;28;13;0,285714285714286;0,5
"8134";8615;56;8134;4;32;44;12;0,571428571428571;0,785714285714286
"8135";8615;56;8135;4;44;56;12;0,785714285714286;1
"8136";8615;56;8136;4;7;19;12;0,142857142857143;0,357142857142857
"8137";8615;56;8137;4;11;23;12;0,214285714285714;0,428571428571429
"8138";8615;56;8138;5;38;44;6;0,678571428571429;0,785714285714286
"8139";8615;56;8139;5;42;48;6;0,75;0,857142857142857
"8140";8615;56;8140;5;48;54;6;0,857142857142857;0,964285714285714
"8141";8615;56;8141;5;21;28;7;0,392857142857143;0,5
"8142";8615;56;8142;5;34;40;6;0,607142857142857;0,714285714285714
"8143";8615;56;8143;5;34;42;8;0,607142857142857;0,75
"8144";8615;56;8144;5;34;44;10;0,607142857142857;0,785714285714286
"8145";8615;56;8145;5;34;46;12;0,607142857142857;0,821428571428571
"8146";8615;56;8146;5;36;42;6;0,642857142857143;0,75
"8147";8615;56;8147;5;40;46;6;0,714285714285714;0,821428571428571
"8148";8615;56;8148;5;40;48;8;0,714285714285714;0,857142857142857
"8149";8615;56;8149;5;17;23;6;0,321428571428571;0,428571428571429
"8150";8615;56;8150;5;17;25;8;0,321428571428571;0,464285714285714
"8151";8615;56;8151;5;19;25;6;0,357142857142857;0,464285714285714
"8152";8615;56;8152;5;15;21;6;0,285714285714286;0,392857142857143
"8153";8615;56;8153;5;19;28;9;0,357142857142857;0,5
"8154";8615;56;8154;5;38;46;8;0,678571428571429;0,821428571428571
"8155";8615;56;8155;5;42;50;8;0,75;0,892857142857143
"8156";8615;56;8156;5;42;52;10;0,75;0,928571428571429
"8157";8615;56;8157;5;44;50;6;0,785714285714286;0,892857142857143
"8158";8615;56;8158;5;46;52;6;0,821428571428571;0,928571428571429
"8159";8615;56;8159;5;46;54;8;0,821428571428571;0,964285714285714
"8160";8615;56;8160;5;46;56;10;0,821428571428571;1
"8161";8615;56;8161;5;13;19;6;0,25;0,357142857142857
"8162";8615;56;8162;5;11;17;6;0,214285714285714;0,321428571428571
"8163";8615;56;8163;5;9;15;6;0,178571428571429;0,285714285714286
"8164";8615;56;8164;5;38;48;10;0,678571428571429;0,857142857142857
"8165";8615;56;8165;5;32;38;6;0,571428571428571;0,678571428571429
"8166";8615;56;8166;5;50;56;6;0,892857142857143;1
"8167";8615;56;8167;5;30;36;6;0,535714285714286;0,642857142857143
"8168";8615;56;8168;5;30;38;8;0,535714285714286;0,678571428571429
"8169";8615;56;8169;5;32;40;8;0,571428571428571;0,714285714285714
"8170";8615;56;8170;5;36;44;8;0,642857142857143;0,785714285714286
"8171";8615;56;8171;5;44;52;8;0,785714285714286;0,928571428571429
"8172";8615;56;8172;5;40;50;10;0,714285714285714;0,892857142857143
"8173";8615;56;8173;5;40;52;12;0,714285714285714;0,928571428571429
"8174";8615;56;8174;5;40;54;14;0,714285714285714;0,964285714285714
"8175";8615;56;8175;5;48;56;8;0,857142857142857;1
"8176";8615;56;8176;5;38;50;12;0,678571428571429;0,892857142857143
"8177";8615;56;8177;5;11;19;8;0,214285714285714;0,357142857142857
"8178";8615;56;8178;5;7;13;6;0,142857142857143;0,25
"8179";8615;56;8179;5;42;54;12;0,75;0,964285714285714
"8180";8615;56;8180;5;44;54;10;0,785714285714286;0,964285714285714
"8181";8615;56;8181;5;38;52;14;0,678571428571429;0,928571428571429
"8182";8630;232;8182;4;82;132;50;0,357142857142857;0,571428571428571
"8183";8630;232;8183;4;49;99;50;0,214285714285714;0,428571428571429
"8184";8630;232;8184;4;182;232;50;0,785714285714286;1
"8185";8630;232;8185;4;165;215;50;0,714285714285714;0,928571428571429
"8186";8630;232;8186;5;55;79;24;0,241379310344828;0,344827586206897
"8187";8630;232;8187;5;103;128;25;0,448275862068966;0,551724137931034
"8188";8630;232;8188;5;111;136;25;0,482758620689655;0,586206896551724
"8189";8630;232;8189;5;192;216;24;0,827586206896552;0,931034482758621
"8190";8630;232;8190;5;168;192;24;0,724137931034483;0,827586206896552
"8191";8630;232;8191;5;71;95;24;0,310344827586207;0,413793103448276
"8192";8630;232;8192;5;31;55;24;0,137931034482759;0,241379310344828
"8193";8630;232;8193;5;200;224;24;0,862068965517241;0,96551724137931
"8194";8630;232;8194;5;200;232;32;0,862068965517241;1
"8195";8630;232;8195;5;87;111;24;0,379310344827586;0,482758620689655
"8196";8630;232;8196;5;176;200;24;0,758620689655172;0,862068965517241
"8197";8630;232;8197;5;184;208;24;0,793103448275862;0,896551724137931
"8198";8630;232;8198;5;192;224;32;0,827586206896552;0,96551724137931
"8199";8630;232;8199;5;79;103;24;0,344827586206897;0,448275862068966
"8200";8630;232;8200;5;208;232;24;0,896551724137931;1
"8201";8630;232;8201;5;95;120;25;0,413793103448276;0,517241379310345
"8202";8630;232;8202;5;144;168;24;0,620689655172414;0,724137931034483
"8203";8630;232;8203;5;39;63;24;0,172413793103448;0,275862068965517
"8204";8630;232;8204;5;47;71;24;0,206896551724138;0,310344827586207
"8205";8630;232;8205;6;55;67;12;0,241379310344828;0,293103448275862
"8206";8630;232;8206;6;59;71;12;0,258620689655172;0,310344827586207
"8207";8630;232;8207;6;79;91;12;0,344827586206897;0,396551724137931
"8208";8630;232;8208;6;87;99;12;0,379310344827586;0,431034482758621
"8209";8630;232;8209;6;192;204;12;0,827586206896552;0,879310344827586
"8210";8630;232;8210;6;99;111;12;0,431034482758621;0,482758620689655
"8211";8630;232;8211;6;111;124;13;0,482758620689655;0,53448275862069
"8212";8630;232;8212;6;116;128;12;0,5;0,551724137931034
"8213";8630;232;8213;6;140;152;12;0,603448275862069;0,655172413793103
"8214";8630;232;8214;6;172;184;12;0,741379310344828;0,793103448275862
"8215";8630;232;8215;6;196;208;12;0,844827586206897;0,896551724137931
"8216";8630;232;8216;6;91;103;12;0,396551724137931;0,448275862068966
"8217";8630;232;8217;6;216;228;12;0,931034482758621;0,982758620689655
"8218";8630;232;8218;6;19;31;12;0,0862068965517241;0,137931034482759
"8219";8630;232;8219;6;51;63;12;0,224137931034483;0,275862068965517
"8220";8630;232;8220;6;144;156;12;0,620689655172414;0,672413793103448
"8221";8630;232;8221;6;176;188;12;0,758620689655172;0,810344827586207
"8222";8630;232;8222;6;200;212;12;0,862068965517241;0,913793103448276
"8223";8630;232;8223;6;220;232;12;0,948275862068966;1
"8224";8630;232;8224;6;47;59;12;0,206896551724138;0,258620689655172
"8225";8630;232;8225;6;83;95;12;0,362068965517241;0,413793103448276
"8226";8630;232;8226;6;95;107;12;0,413793103448276;0,46551724137931
"8227";8630;232;8227;6;172;188;16;0,741379310344828;0,810344827586207
"8228";8630;232;8228;6;196;212;16;0,844827586206897;0,913793103448276
"8229";8630;232;8229;6;196;216;20;0,844827586206897;0,931034482758621
"8230";8630;232;8230;6;200;216;16;0,862068965517241;0,931034482758621
"8231";8630;232;8231;6;200;220;20;0,862068965517241;0,948275862068966
"8232";8630;232;8232;6;204;216;12;0,879310344827586;0,931034482758621
"8233";8630;232;8233;6;120;132;12;0,517241379310345;0,568965517241379
"8234";8630;232;8234;6;212;224;12;0,913793103448276;0,96551724137931
"8235";8630;232;8235;6;212;228;16;0,913793103448276;0,982758620689655
"8236";8630;232;8236;6;216;232;16;0,931034482758621;1
"8237";8630;232;8237;6;35;47;12;0,155172413793103;0,206896551724138
"8238";8630;232;8238;6;192;208;16;0,827586206896552;0,896551724137931
"8239";8630;232;8239;6;192;212;20;0,827586206896552;0,913793103448276
"8240";8630;232;8240;6;204;220;16;0,879310344827586;0,948275862068966
"8241";8630;232;8241;6;63;75;12;0,275862068965517;0,327586206896552
"8242";8630;232;8242;6;116;132;16;0,5;0,568965517241379
"8243";8630;232;8243;6;23;35;12;0,103448275862069;0,155172413793103
"8244";8630;232;8244;6;180;192;12;0,775862068965517;0,827586206896552
"8245";8630;232;8245;6;208;220;12;0,896551724137931;0,948275862068966
"8246";8630;232;8246;6;75;87;12;0,327586206896552;0,379310344827586
"8247";8630;232;8247;6;188;200;12;0,810344827586207;0,862068965517241
"8248";8630;232;8248;6;168;180;12;0,724137931034483;0,775862068965517
"8249";8630;232;8249;6;176;192;16;0,758620689655172;0,827586206896552
"8250";8630;232;8250;6;87;103;16;0,379310344827586;0,448275862068966
"8251";8630;232;8251;6;103;116;13;0,448275862068966;0,5
"8252";8630;232;8252;6;188;204;16;0,810344827586207;0,879310344827586
"8253";8630;232;8253;6;148;160;12;0,637931034482759;0,689655172413793
"8254";8630;232;8254;6;192;216;24;0,827586206896552;0,931034482758621
"8255";8630;232;8255;6;152;164;12;0,655172413793103;0,706896551724138
"8256";8630;232;8256;6;188;208;20;0,810344827586207;0,896551724137931
"8257";8630;232;8257;6;91;107;16;0,396551724137931;0,46551724137931
"8258";8630;232;8258;6;91;111;20;0,396551724137931;0,482758620689655
"8259";8630;232;8259;6;196;220;24;0,844827586206897;0,948275862068966
"8260";8630;232;8260;6;188;212;24;0,810344827586207;0,913793103448276
"8261";8630;232;8261;6;83;99;16;0,362068965517241;0,431034482758621
"8262";8687;61;8262;3;34;61;27;0,571428571428571;1
"8263";8687;61;8263;4;40;53;13;0,666666666666667;0,866666666666667
"8264";8687;61;8264;4;28;40;12;0,466666666666667;0,666666666666667
"8265";8687;61;8265;4;36;49;13;0,6;0,8
"8266";8687;61;8266;4;44;57;13;0,733333333333333;0,933333333333333
"8267";8687;61;8267;5;31;37;6;0,516129032258065;0,612903225806452
"8268";8687;61;8268;5;45;51;6;0,741935483870968;0,838709677419355
"8269";8687;61;8269;5;3;9;6;0,0645161290322581;0,161290322580645
"8270";8687;61;8270;5;55;61;6;0,903225806451613;1
"8271";8687;61;8271;5;41;47;6;0,67741935483871;0,774193548387097
"8272";8687;61;8272;5;47;53;6;0,774193548387097;0,870967741935484
"8273";8687;61;8273;5;7;13;6;0,129032258064516;0,225806451612903
"8274";8687;61;8274;5;29;35;6;0,483870967741935;0,580645161290323
"8275";8687;61;8275;5;5;11;6;0,0967741935483871;0,193548387096774
"8276";8687;61;8276;5;5;13;8;0,0967741935483871;0,225806451612903
"8277";8687;61;8277;5;33;39;6;0,548387096774194;0,645161290322581
"8278";8687;61;8278;5;43;49;6;0,709677419354839;0,806451612903226
"8279";8687;61;8279;5;43;51;8;0,709677419354839;0,838709677419355
"8280";8687;61;8280;5;53;59;6;0,870967741935484;0,967741935483871
"8281";8687;61;8281;5;39;45;6;0,645161290322581;0,741935483870968
"8282";8687;61;8282;5;41;49;8;0,67741935483871;0,806451612903226
"8283";8687;61;8283;5;25;31;6;0,419354838709677;0,516129032258065
"8284";8687;61;8284;5;45;53;8;0,741935483870968;0,870967741935484
"8285";8687;61;8285;5;35;41;6;0,580645161290323;0,67741935483871
"8286";342092;35;8286;4;15;27;12;0,444444444444444;0,777777777777778
"8287";342092;35;8287;4;23;35;12;0,666666666666667;1
"8288";342092;35;8288;4;19;31;12;0,555555555555556;0,888888888888889
"8289";342092;35;8289;5;25;31;6;0,722222222222222;0,888888888888889
"8290";342092;35;8290;5;21;27;6;0,611111111111111;0,777777777777778
"8291";342092;35;8291;5;21;29;8;0,611111111111111;0,833333333333333
"8292";342092;35;8292;5;23;29;6;0,666666666666667;0,833333333333333
"8293";342092;35;8293;5;19;25;6;0,555555555555556;0,722222222222222
"8294";342092;35;8294;5;5;11;6;0,166666666666667;0,333333333333333
"8295";342092;35;8295;5;29;35;6;0,833333333333333;1
"8296";342092;35;8296;5;11;17;6;0,333333333333333;0,5
"8297";342092;35;8297;5;27;33;6;0,777777777777778;0,944444444444444
"8298";8713;117;8298;3;66;117;51;0,571428571428571;1
"8299";8713;117;8299;3;50;100;50;0,428571428571429;0,857142857142857
"8300";8713;117;8300;4;66;92;26;0,571428571428571;0,785714285714286
"8301";8713;117;8301;4;92;117;25;0,785714285714286;1
"8302";8713;117;8302;4;41;66;25;0,357142857142857;0,571428571428571
"8303";8713;117;8303;4;66;100;34;0,571428571428571;0,857142857142857
"8304";8713;117;8304;4;50;75;25;0,428571428571429;0,642857142857143
"8305";8713;117;8305;4;75;100;25;0,642857142857143;0,857142857142857
"8306";8713;117;8306;4;83;109;26;0,714285714285714;0,928571428571429
"8307";8713;117;8307;4;58;83;25;0,5;0,714285714285714
"8308";8713;117;8308;4;58;92;34;0,5;0,785714285714286
"8309";8713;117;8309;4;83;117;34;0,714285714285714;1
"8310";8713;117;8310;5;56;68;12;0,482758620689655;0,586206896551724
"8311";8713;117;8311;5;60;72;12;0,517241379310345;0,620689655172414
"8312";8713;117;8312;5;68;80;12;0,586206896551724;0,689655172413793
"8313";8713;117;8313;5;72;84;12;0,620689655172414;0,724137931034483
"8314";8713;117;8314;5;19;32;13;0,172413793103448;0,275862068965517
"8315";8713;117;8315;5;64;76;12;0,551724137931034;0,655172413793103
"8316";8713;117;8316;5;76;89;13;0,655172413793103;0,758620689655172
"8317";8713;117;8317;5;101;113;12;0,862068965517241;0,96551724137931
"8318";8713;117;8318;5;101;117;16;0,862068965517241;1
"8319";8713;117;8319;5;105;117;12;0,896551724137931;1
"8320";8713;117;8320;5;68;84;16;0,586206896551724;0,724137931034483
"8321";8713;117;8321;5;89;101;12;0,758620689655172;0,862068965517241
"8322";8713;117;8322;5;44;56;12;0,379310344827586;0,482758620689655
"8323";8713;117;8323;5;48;60;12;0,413793103448276;0,517241379310345
"8324";8713;117;8324;5;64;80;16;0,551724137931034;0,689655172413793
"8325";8713;117;8325;5;72;89;17;0,620689655172414;0,758620689655172
"8326";8713;117;8326;5;84;97;13;0,724137931034483;0,827586206896552
"8327";8713;117;8327;5;15;27;12;0,137931034482759;0,241379310344828
"8328";8713;117;8328;5;23;36;13;0,206896551724138;0,310344827586207
"8329";8713;117;8329;5;40;52;12;0,344827586206897;0,448275862068966
"8330";8713;117;8330;5;52;64;12;0,448275862068966;0,551724137931034
"8331";8713;117;8331;6;105;111;6;0,898305084745763;0,949152542372881
"8332";8713;117;8332;6;19;25;6;0,169491525423729;0,220338983050847
"8333";8713;117;8333;6;55;61;6;0,474576271186441;0,525423728813559
"8334";8713;117;8334;6;103;109;6;0,88135593220339;0,932203389830508
"8335";8713;117;8335;6;21;27;6;0,186440677966102;0,23728813559322
"8336";8713;117;8336;6;21;29;8;0,186440677966102;0,254237288135593
"8337";8713;117;8337;6;43;49;6;0,372881355932203;0,423728813559322
"8338";8713;117;8338;6;61;67;6;0,525423728813559;0,576271186440678
"8339";8713;117;8339;6;61;69;8;0,525423728813559;0,593220338983051
"8340";8713;117;8340;6;63;69;6;0,542372881355932;0,593220338983051
"8341";8713;117;8341;6;69;75;6;0,593220338983051;0,644067796610169
"8342";8713;117;8342;6;87;93;6;0,745762711864407;0,796610169491525
"8343";8713;117;8343;6;101;107;6;0,864406779661017;0,915254237288136
"8344";8713;117;8344;6;101;109;8;0,864406779661017;0,932203389830508
"8345";8713;117;8345;6;109;115;6;0,932203389830508;0,983050847457627
"8346";8713;117;8346;6;111;117;6;0,949152542372881;1
"8347";8713;117;8347;6;41;47;6;0,355932203389831;0,406779661016949
"8348";8713;117;8348;6;43;51;8;0,372881355932203;0,440677966101695
"8349";8713;117;8349;6;45;51;6;0,389830508474576;0,440677966101695
"8350";8713;117;8350;6;53;59;6;0,457627118644068;0,508474576271186
"8351";8713;117;8351;6;61;71;10;0,525423728813559;0,610169491525424
"8352";8713;117;8352;6;61;73;12;0,525423728813559;0,627118644067797
"8353";8713;117;8353;6;65;71;6;0,559322033898305;0,610169491525424
"8354";8713;117;8354;6;67;73;6;0,576271186440678;0,627118644067797
"8355";8713;117;8355;6;89;95;6;0,76271186440678;0,813559322033898
"8356";8713;117;8356;6;89;97;8;0,76271186440678;0,830508474576271
"8357";8713;117;8357;6;103;111;8;0,88135593220339;0,949152542372881
"8358";8713;117;8358;6;103;113;10;0,88135593220339;0,966101694915254
"8359";8713;117;8359;6;103;115;12;0,88135593220339;0,983050847457627
"8360";8713;117;8360;6;105;113;8;0,898305084745763;0,966101694915254
"8361";8713;117;8361;6;105;115;10;0,898305084745763;0,983050847457627
"8362";8713;117;8362;6;107;113;6;0,915254237288136;0,966101694915254
"8363";8713;117;8363;6;63;71;8;0,542372881355932;0,610169491525424
"8364";8713;117;8364;6;63;73;10;0,542372881355932;0,627118644067797
"8365";8713;117;8365;6;65;73;8;0,559322033898305;0,627118644067797
"8366";8713;117;8366;6;101;111;10;0,864406779661017;0,949152542372881
"8367";8713;117;8367;6;101;113;12;0,864406779661017;0,966101694915254
"8368";8713;117;8368;6;107;115;8;0,915254237288136;0,983050847457627
"8369";8713;117;8369;6;109;117;8;0,932203389830508;1
"8370";8713;117;8370;6;23;29;6;0,203389830508475;0,254237288135593
"8371";8713;117;8371;6;87;95;8;0,745762711864407;0,813559322033898
"8372";8713;117;8372;6;87;97;10;0,745762711864407;0,830508474576271
"8373";8713;117;8373;6;91;97;6;0,779661016949153;0,830508474576271
"8374";8713;117;8374;6;51;57;6;0,440677966101695;0,491525423728814
"8375";8713;117;8375;6;53;61;8;0,457627118644068;0,525423728813559
"8376";8713;117;8376;6;85;91;6;0,728813559322034;0,779661016949153
"8377";8713;117;8377;6;25;31;6;0,220338983050847;0,271186440677966
"8378";8713;117;8378;6;105;117;12;0,898305084745763;1
"8379";8713;117;8379;6;107;117;10;0,915254237288136;1
"8380";8713;117;8380;6;59;65;6;0,508474576271186;0,559322033898305
"8381";8713;117;8381;6;65;75;10;0,559322033898305;0,644067796610169
"8382";8713;117;8382;6;67;75;8;0,576271186440678;0,644067796610169
"8383";8713;117;8383;6;71;77;6;0,610169491525424;0,661016949152542
"8384";8713;117;8384;6;77;83;6;0,661016949152542;0,711864406779661
"8385";8713;117;8385;6;93;99;6;0,796610169491525;0,847457627118644
"8386";8713;117;8386;6;93;101;8;0,796610169491525;0,864406779661017
"8387";8713;117;8387;6;15;21;6;0,135593220338983;0,186440677966102
"8388";8713;117;8388;6;57;63;6;0,491525423728814;0,542372881355932
"8389";8713;117;8389;6;51;59;8;0,440677966101695;0,508474576271186
"8390";8713;117;8390;6;103;117;14;0,88135593220339;1
"8391";8713;117;8391;6;9;15;6;0,0847457627118644;0,135593220338983
"8392";8713;117;8392;6;75;81;6;0,644067796610169;0,694915254237288
"8393";8713;117;8393;6;85;93;8;0,728813559322034;0,796610169491525
"8394";8713;117;8394;6;29;35;6;0,254237288135593;0,305084745762712
"8395";8713;117;8395;6;23;31;8;0,203389830508475;0,271186440677966
"8396";8713;117;8396;6;99;105;6;0,847457627118644;0,898305084745763
"8397";8713;117;8397;6;95;101;6;0,813559322033898;0,864406779661017
"8398";8713;117;8398;6;47;53;6;0,406779661016949;0,457627118644068
"8399";8713;117;8399;6;63;75;12;0,542372881355932;0,644067796610169
"8400";8713;117;8400;6;7;13;6;0,0677966101694915;0,11864406779661
"8401";8713;117;8401;6;39;45;6;0,338983050847458;0,389830508474576
"8402";8765;114;8402;3;65;114;49;0,571428571428571;1
"8403";8765;114;8403;3;32;81;49;0,285714285714286;0,714285714285714
"8404";8765;114;8404;3;48;98;50;0,428571428571429;0,857142857142857
"8405";8765;114;8405;4;15;40;25;0,142857142857143;0,357142857142857
"8406";8765;114;8406;4;24;48;24;0,214285714285714;0,428571428571429
"8407";8765;114;8407;4;32;56;24;0,285714285714286;0,5
"8408";8765;114;8408;4;48;73;25;0,428571428571429;0,642857142857143
"8409";8765;114;8409;4;24;56;32;0,214285714285714;0,5
"8410";8765;114;8410;4;56;81;25;0,5;0,714285714285714
"8411";8765;114;8411;4;81;106;25;0,714285714285714;0,928571428571429
"8412";8765;114;8412;4;73;98;25;0,642857142857143;0,857142857142857
"8413";8765;114;8413;4;15;48;33;0,142857142857143;0,428571428571429
"8414";8765;114;8414;4;89;114;25;0,785714285714286;1
"8415";8765;114;8415;4;81;114;33;0,714285714285714;1
"8416";8765;114;8416;5;24;36;12;0,214285714285714;0,321428571428571
"8417";8765;114;8417;5;28;40;12;0,25;0,357142857142857
"8418";8765;114;8418;5;56;69;13;0,5;0,607142857142857
"8419";8765;114;8419;5;77;89;12;0,678571428571429;0,785714285714286
"8420";8765;114;8420;5;93;106;13;0,821428571428571;0,928571428571429
"8421";8765;114;8421;5;102;114;12;0,892857142857143;1
"8422";8765;114;8422;5;11;24;13;0,107142857142857;0,214285714285714
"8423";8765;114;8423;5;28;44;16;0,25;0,392857142857143
"8424";8765;114;8424;5;32;44;12;0,285714285714286;0,392857142857143
"8425";8765;114;8425;5;44;56;12;0,392857142857143;0,5
"8426";8765;114;8426;5;56;73;17;0,5;0,642857142857143
"8427";8765;114;8427;5;56;77;21;0,5;0,678571428571429
"8428";8765;114;8428;5;61;73;12;0,535714285714286;0,642857142857143
"8429";8765;114;8429;5;28;48;20;0,25;0,428571428571429
"8430";8765;114;8430;5;32;48;16;0,285714285714286;0,428571428571429
"8431";8765;114;8431;5;61;77;16;0,535714285714286;0,678571428571429
"8432";8765;114;8432;5;61;81;20;0,535714285714286;0,714285714285714
"8433";8765;114;8433;5;65;77;12;0,571428571428571;0,678571428571429
"8434";8765;114;8434;5;81;93;12;0,714285714285714;0,821428571428571
"8435";8765;114;8435;5;81;98;17;0,714285714285714;0,857142857142857
"8436";8765;114;8436;5;81;102;21;0,714285714285714;0,892857142857143
"8437";8765;114;8437;5;85;98;13;0,75;0,857142857142857
"8438";8765;114;8438;5;89;102;13;0,785714285714286;0,892857142857143
"8439";8765;114;8439;5;89;106;17;0,785714285714286;0,928571428571429
"8440";8765;114;8440;5;93;110;17;0,821428571428571;0,964285714285714
"8441";8765;114;8441;5;93;114;21;0,821428571428571;1
"8442";8765;114;8442;5;98;110;12;0,857142857142857;0,964285714285714
"8443";8765;114;8443;5;40;52;12;0,357142857142857;0,464285714285714
"8444";8765;114;8444;5;98;114;16;0,857142857142857;1
"8445";8765;114;8445;5;24;40;16;0,214285714285714;0,357142857142857
"8446";8765;114;8446;5;15;28;13;0,142857142857143;0,25
"8447";8765;114;8447;5;24;44;20;0,214285714285714;0,392857142857143
"8448";8765;114;8448;5;24;48;24;0,214285714285714;0,428571428571429
"8449";8765;114;8449;5;28;52;24;0,25;0,464285714285714
"8450";8765;114;8450;5;48;61;13;0,428571428571429;0,535714285714286
"8451";8765;114;8451;5;20;32;12;0,178571428571429;0,285714285714286
"8452";8765;114;8452;5;52;65;13;0,464285714285714;0,571428571428571
"8453";8765;114;8453;5;52;69;17;0,464285714285714;0,607142857142857
"8454";8765;114;8454;5;40;56;16;0,357142857142857;0,5
"8455";8765;114;8455;5;85;102;17;0,75;0,892857142857143
"8456";8765;114;8456;5;77;93;16;0,678571428571429;0,821428571428571
"8457";8765;114;8457;5;32;52;20;0,285714285714286;0,464285714285714
"8458";8765;114;8458;5;52;73;21;0,464285714285714;0,642857142857143
"8459";8765;114;8459;5;77;98;21;0,678571428571429;0,857142857142857
"8460";8765;114;8460;5;20;36;16;0,178571428571429;0,321428571428571
"8461";8765;114;8461;5;36;48;12;0,321428571428571;0,428571428571429
"8462";8765;114;8462;6;96;102;6;0,842105263157895;0,894736842105263
"8463";8765;114;8463;6;96;104;8;0,842105263157895;0,912280701754386
"8464";8765;114;8464;6;98;104;6;0,859649122807018;0,912280701754386
"8465";8765;114;8465;6;3;9;6;0,0350877192982456;0,087719298245614
"8466";8765;114;8466;6;13;19;6;0,12280701754386;0,175438596491228
"8467";8765;114;8467;6;15;21;6;0,140350877192982;0,192982456140351
"8468";8765;114;8468;6;15;23;8;0,140350877192982;0,210526315789474
"8469";8765;114;8469;6;15;25;10;0,140350877192982;0,228070175438596
"8470";8765;114;8470;6;17;23;6;0,157894736842105;0,210526315789474
"8471";8765;114;8471;6;17;25;8;0,157894736842105;0,228070175438596
"8472";8765;114;8472;6;19;25;6;0,175438596491228;0,228070175438596
"8473";8765;114;8473;6;21;27;6;0,192982456140351;0,245614035087719
"8474";8765;114;8474;6;21;29;8;0,192982456140351;0,263157894736842
"8475";8765;114;8475;6;27;33;6;0,245614035087719;0,298245614035088
"8476";8765;114;8476;6;27;35;8;0,245614035087719;0,315789473684211
"8477";8765;114;8477;6;27;37;10;0,245614035087719;0,333333333333333
"8478";8765;114;8478;6;33;39;6;0,298245614035088;0,350877192982456
"8479";8765;114;8479;6;33;41;8;0,298245614035088;0,368421052631579
"8480";8765;114;8480;6;41;47;6;0,368421052631579;0,421052631578947
"8481";8765;114;8481;6;41;49;8;0,368421052631579;0,43859649122807
"8482";8765;114;8482;6;43;49;6;0,385964912280702;0,43859649122807
"8483";8765;114;8483;6;49;55;6;0,43859649122807;0,491228070175439
"8484";8765;114;8484;6;58;64;6;0,508771929824561;0,56140350877193
"8485";8765;114;8485;6;60;66;6;0,526315789473684;0,578947368421053
"8486";8765;114;8486;6;60;68;8;0,526315789473684;0,596491228070175
"8487";8765;114;8487;6;60;70;10;0,526315789473684;0,614035087719298
"8488";8765;114;8488;6;66;72;6;0,578947368421053;0,631578947368421
"8489";8765;114;8489;6;66;74;8;0,578947368421053;0,649122807017544
"8490";8765;114;8490;6;66;76;10;0,578947368421053;0,666666666666667
"8491";8765;114;8491;6;74;80;6;0,649122807017544;0,701754385964912
"8492";8765;114;8492;6;82;88;6;0,719298245614035;0,771929824561403
"8493";8765;114;8493;6;82;90;8;0,719298245614035;0,789473684210526
"8494";8765;114;8494;6;84;90;6;0,736842105263158;0,789473684210526
"8495";8765;114;8495;6;86;92;6;0,754385964912281;0,807017543859649
"8496";8765;114;8496;6;88;94;6;0,771929824561403;0,824561403508772
"8497";8765;114;8497;6;90;96;6;0,789473684210526;0,842105263157895
"8498";8765;114;8498;6;92;98;6;0,807017543859649;0,859649122807018
"8499";8765;114;8499;6;100;106;6;0,87719298245614;0,929824561403509
"8500";8765;114;8500;6;100;108;8;0,87719298245614;0,947368421052632
"8501";8765;114;8501;6;100;110;10;0,87719298245614;0,964912280701754
"8502";8765;114;8502;6;102;108;6;0,894736842105263;0,947368421052632
"8503";8765;114;8503;6;102;110;8;0,894736842105263;0,964912280701754
"8504";8765;114;8504;6;102;112;10;0,894736842105263;0,982456140350877
"8505";8765;114;8505;6;104;110;6;0,912280701754386;0,964912280701754
"8506";8765;114;8506;6;104;112;8;0,912280701754386;0,982456140350877
"8507";8765;114;8507;6;104;114;10;0,912280701754386;1
"8508";8765;114;8508;6;106;112;6;0,929824561403509;0,982456140350877
"8509";8765;114;8509;6;106;114;8;0,929824561403509;1
"8510";8765;114;8510;6;3;11;8;0,0350877192982456;0,105263157894737
"8511";8765;114;8511;6;13;21;8;0,12280701754386;0,192982456140351
"8512";8765;114;8512;6;13;23;10;0,12280701754386;0,210526315789474
"8513";8765;114;8513;6;25;31;6;0,228070175438596;0,280701754385965
"8514";8765;114;8514;6;25;33;8;0,228070175438596;0,298245614035088
"8515";8765;114;8515;6;25;35;10;0,228070175438596;0,315789473684211
"8516";8765;114;8516;6;25;37;12;0,228070175438596;0,333333333333333
"8517";8765;114;8517;6;27;39;12;0,245614035087719;0,350877192982456
"8518";8765;114;8518;6;27;41;14;0,245614035087719;0,368421052631579
"8519";8765;114;8519;6;27;43;16;0,245614035087719;0,385964912280702
"8520";8765;114;8520;6;27;45;18;0,245614035087719;0,403508771929825
"8521";8765;114;8521;6;27;47;20;0,245614035087719;0,421052631578947
"8522";8765;114;8522;6;43;51;8;0,385964912280702;0,456140350877193
"8523";8765;114;8523;6;51;58;7;0,456140350877193;0,508771929824561
"8524";8765;114;8524;6;58;66;8;0,508771929824561;0,578947368421053
"8525";8765;114;8525;6;58;68;10;0,508771929824561;0,596491228070175
"8526";8765;114;8526;6;60;72;12;0,526315789473684;0,631578947368421
"8527";8765;114;8527;6;60;74;14;0,526315789473684;0,649122807017544
"8528";8765;114;8528;6;62;68;6;0,543859649122807;0,596491228070175
"8529";8765;114;8529;6;62;70;8;0,543859649122807;0,614035087719298
"8530";8765;114;8530;6;62;72;10;0,543859649122807;0,631578947368421
"8531";8765;114;8531;6;66;78;12;0,578947368421053;0,684210526315789
"8532";8765;114;8532;6;80;86;6;0,701754385964912;0,754385964912281
"8533";8765;114;8533;6;80;88;8;0,701754385964912;0,771929824561403
"8534";8765;114;8534;6;80;90;10;0,701754385964912;0,789473684210526
"8535";8765;114;8535;6;80;92;12;0,701754385964912;0,807017543859649
"8536";8765;114;8536;6;82;92;10;0,719298245614035;0,807017543859649
"8537";8765;114;8537;6;84;92;8;0,736842105263158;0,807017543859649
"8538";8765;114;8538;6;84;94;10;0,736842105263158;0,824561403508772
"8539";8765;114;8539;6;86;94;8;0,754385964912281;0,824561403508772
"8540";8765;114;8540;6;86;96;10;0,754385964912281;0,842105263157895
"8541";8765;114;8541;6;88;96;8;0,771929824561403;0,842105263157895
"8542";8765;114;8542;6;5;11;6;0,0526315789473684;0,105263157894737
"8543";8765;114;8543;6;33;43;10;0,298245614035088;0,385964912280702
"8544";8765;114;8544;6;33;45;12;0,298245614035088;0,403508771929825
"8545";8765;114;8545;6;33;47;14;0,298245614035088;0,421052631578947
"8546";8765;114;8546;6;60;76;16;0,526315789473684;0,666666666666667
"8547";8765;114;8547;6;60;78;18;0,526315789473684;0,684210526315789
"8548";8765;114;8548;6;84;96;12;0,736842105263158;0,842105263157895
"8549";8765;114;8549;6;86;98;12;0,754385964912281;0,859649122807018
"8550";8765;114;8550;6;90;98;8;0,789473684210526;0,859649122807018
"8551";8765;114;8551;6;90;100;10;0,789473684210526;0,87719298245614
"8552";8765;114;8552;6;92;100;8;0,807017543859649;0,87719298245614
"8553";8765;114;8553;6;92;102;10;0,807017543859649;0,894736842105263
"8554";8765;114;8554;6;98;106;8;0,859649122807018;0,929824561403509
"8555";8765;114;8555;6;100;112;12;0,87719298245614;0,982456140350877
"8556";8765;114;8556;6;100;114;14;0,87719298245614;1
"8557";8765;114;8557;6;102;114;12;0,894736842105263;1
"8558";8765;114;8558;6;60;80;20;0,526315789473684;0,701754385964912
"8559";8765;114;8559;6;66;80;14;0,578947368421053;0,701754385964912
"8560";8765;114;8560;6;25;39;14;0,228070175438596;0,350877192982456
"8561";8765;114;8561;6;25;41;16;0,228070175438596;0,368421052631579
"8562";8765;114;8562;6;55;62;7;0,491228070175439;0,543859649122807
"8563";8765;114;8563;6;55;64;9;0,491228070175439;0,56140350877193
"8564";8765;114;8564;6;55;66;11;0,491228070175439;0,578947368421053
"8565";8765;114;8565;6;55;68;13;0,491228070175439;0,596491228070175
"8566";8765;114;8566;6;55;70;15;0,491228070175439;0,614035087719298
"8567";8765;114;8567;6;55;72;17;0,491228070175439;0,631578947368421
"8568";8765;114;8568;6;58;70;12;0,508771929824561;0,614035087719298
"8569";8765;114;8569;6;58;72;14;0,508771929824561;0,631578947368421
"8570";8765;114;8570;6;82;94;12;0,719298245614035;0,824561403508772
"8571";8765;114;8571;6;58;74;16;0,508771929824561;0,649122807017544
"8572";8765;114;8572;6;49;58;9;0,43859649122807;0,508771929824561
"8573";8765;114;8573;6;13;25;12;0,12280701754386;0,228070175438596
"8574";8765;114;8574;6;33;49;16;0,298245614035088;0,43859649122807
"8575";8765;114;8575;6;64;70;6;0,56140350877193;0,614035087719298
"8576";8765;114;8576;6;82;96;14;0,719298245614035;0,842105263157895
"8577";8765;114;8577;6;82;98;16;0,719298245614035;0,859649122807018
"8578";8765;114;8578;6;90;102;12;0,789473684210526;0,894736842105263
"8579";8765;114;8579;6;62;74;12;0,543859649122807;0,649122807017544
"8580";8765;114;8580;6;96;106;10;0,842105263157895;0,929824561403509
"8581";8765;114;8581;6;80;94;14;0,701754385964912;0,824561403508772
"8582";8765;114;8582;6;80;96;16;0,701754385964912;0,842105263157895
"8583";8765;114;8583;6;41;51;10;0,368421052631579;0,456140350877193
"8584";8765;114;8584;6;96;108;12;0,842105263157895;0,947368421052632
"8585";8765;114;8585;6;58;76;18;0,508771929824561;0,666666666666667
"8586";8765;114;8586;6;58;78;20;0,508771929824561;0,684210526315789
"8587";8765;114;8587;6;58;80;22;0,508771929824561;0,701754385964912
"8588";8765;114;8588;6;64;72;8;0,56140350877193;0,631578947368421
"8589";8765;114;8589;6;64;74;10;0,56140350877193;0,649122807017544
"8590";8765;114;8590;6;23;29;6;0,210526315789474;0,263157894736842
"8591";8765;114;8591;6;98;108;10;0,859649122807018;0,947368421052632
"8592";8765;114;8592;6;98;110;12;0,859649122807018;0,964912280701754
"8593";8765;114;8593;6;98;112;14;0,859649122807018;0,982456140350877
"8594";8765;114;8594;6;25;43;18;0,228070175438596;0,385964912280702
"8595";8765;114;8595;6;62;76;14;0,543859649122807;0,666666666666667
"8596";8765;114;8596;6;15;27;12;0,140350877192982;0,245614035087719
"8597";8765;114;8597;6;39;45;6;0,350877192982456;0,403508771929825
"8598";8765;114;8598;6;1;7;6;0,0175438596491228;0,0701754385964912
"8599";8765;114;8599;6;39;47;8;0,350877192982456;0,421052631578947
"8600";8765;114;8600;6;39;49;10;0,350877192982456;0,43859649122807
"8601";8765;114;8601;6;43;53;10;0,385964912280702;0,473684210526316
"8602";8765;114;8602;6;41;53;12;0,368421052631579;0,473684210526316
"8603";8765;114;8603;6;64;76;12;0,56140350877193;0,666666666666667
"8604";8765;114;8604;6;64;78;14;0,56140350877193;0,684210526315789
"8605";8765;114;8605;6;64;80;16;0,56140350877193;0,701754385964912
"8606";8765;114;8606;6;25;45;20;0,228070175438596;0,403508771929825
"8607";8765;114;8607;6;25;47;22;0,228070175438596;0,421052631578947
"8608";8765;114;8608;6;96;110;14;0,842105263157895;0,964912280701754
"8609";8765;114;8609;6;96;112;16;0,842105263157895;0,982456140350877
"8610";8765;114;8610;6;27;49;22;0,245614035087719;0,43859649122807
"8611";8891;167;8611;4;49;100;51;0,3;0,6
"8612";8891;167;8612;5;79;103;24;0,476190476190476;0,619047619047619
"8613";8891;167;8613;5;127;151;24;0,761904761904762;0,904761904761905
"8614";8891;167;8614;5;63;87;24;0,380952380952381;0,523809523809524
"8615";8891;167;8615;5;71;95;24;0,428571428571429;0,571428571428571
"8616";8891;167;8616;5;79;111;32;0,476190476190476;0,666666666666667
"8617";8891;167;8617;5;87;111;24;0,523809523809524;0,666666666666667
"8618";8891;167;8618;5;135;159;24;0,80952380952381;0,952380952380952
"8619";8891;167;8619;5;143;167;24;0,857142857142857;1
"8620";8891;167;8620;5;55;79;24;0,333333333333333;0,476190476190476
"8621";8891;167;8621;6;83;95;12;0,5;0,571428571428571
"8622";8891;167;8622;6;123;135;12;0,738095238095238;0,80952380952381
"8623";8891;167;8623;6;83;99;16;0,5;0,595238095238095
"8624";8891;167;8624;6;87;99;12;0,523809523809524;0,595238095238095
"8625";8891;167;8625;6;87;103;16;0,523809523809524;0,619047619047619
"8626";8891;167;8626;6;95;107;12;0,571428571428571;0,642857142857143
"8627";8891;167;8627;6;99;111;12;0,595238095238095;0,666666666666667
"8628";8891;167;8628;6;103;115;12;0,619047619047619;0,69047619047619
"8629";8891;167;8629;6;127;139;12;0,761904761904762;0,833333333333333
"8630";8891;167;8630;6;95;111;16;0,571428571428571;0,666666666666667
"8631";8891;167;8631;6;99;115;16;0,595238095238095;0,69047619047619
"8632";8891;167;8632;6;123;139;16;0,738095238095238;0,833333333333333
"8633";8891;167;8633;6;131;143;12;0,785714285714286;0,857142857142857
"8634";8891;167;8634;6;147;159;12;0,880952380952381;0,952380952380952
"8635";8891;167;8635;6;155;167;12;0,928571428571429;1
"8636";8891;167;8636;6;35;47;12;0,214285714285714;0,285714285714286
"8637";8891;167;8637;6;91;103;12;0,547619047619048;0,619047619047619
"8638";8891;167;8638;6;91;107;16;0,547619047619048;0,642857142857143
"8639";8891;167;8639;6;139;151;12;0,833333333333333;0,904761904761905
"8640";8891;167;8640;6;147;163;16;0,880952380952381;0,976190476190476
"8641";8891;167;8641;6;151;163;12;0,904761904761905;0,976190476190476
"8642";8891;167;8642;6;151;167;16;0,904761904761905;1
"8643";8891;167;8643;6;71;83;12;0,428571428571429;0,5
"8644";8891;167;8644;6;75;87;12;0,452380952380952;0,523809523809524
"8645";8891;167;8645;6;95;115;20;0,571428571428571;0,69047619047619
"8646";8891;167;8646;6;147;167;20;0,880952380952381;1
"8647";8891;167;8647;6;79;91;12;0,476190476190476;0,547619047619048
"8648";8891;167;8648;6;143;155;12;0,857142857142857;0,928571428571429
"8649";8891;167;8649;6;143;159;16;0,857142857142857;0,952380952380952
"8650";8891;167;8650;6;67;79;12;0,404761904761905;0,476190476190476
"8651";8891;167;8651;6;27;39;12;0,166666666666667;0,238095238095238
"8652";8891;167;8652;6;47;59;12;0,285714285714286;0,357142857142857
"8653";8891;167;8653;6;63;75;12;0,380952380952381;0,452380952380952
"8654";8891;167;8654;6;19;31;12;0,119047619047619;0,19047619047619
"8655";8891;167;8655;6;31;43;12;0,19047619047619;0,261904761904762
"8656";8891;167;8656;6;135;147;12;0,80952380952381;0,880952380952381
"8657";8891;167;8657;6;87;107;20;0,523809523809524;0,642857142857143
"8658";8891;167;8658;6;59;71;12;0,357142857142857;0,428571428571429
"8659";8891;167;8659;6;127;143;16;0,761904761904762;0,857142857142857
"8660";8891;167;8660;6;75;91;16;0,452380952380952;0,547619047619048
"8661";8891;167;8661;6;79;95;16;0,476190476190476;0,571428571428571
"8662";8891;167;8662;6;55;67;12;0,333333333333333;0,404761904761905
"8663";8891;167;8663;6;139;155;16;0,833333333333333;0,928571428571429
"8664";8891;167;8664;6;139;159;20;0,833333333333333;0,952380952380952
"8665";8891;167;8665;6;23;35;12;0,142857142857143;0,214285714285714
"8666";8891;167;8666;6;131;147;16;0,785714285714286;0,880952380952381
"8667";8891;167;8667;6;43;55;12;0,261904761904762;0,333333333333333
"8668";8891;167;8668;6;71;87;16;0,428571428571429;0,523809523809524
"8669";8891;167;8669;6;11;23;12;0,0714285714285714;0,142857142857143
"8670";8891;167;8670;6;91;111;20;0,547619047619048;0,666666666666667
"8671";8891;167;8671;6;91;115;24;0,547619047619048;0,69047619047619
"8672";8891;167;8672;6;51;63;12;0,30952380952381;0,380952380952381
"8673";8957;166;8673;4;99;149;50;0,6;0,9
"8674";8957;166;8674;4;116;166;50;0,7;1
"8675";8957;166;8675;5;116;141;25;0,7;0,85
"8676";8957;166;8676;5;99;124;25;0,6;0,75
"8677";8957;166;8677;5;108;133;25;0,65;0,8
"8678";8957;166;8678;5;116;149;33;0,7;0,9
"8679";8957;166;8679;5;124;149;25;0,75;0,9
"8680";8957;166;8680;5;99;133;34;0,6;0,8
"8681";8957;166;8681;5;99;141;42;0,6;0,85
"8682";8957;166;8682;5;99;149;50;0,6;0,9
"8683";8957;166;8683;5;91;116;25;0,55;0,7
"8684";8957;166;8684;5;108;141;33;0,65;0,85
"8685";8957;166;8685;5;108;149;41;0,65;0,9
"8686";8957;166;8686;5;82;108;26;0,5;0,65
"8687";8957;166;8687;6;93;105;12;0,560975609756098;0,634146341463415
"8688";8957;166;8688;6;11;23;12;0,0731707317073171;0,146341463414634
"8689";8957;166;8689;6;97;109;12;0,585365853658537;0,658536585365854
"8690";8957;166;8690;6;97;113;16;0,585365853658537;0,682926829268293
"8691";8957;166;8691;6;101;113;12;0,609756097560976;0,682926829268293
"8692";8957;166;8692;6;105;117;12;0,634146341463415;0,707317073170732
"8693";8957;166;8693;6;113;125;12;0,682926829268293;0,75609756097561
"8694";8957;166;8694;6;117;129;12;0,707317073170732;0,780487804878049
"8695";8957;166;8695;6;117;133;16;0,707317073170732;0,804878048780488
"8696";8957;166;8696;6;121;133;12;0,731707317073171;0,804878048780488
"8697";8957;166;8697;6;121;137;16;0,731707317073171;0,829268292682927
"8698";8957;166;8698;6;125;137;12;0,75609756097561;0,829268292682927
"8699";8957;166;8699;6;125;142;17;0,75609756097561;0,853658536585366
"8700";8957;166;8700;6;142;154;12;0,853658536585366;0,926829268292683
"8701";8957;166;8701;6;3;15;12;0,024390243902439;0,0975609756097561
"8702";8957;166;8702;6;36;48;12;0,219512195121951;0,292682926829268
"8703";8957;166;8703;6;109;121;12;0,658536585365854;0,731707317073171
"8704";8957;166;8704;6;117;137;20;0,707317073170732;0,829268292682927
"8705";8957;166;8705;6;121;142;21;0,731707317073171;0,853658536585366
"8706";8957;166;8706;6;129;142;13;0,780487804878049;0,853658536585366
"8707";8957;166;8707;6;129;146;17;0,780487804878049;0,878048780487805
"8708";8957;166;8708;6;129;150;21;0,780487804878049;0,902439024390244
"8709";8957;166;8709;6;133;146;13;0,804878048780488;0,878048780487805
"8710";8957;166;8710;6;133;150;17;0,804878048780488;0,902439024390244
"8711";8957;166;8711;6;109;125;16;0,658536585365854;0,75609756097561
"8712";8957;166;8712;6;137;150;13;0,829268292682927;0,902439024390244
"8713";8957;166;8713;6;97;117;20;0,585365853658537;0,707317073170732
"8714";8957;166;8714;6;101;117;16;0,609756097560976;0,707317073170732
"8715";8957;166;8715;6;117;142;25;0,707317073170732;0,853658536585366
"8716";8957;166;8716;6;121;146;25;0,731707317073171;0,878048780487805
"8717";8957;166;8717;6;113;129;16;0,682926829268293;0,780487804878049
"8718";8957;166;8718;6;117;146;29;0,707317073170732;0,878048780487805
"8719";8957;166;8719;6;117;150;33;0,707317073170732;0,902439024390244
"8720";8957;166;8720;6;117;154;37;0,707317073170732;0,926829268292683
"8721";8957;166;8721;6;121;150;29;0,731707317073171;0,902439024390244
"8722";8957;166;8722;6;121;154;33;0,731707317073171;0,926829268292683
"8723";8957;166;8723;6;125;146;21;0,75609756097561;0,878048780487805
"8724";8957;166;8724;6;125;150;25;0,75609756097561;0,902439024390244
"8725";8957;166;8725;6;125;154;29;0,75609756097561;0,926829268292683
"8726";8957;166;8726;6;137;154;17;0,829268292682927;0,926829268292683
"8727";8957;166;8727;6;146;158;12;0,878048780487805;0,951219512195122
"8728";8957;166;8728;6;7;19;12;0,0487804878048781;0,121951219512195
"8729";8957;166;8729;6;105;121;16;0,634146341463415;0,731707317073171
"8730";8957;166;8730;6;105;125;20;0,634146341463415;0,75609756097561
"8731";8957;166;8731;6;105;129;24;0,634146341463415;0,780487804878049
"8732";8957;166;8732;6;105;133;28;0,634146341463415;0,804878048780488
"8733";8957;166;8733;6;105;137;32;0,634146341463415;0,829268292682927
"8734";8957;166;8734;6;93;109;16;0,560975609756098;0,658536585365854
"8735";8957;166;8735;6;23;36;13;0,146341463414634;0,219512195121951
"8736";8957;166;8736;6;109;129;20;0,658536585365854;0,780487804878049
"8737";8957;166;8737;6;109;133;24;0,658536585365854;0,804878048780488
"8738";8957;166;8738;6;101;121;20;0,609756097560976;0,731707317073171
"8739";8957;166;8739;6;129;154;25;0,780487804878049;0,926829268292683
"8740";8957;166;8740;6;133;154;21;0,804878048780488;0,926829268292683
"8741";8957;166;8741;6;113;133;20;0,682926829268293;0,804878048780488
"8742";8957;166;8742;6;113;137;24;0,682926829268293;0,829268292682927
"8743";8957;166;8743;6;3;19;16;0,024390243902439;0,121951219512195
"8744";8957;166;8744;6;40;52;12;0,24390243902439;0,317073170731707
"8745";8957;166;8745;6;93;113;20;0,560975609756098;0,682926829268293
"8746";8957;166;8746;6;93;117;24;0,560975609756098;0,707317073170732
"8747";8957;166;8747;6;109;137;28;0,658536585365854;0,829268292682927
"8748";8957;166;8748;6;80;93;13;0,48780487804878;0,560975609756098
"8749";8957;166;8749;6;89;101;12;0,536585365853659;0,609756097560976
"8750";8957;166;8750;6;113;142;29;0,682926829268293;0,853658536585366
"8751";8957;166;8751;6;113;146;33;0,682926829268293;0,878048780487805
"8752";8957;166;8752;6;28;40;12;0,170731707317073;0,24390243902439
"8753";8957;166;8753;6;97;121;24;0,585365853658537;0,731707317073171
"8754";8957;166;8754;6;101;125;24;0,609756097560976;0,75609756097561
"8755";8957;166;8755;6;154;166;12;0,926829268292683;1
"8756";9630;66;8756;5;37;49;12;0,5625;0,75
"8757";9630;66;8757;5;41;53;12;0,625;0,8125
"8758";9630;66;8758;5;12;24;12;0,1875;0,375
"8759";9630;66;8759;6;44;50;6;0,666666666666667;0,757575757575758
"8760";9630;66;8760;6;42;48;6;0,636363636363636;0,727272727272727
"8761";9630;66;8761;6;38;44;6;0,575757575757576;0,666666666666667
"8762";9630;66;8762;6;40;46;6;0,606060606060606;0,696969696969697
"8763";9630;66;8763;6;42;50;8;0,636363636363636;0,757575757575758
"8764";9630;66;8764;6;38;46;8;0,575757575757576;0,696969696969697
"8765";9630;66;8765;6;38;48;10;0,575757575757576;0,727272727272727
"8766";9630;66;8766;6;21;27;6;0,333333333333333;0,424242424242424
"8767";9630;66;8767;6;17;23;6;0,272727272727273;0,363636363636364
"8768";9630;66;8768;6;19;25;6;0,303030303030303;0,393939393939394
"8769";9630;66;8769;6;36;42;6;0,545454545454545;0,636363636363636
"8770";9630;66;8770;6;34;40;6;0,515151515151515;0,606060606060606
"8771";9630;66;8771;6;38;50;12;0,575757575757576;0,757575757575758
"8772";9630;66;8772;6;36;44;8;0,545454545454545;0,666666666666667
"8773";9630;66;8773;6;36;46;10;0,545454545454545;0,696969696969697
"8774";9630;66;8774;6;54;60;6;0,818181818181818;0,909090909090909
"8775";9630;66;8775;6;40;48;8;0,606060606060606;0,727272727272727
"8776";9630;66;8776;6;40;50;10;0,606060606060606;0,757575757575758
"8777";9630;66;8777;6;31;38;7;0,484848484848485;0,575757575757576
"8778";9630;66;8778;6;15;21;6;0,242424242424242;0,333333333333333
"8779";9646;179;8779;5;130;154;24;0,727272727272727;0,863636363636364
"8780";9646;179;8780;5;81;105;24;0,454545454545455;0,590909090909091
"8781";9646;179;8781;6;79;91;12;0,444444444444444;0,511111111111111
"8782";9646;179;8782;6;83;95;12;0,466666666666667;0,533333333333333
"8783";9646;179;8783;6;127;139;12;0,711111111111111;0,777777777777778
"8784";9646;179;8784;6;139;151;12;0,777777777777778;0,844444444444444
"8785";9646;179;8785;6;139;155;16;0,777777777777778;0,866666666666667
"8786";9646;179;8786;6;31;43;12;0,177777777777778;0,244444444444444
"8787";9646;179;8787;6;83;99;16;0,466666666666667;0,555555555555556
"8788";9646;179;8788;6;127;143;16;0,711111111111111;0,8
"8789";9646;179;8789;6;127;147;20;0,711111111111111;0,822222222222222
"8790";9646;179;8790;6;131;143;12;0,733333333333333;0,8
"8791";9646;179;8791;6;131;147;16;0,733333333333333;0,822222222222222
"8792";9646;179;8792;6;143;155;12;0,8;0,866666666666667
"8793";9646;179;8793;6;79;95;16;0,444444444444444;0,533333333333333
"8794";9646;179;8794;6;135;147;12;0,755555555555556;0,822222222222222
"8795";9646;179;8795;6;135;151;16;0,755555555555556;0,844444444444444
"8796";9646;179;8796;6;135;155;20;0,755555555555556;0,866666666666667
"8797";9646;179;8797;6;91;103;12;0,511111111111111;0,577777777777778
"8798";9646;179;8798;6;155;167;12;0,866666666666667;0,933333333333333
"8799";9646;179;8799;6;155;171;16;0,866666666666667;0,955555555555556
"8800";9646;179;8800;6;27;39;12;0,155555555555556;0,222222222222222
"8801";9646;179;8801;6;123;135;12;0,688888888888889;0,755555555555556
"8802";9646;179;8802;6;123;139;16;0,688888888888889;0,777777777777778
"8803";9646;179;8803;6;27;43;16;0,155555555555556;0,244444444444444
"8804";9646;179;8804;6;87;99;12;0,488888888888889;0,555555555555556
"8805";9646;179;8805;6;131;151;20;0,733333333333333;0,844444444444444
"8806";9646;179;8806;6;131;155;24;0,733333333333333;0,866666666666667
"8807";9646;179;8807;6;79;99;20;0,444444444444444;0,555555555555556
"8808";9673;58;8808;3;24;50;26;0,428571428571429;0,857142857142857
"8809";9673;58;8809;3;33;58;25;0,571428571428571;1
"8810";9673;58;8810;4;24;37;13;0,428571428571429;0,642857142857143
"8811";9673;58;8811;4;24;41;17;0,428571428571429;0,714285714285714
"8812";9673;58;8812;4;28;41;13;0,5;0,714285714285714
"8813";9673;58;8813;4;28;45;17;0,5;0,785714285714286
"8814";9673;58;8814;4;28;50;22;0,5;0,857142857142857
"8815";9673;58;8815;4;33;45;12;0,571428571428571;0,785714285714286
"8816";9673;58;8816;4;33;50;17;0,571428571428571;0,857142857142857
"8817";9673;58;8817;4;37;50;13;0,642857142857143;0,857142857142857
"8818";9673;58;8818;4;28;54;26;0,5;0,928571428571429
"8819";9673;58;8819;4;33;54;21;0,571428571428571;0,928571428571429
"8820";9673;58;8820;4;37;54;17;0,642857142857143;0,928571428571429
"8821";9673;58;8821;4;41;54;13;0,714285714285714;0,928571428571429
"8822";9673;58;8822;4;37;58;21;0,642857142857143;1
"8823";9673;58;8823;4;33;58;25;0,571428571428571;1
"8824";9673;58;8824;5;25;32;7;0,448275862068966;0,551724137931034
"8825";9673;58;8825;5;27;34;7;0,482758620689655;0,586206896551724
"8826";9673;58;8826;5;3;9;6;0,0689655172413793;0,172413793103448
"8827";9673;58;8827;5;25;34;9;0,448275862068966;0,586206896551724
"8828";9673;58;8828;5;27;36;9;0,482758620689655;0,620689655172414
"8829";9673;58;8829;5;27;38;11;0,482758620689655;0,655172413793103
"8830";9673;58;8830;5;27;40;13;0,482758620689655;0,689655172413793
"8831";9673;58;8831;5;30;36;6;0,517241379310345;0,620689655172414
"8832";9673;58;8832;5;34;40;6;0,586206896551724;0,689655172413793
"8833";9673;58;8833;5;34;42;8;0,586206896551724;0,724137931034483
"8834";9673;58;8834;5;34;44;10;0,586206896551724;0,758620689655172
"8835";9673;58;8835;5;36;42;6;0,620689655172414;0,724137931034483
"8836";9673;58;8836;5;38;44;6;0,655172413793103;0,758620689655172
"8837";9673;58;8837;5;40;46;6;0,689655172413793;0,793103448275862
"8838";9673;58;8838;5;40;48;8;0,689655172413793;0,827586206896552
"8839";9673;58;8839;5;40;50;10;0,689655172413793;0,862068965517241
"8840";9673;58;8840;5;48;54;6;0,827586206896552;0,931034482758621
"8841";9673;58;8841;5;32;38;6;0,551724137931034;0,655172413793103
"8842";9673;58;8842;5;36;44;8;0,620689655172414;0,758620689655172
"8843";9673;58;8843;5;36;46;10;0,620689655172414;0,793103448275862
"8844";9673;58;8844;5;36;48;12;0,620689655172414;0,827586206896552
"8845";9673;58;8845;5;36;50;14;0,620689655172414;0,862068965517241
"8846";9673;58;8846;5;36;52;16;0,620689655172414;0,896551724137931
"8847";9673;58;8847;5;42;48;6;0,724137931034483;0,827586206896552
"8848";9673;58;8848;5;42;50;8;0,724137931034483;0,862068965517241
"8849";9673;58;8849;5;42;52;10;0,724137931034483;0,896551724137931
"8850";9673;58;8850;5;30;38;8;0,517241379310345;0,655172413793103
"8851";9673;58;8851;5;32;40;8;0,551724137931034;0,689655172413793
"8852";9673;58;8852;5;32;42;10;0,551724137931034;0,724137931034483
"8853";9673;58;8853;5;32;44;12;0,551724137931034;0,758620689655172
"8854";9673;58;8854;5;38;46;8;0,655172413793103;0,793103448275862
"8855";9673;58;8855;5;38;48;10;0,655172413793103;0,827586206896552
"8856";9673;58;8856;5;38;50;12;0,655172413793103;0,862068965517241
"8857";9673;58;8857;5;40;52;12;0,689655172413793;0,896551724137931
"8858";9673;58;8858;5;40;54;14;0,689655172413793;0,931034482758621
"8859";9673;58;8859;5;44;50;6;0,758620689655172;0,862068965517241
"8860";9673;58;8860;5;44;52;8;0,758620689655172;0,896551724137931
"8861";9673;58;8861;5;27;42;15;0,482758620689655;0,724137931034483
"8862";9673;58;8862;5;27;44;17;0,482758620689655;0,758620689655172
"8863";9673;58;8863;5;30;40;10;0,517241379310345;0,689655172413793
"8864";9673;58;8864;5;34;46;12;0,586206896551724;0,793103448275862
"8865";9673;58;8865;5;34;48;14;0,586206896551724;0,827586206896552
"8866";9673;58;8866;5;30;42;12;0,517241379310345;0,724137931034483
"8867";9673;58;8867;5;30;44;14;0,517241379310345;0,758620689655172
"8868";9673;58;8868;5;30;46;16;0,517241379310345;0,793103448275862
"8869";9673;58;8869;5;30;48;18;0,517241379310345;0,827586206896552
"8870";9673;58;8870;5;30;50;20;0,517241379310345;0,862068965517241
"8871";9673;58;8871;5;30;52;22;0,517241379310345;0,896551724137931
"8872";9673;58;8872;5;30;54;24;0,517241379310345;0,931034482758621
"8873";9673;58;8873;5;34;50;16;0,586206896551724;0,862068965517241
"8874";9673;58;8874;5;36;54;18;0,620689655172414;0,931034482758621
"8875";9673;58;8875;5;38;52;14;0,655172413793103;0,896551724137931
"8876";9673;58;8876;5;38;54;16;0,655172413793103;0,931034482758621
"8877";9673;58;8877;5;48;56;8;0,827586206896552;0,96551724137931
"8878";9673;58;8878;5;48;58;10;0,827586206896552;1
"8879";9673;58;8879;5;42;54;12;0,724137931034483;0,931034482758621
"8880";9673;58;8880;5;44;54;10;0,758620689655172;0,931034482758621
"8881";9673;58;8881;5;34;52;18;0,586206896551724;0,896551724137931
"8882";9673;58;8882;5;34;54;20;0,586206896551724;0,931034482758621
"8883";9673;58;8883;5;27;46;19;0,482758620689655;0,793103448275862
"8884";9673;58;8884;5;32;46;14;0,551724137931034;0,793103448275862
"8885";9673;58;8885;5;32;48;16;0,551724137931034;0,827586206896552
"8886";9673;58;8886;5;27;48;21;0,482758620689655;0,827586206896552
"8887";9673;58;8887;5;32;50;18;0,551724137931034;0,862068965517241
"8888";9673;58;8888;5;32;52;20;0,551724137931034;0,896551724137931
"8889";9673;58;8889;5;32;54;22;0,551724137931034;0,931034482758621
"8890";9673;58;8890;5;50;56;6;0,862068965517241;0,96551724137931
"8891";9673;58;8891;5;50;58;8;0,862068965517241;1
"8892";9673;58;8892;5;1;7;6;0,0344827586206897;0,137931034482759
"8893";9904;81;8893;4;56;81;25;0,7;1
"8894";9904;81;8894;5;65;77;12;0,8;0,95
"8895";9904;81;8895;5;69;81;12;0,85;1
"8896";9904;81;8896;5;11;24;13;0,15;0,3
"8897";9904;81;8897;5;15;28;13;0,2;0,35
"8898";9904;81;8898;5;20;32;12;0,25;0,4
"8899";9904;81;8899;5;65;81;16;0,8;1
"8900";9904;81;8900;5;56;69;13;0,7;0,85
"8901";9904;81;8901;5;15;32;17;0,2;0,4
"8902";9904;81;8902;5;60;73;13;0,75;0,9
"8903";9904;81;8903;5;60;77;17;0,75;0,95
"8904";9904;81;8904;6;17;23;6;0,219512195121951;0,292682926829268
"8905";9904;81;8905;6;59;65;6;0,731707317073171;0,804878048780488
"8906";9904;81;8906;6;67;73;6;0,829268292682927;0,902439024390244
"8907";9904;81;8907;6;71;77;6;0,878048780487805;0,951219512195122
"8908";9904;81;8908;6;9;15;6;0,121951219512195;0,195121951219512
"8909";9904;81;8909;6;11;17;6;0,146341463414634;0,219512195121951
"8910";9904;81;8910;6;11;19;8;0,146341463414634;0,24390243902439
"8911";9904;81;8911;6;27;33;6;0,341463414634146;0,414634146341463
"8912";9904;81;8912;6;27;35;8;0,341463414634146;0,439024390243902
"8913";9904;81;8913;6;55;61;6;0,682926829268293;0,75609756097561
"8914";9904;81;8914;6;55;63;8;0,682926829268293;0,780487804878049
"8915";9904;81;8915;6;57;63;6;0,707317073170732;0,780487804878049
"8916";9904;81;8916;6;57;65;8;0,707317073170732;0,804878048780488
"8917";9904;81;8917;6;67;75;8;0,829268292682927;0,926829268292683
"8918";9904;81;8918;6;67;77;10;0,829268292682927;0,951219512195122
"8919";9904;81;8919;6;71;79;8;0,878048780487805;0,975609756097561
"8920";9904;81;8920;6;19;25;6;0,24390243902439;0,317073170731707
"8921";9904;81;8921;6;23;29;6;0,292682926829268;0,365853658536585
"8922";9904;81;8922;6;23;31;8;0,292682926829268;0,390243902439024
"8923";9904;81;8923;6;25;31;6;0,317073170731707;0,390243902439024
"8924";9904;81;8924;6;29;35;6;0,365853658536585;0,439024390243902
"8925";9904;81;8925;6;65;71;6;0,804878048780488;0,878048780487805
"8926";9904;81;8926;6;65;73;8;0,804878048780488;0,902439024390244
"8927";9904;81;8927;6;67;79;12;0,829268292682927;0,975609756097561
"8928";9904;81;8928;6;67;81;14;0,829268292682927;1
"8929";9904;81;8929;6;69;75;6;0,853658536585366;0,926829268292683
"8930";9904;81;8930;6;69;77;8;0,853658536585366;0,951219512195122
"8931";9904;81;8931;6;69;79;10;0,853658536585366;0,975609756097561
"8932";9904;81;8932;6;71;81;10;0,878048780487805;1
"8933";9904;81;8933;6;17;25;8;0,219512195121951;0,317073170731707
"8934";9904;81;8934;6;25;33;8;0,317073170731707;0,414634146341463
"8935";9904;81;8935;6;25;35;10;0,317073170731707;0,439024390243902
"8936";9904;81;8936;6;69;81;12;0,853658536585366;1
"8937";9904;81;8937;6;9;17;8;0,121951219512195;0,219512195121951
"8938";9904;81;8938;6;55;65;10;0,682926829268293;0,804878048780488
"8939";9904;81;8939;6;57;67;10;0,707317073170732;0,829268292682927
"8940";9904;81;8940;6;59;67;8;0,731707317073171;0,829268292682927
"8941";9904;81;8941;6;65;75;10;0,804878048780488;0,926829268292683
"8942";9904;81;8942;6;65;77;12;0,804878048780488;0,951219512195122
"8943";9904;81;8943;6;65;79;14;0,804878048780488;0,975609756097561
"8944";9904;81;8944;6;65;81;16;0,804878048780488;1
"8945";9904;81;8945;6;13;19;6;0,170731707317073;0,24390243902439
"8946";9904;81;8946;6;15;21;6;0,195121951219512;0,268292682926829
"8947";9904;81;8947;6;15;23;8;0,195121951219512;0,292682926829268
"8948";9904;81;8948;6;59;69;10;0,731707317073171;0,853658536585366
"8949";9904;81;8949;6;19;27;8;0,24390243902439;0,341463414634146
"8950";9904;81;8950;6;23;33;10;0,292682926829268;0,414634146341463
"8951";9904;81;8951;6;57;69;12;0,707317073170732;0,853658536585366
"8952";9904;81;8952;6;61;67;6;0,75609756097561;0,829268292682927
"8953";9904;81;8953;6;21;27;6;0,268292682926829;0,341463414634146
"8954";9904;81;8954;6;13;21;8;0,170731707317073;0,268292682926829
"8955";10022;81;8955;3;32;81;49;0,4;1
"8956";10022;81;8956;4;56;81;25;0,7;1
"8957";10022;81;8957;4;48;73;25;0,6;0,9
"8958";10022;81;8958;4;15;40;25;0,2;0,5
"8959";10022;81;8959;4;40;65;25;0,5;0,8
"8960";10022;81;8960;4;32;56;24;0,4;0,7
"8961";10022;81;8961;5;60;73;13;0,75;0,9
"8962";10022;81;8962;5;32;44;12;0,4;0,55
"8963";10022;81;8963;5;69;81;12;0,85;1
"8964";10022;81;8964;5;36;48;12;0,45;0,6
"8965";10022;81;8965;5;44;56;12;0,55;0,7
"8966";10022;81;8966;5;28;40;12;0,35;0,5
"8967";10022;81;8967;5;52;65;13;0,65;0,8
"8968";10022;81;8968;5;40;52;12;0,5;0,65
"8969";10022;81;8969;5;48;60;12;0,6;0,75
"8970";10022;81;8970;5;65;77;12;0,8;0,95
"8971";10022;81;8971;5;65;81;16;0,8;1
"8972";10022;81;8972;5;20;32;12;0,25;0,4
"8973";10022;81;8973;5;48;65;17;0,6;0,8
"8974";10022;81;8974;5;52;69;17;0,65;0,85
"8975";10022;81;8975;5;56;69;13;0,7;0,85
"8976";10022;81;8976;5;60;77;17;0,75;0,95
"8977";10022;81;8977;5;32;48;16;0,4;0,6
"8978";10022;81;8978;5;60;81;21;0,75;1
"8979";10022;81;8979;5;40;56;16;0,5;0,7
"8980";10022;81;8980;6;55;61;6;0,682926829268293;0,75609756097561
"8981";10022;81;8981;6;21;27;6;0,268292682926829;0,341463414634146
"8982";10022;81;8982;6;67;73;6;0,829268292682927;0,902439024390244
"8983";10022;81;8983;6;69;75;6;0,853658536585366;0,926829268292683
"8984";10022;81;8984;6;23;29;6;0,292682926829268;0,365853658536585
"8985";10022;81;8985;6;33;39;6;0,414634146341463;0,48780487804878
"8986";10022;81;8986;6;39;45;6;0,48780487804878;0,560975609756098
"8987";10022;81;8987;6;45;51;6;0,560975609756098;0,634146341463415
"8988";10022;81;8988;6;47;53;6;0,585365853658537;0,658536585365854
"8989";10022;81;8989;6;57;63;6;0,707317073170732;0,780487804878049
"8990";10022;81;8990;6;65;71;6;0,804878048780488;0,878048780487805
"8991";10022;81;8991;6;35;41;6;0,439024390243902;0,51219512195122
"8992";10022;81;8992;6;41;47;6;0,51219512195122;0,585365853658537
"8993";10022;81;8993;6;31;37;6;0,390243902439024;0,463414634146341
"8994";10022;81;8994;6;63;69;6;0,780487804878049;0,853658536585366
"8995";10022;81;8995;6;63;71;8;0,780487804878049;0,878048780487805
"8996";10022;81;8996;6;65;73;8;0,804878048780488;0,902439024390244
"8997";10022;81;8997;6;53;59;6;0,658536585365854;0,731707317073171
"8998";10022;81;8998;6;65;75;10;0,804878048780488;0,926829268292683
"8999";10022;81;8999;6;67;75;8;0,829268292682927;0,926829268292683
"9000";10022;81;9000;6;67;77;10;0,829268292682927;0,951219512195122
"9001";10022;81;9001;6;69;77;8;0,853658536585366;0,951219512195122
"9002";10022;81;9002;6;71;77;6;0,878048780487805;0,951219512195122
"9003";10022;81;9003;6;25;31;6;0,317073170731707;0,390243902439024
"9004";10022;81;9004;6;55;63;8;0,682926829268293;0,780487804878049
"9005";10022;81;9005;6;1;7;6;0,024390243902439;0,0975609756097561
"9006";10022;81;9006;6;63;73;10;0,780487804878049;0,902439024390244
"9007";10022;81;9007;6;63;75;12;0,780487804878049;0,926829268292683
"9008";10022;81;9008;6;63;77;14;0,780487804878049;0,951219512195122
"9009";10022;81;9009;6;63;79;16;0,780487804878049;0,975609756097561
"9010";10022;81;9010;6;65;77;12;0,804878048780488;0,951219512195122
"9011";10022;81;9011;6;65;79;14;0,804878048780488;0,975609756097561
"9012";10022;81;9012;6;65;81;16;0,804878048780488;1
"9013";10022;81;9013;6;67;79;12;0,829268292682927;0,975609756097561
"9014";10022;81;9014;6;67;81;14;0,829268292682927;1
"9015";10022;81;9015;6;69;79;10;0,853658536585366;0,975609756097561
"9016";10022;81;9016;6;71;79;8;0,878048780487805;0,975609756097561
"9017";10022;81;9017;6;71;81;10;0,878048780487805;1
"9018";10022;81;9018;6;73;79;6;0,902439024390244;0,975609756097561
"9019";10022;81;9019;6;69;81;12;0,853658536585366;1
"9020";10022;81;9020;6;73;81;8;0,902439024390244;1
"9021";10022;81;9021;6;63;81;18;0,780487804878049;1
"9022";10022;81;9022;6;49;55;6;0,609756097560976;0,682926829268293
"9023";10022;81;9023;6;53;61;8;0,658536585365854;0,75609756097561
"9024";10022;81;9024;6;59;65;6;0,731707317073171;0,804878048780488
"9025";10022;81;9025;6;59;67;8;0,731707317073171;0,829268292682927
"9026";10022;81;9026;6;43;49;6;0,536585365853659;0,609756097560976
"9027";10022;81;9027;6;43;51;8;0,536585365853659;0,634146341463415
"9028";10022;81;9028;6;47;55;8;0,585365853658537;0,682926829268293
"9029";10022;81;9029;6;37;43;6;0,463414634146341;0,536585365853659
"9030";10022;81;9030;6;51;57;6;0,634146341463415;0,707317073170732
"9031";10022;81;9031;6;61;67;6;0,75609756097561;0,829268292682927
"9032";10022;81;9032;6;17;23;6;0,219512195121951;0,292682926829268
"9033";10022;81;9033;6;33;41;8;0,414634146341463;0,51219512195122
"9034";10022;81;9034;6;39;47;8;0,48780487804878;0,585365853658537
"9035";10022;81;9035;6;31;39;8;0,390243902439024;0,48780487804878
"9036";10022;81;9036;6;51;59;8;0,634146341463415;0,731707317073171
"9037";10022;81;9037;6;41;49;8;0,51219512195122;0,609756097560976
"9038";10022;81;9038;6;53;63;10;0,658536585365854;0,780487804878049
"9039";10022;81;9039;6;23;31;8;0,292682926829268;0,390243902439024
"9040";10022;81;9040;6;61;69;8;0,75609756097561;0,853658536585366
"9041";10022;81;9041;6;61;71;10;0,75609756097561;0,878048780487805
"9042";10022;81;9042;6;45;53;8;0,560975609756098;0,658536585365854
"9043";10505;133;9043;5;108;133;25;0,8125;1
"9044";10505;133;9044;6;117;129;12;0,878787878787879;0,96969696969697
"9045";10505;133;9045;6;60;72;12;0,454545454545455;0,545454545454545
"9046";10505;133;9046;6;113;125;12;0,848484848484849;0,939393939393939
"9047";10505;133;9047;6;109;121;12;0,818181818181818;0,909090909090909
"9048";10505;133;9048;6;113;129;16;0,848484848484849;0,96969696969697
"9049";10505;133;9049;6;121;133;12;0,909090909090909;1
"9050";10505;133;9050;6;117;133;16;0,878787878787879;1
"9051";10505;133;9051;6;109;125;16;0,818181818181818;0,939393939393939
"9052";10505;133;9052;6;109;129;20;0,818181818181818;0,96969696969697
"9053";10505;133;9053;6;80;92;12;0,606060606060606;0,696969696969697
"9054";10733;160;9054;5;120;144;24;0,75;0,9
"9055";10733;160;9055;5;120;152;32;0,75;0,95
"9056";10733;160;9056;5;120;160;40;0,75;1
"9057";10733;160;9057;5;128;152;24;0,8;0,95
"9058";10733;160;9058;5;128;160;32;0,8;1
"9059";10733;160;9059;5;136;160;24;0,85;1
"9060";10733;160;9060;5;80;104;24;0,5;0,65
"9061";10733;160;9061;5;23;47;24;0,15;0,3
"9062";10733;160;9062;5;71;96;25;0,45;0,6
"9063";10733;160;9063;6;128;140;12;0,8;0,875
"9064";10733;160;9064;6;132;144;12;0,825;0,9
"9065";10733;160;9065;6;132;148;16;0,825;0,925
"9066";10733;160;9066;6;132;152;20;0,825;0,95
"9067";10733;160;9067;6;140;152;12;0,875;0,95
"9068";10733;160;9068;6;140;156;16;0,875;0,975
"9069";10733;160;9069;6;144;156;12;0,9;0,975
"9070";10733;160;9070;6;144;160;16;0,9;1
"9071";10733;160;9071;6;148;160;12;0,925;1
"9072";10733;160;9072;6;75;88;13;0,475;0,55
"9073";10733;160;9073;6;80;92;12;0,5;0,575
"9074";10733;160;9074;6;128;144;16;0,8;0,9
"9075";10733;160;9075;6;128;148;20;0,8;0,925
"9076";10733;160;9076;6;136;148;12;0,85;0,925
"9077";10733;160;9077;6;136;152;16;0,85;0,95
"9078";10733;160;9078;6;92;104;12;0,575;0,65
"9079";10733;160;9079;6;136;156;20;0,85;0,975
"9080";10733;160;9080;6;96;108;12;0,6;0,675
"9081";10733;160;9081;6;132;156;24;0,825;0,975
"9082";10733;160;9082;6;132;160;28;0,825;1
"9083";10733;160;9083;6;136;160;24;0,85;1
"9084";10733;160;9084;6;140;160;20;0,875;1
"9085";10733;160;9085;6;128;152;24;0,8;0,95
"9086";10733;160;9086;6;128;156;28;0,8;0,975
"9087";10733;160;9087;6;128;160;32;0,8;1
"9088";10733;160;9088;6;31;43;12;0,2;0,275
"9089";10733;160;9089;6;120;132;12;0,75;0,825
"9090";10733;160;9090;6;124;136;12;0,775;0,85
"9091";10733;160;9091;6;124;140;16;0,775;0,875
"9092";10733;160;9092;6;71;84;13;0,45;0,525
"9093";10733;160;9093;6;27;39;12;0,175;0,25
"9094";10733;160;9094;6;84;96;12;0,525;0,6
"9095";10733;160;9095;6;39;51;12;0,25;0,325
"9096";10733;160;9096;6;23;35;12;0,15;0,225
"9097";10733;160;9097;6;116;128;12;0,725;0,8
"9098";10733;160;9098;6;11;23;12;0,075;0,15
"9099";10782;126;9099;4;101;126;25;0,8;1
"9100";10782;126;9100;4;92;118;26;0,733333333333333;0,933333333333333
"9101";10782;126;9101;4;24;50;26;0,2;0,4
"9102";10782;126;9102;4;75;101;26;0,6;0,8
"9103";10782;126;9103;4;84;109;25;0,666666666666667;0,866666666666667
"9104";10782;126;9104;5;28;40;12;0,225806451612903;0,32258064516129
"9105";10782;126;9105;5;106;118;12;0,838709677419355;0,935483870967742
"9106";10782;126;9106;5;81;93;12;0,645161290322581;0,741935483870968
"9107";10782;126;9107;5;93;106;13;0,741935483870968;0,838709677419355
"9108";10782;126;9108;5;97;110;13;0,774193548387097;0,870967741935484
"9109";10782;126;9109;5;106;122;16;0,838709677419355;0,967741935483871
"9110";10782;126;9110;5;110;122;12;0,870967741935484;0,967741935483871
"9111";10782;126;9111;5;114;126;12;0,903225806451613;1
"9112";10782;126;9112;5;110;126;16;0,870967741935484;1
"9113";10782;126;9113;5;24;36;12;0,193548387096774;0,290322580645161
"9114";10782;126;9114;5;19;32;13;0,161290322580645;0,258064516129032
"9115";10782;126;9115;5;89;101;12;0,709677419354839;0,806451612903226
"9116";10782;126;9116;5;101;114;13;0,806451612903226;0,903225806451613
"9117";10782;126;9117;5;15;28;13;0,129032258064516;0,225806451612903
"9118";10782;126;9118;5;32;44;12;0,258064516129032;0,354838709677419
"9119";10782;126;9119;5;77;89;12;0,612903225806452;0,709677419354839
"9120";10782;126;9120;5;36;48;12;0,290322580645161;0,387096774193548
"9121";10782;126;9121;5;3;15;12;0,032258064516129;0,129032258064516
"9122";10782;126;9122;5;85;97;12;0,67741935483871;0,774193548387097
"9123";10782;126;9123;5;101;118;17;0,806451612903226;0,935483870967742
"9124";10782;126;9124;5;106;126;20;0,838709677419355;1
"9125";10782;126;9125;6;39;45;6;0,317460317460317;0,365079365079365
"9126";10782;126;9126;6;5;11;6;0,0476190476190476;0,0952380952380952
"9127";10782;126;9127;6;25;31;6;0,206349206349206;0,253968253968254
"9128";10782;126;9128;6;104;110;6;0,825396825396825;0,873015873015873
"9129";10782;126;9129;6;104;112;8;0,825396825396825;0,888888888888889
"9130";10782;126;9130;6;106;112;6;0,841269841269841;0,888888888888889
"9131";10782;126;9131;6;114;120;6;0,904761904761905;0,952380952380952
"9132";10782;126;9132;6;116;122;6;0,920634920634921;0,968253968253968
"9133";10782;126;9133;6;120;126;6;0,952380952380952;1
"9134";10782;126;9134;6;19;25;6;0,158730158730159;0,206349206349206
"9135";10782;126;9135;6;21;27;6;0,174603174603175;0,222222222222222
"9136";10782;126;9136;6;27;33;6;0,222222222222222;0,26984126984127
"9137";10782;126;9137;6;29;35;6;0,238095238095238;0,285714285714286
"9138";10782;126;9138;6;41;47;6;0,333333333333333;0,380952380952381
"9139";10782;126;9139;6;76;82;6;0,603174603174603;0,650793650793651
"9140";10782;126;9140;6;76;84;8;0,603174603174603;0,666666666666667
"9141";10782;126;9141;6;96;102;6;0,761904761904762;0,80952380952381
"9142";10782;126;9142;6;33;39;6;0,26984126984127;0,317460317460317
"9143";10782;126;9143;6;72;78;6;0,571428571428571;0,619047619047619
"9144";10782;126;9144;6;37;43;6;0,301587301587302;0,349206349206349
"9145";10782;126;9145;6;74;80;6;0,587301587301587;0,634920634920635
"9146";10782;126;9146;6;118;124;6;0,936507936507937;0,984126984126984
"9147";10782;126;9147;6;9;15;6;0,0793650793650794;0,126984126984127
"9148";10782;126;9148;6;43;49;6;0,349206349206349;0,396825396825397
"9149";10782;126;9149;6;43;51;8;0,349206349206349;0,412698412698413
"9150";10782;126;9150;6;45;51;6;0,365079365079365;0,412698412698413
"9151";10782;126;9151;6;92;98;6;0,73015873015873;0,777777777777778
"9152";10782;126;9152;6;94;100;6;0,746031746031746;0,793650793650794
"9153";10782;126;9153;6;94;102;8;0,746031746031746;0,80952380952381
"9154";10782;126;9154;6;114;122;8;0,904761904761905;0,968253968253968
"9155";10782;126;9155;6;114;124;10;0,904761904761905;0,984126984126984
"9156";10782;126;9156;6;116;124;8;0,920634920634921;0,984126984126984
"9157";10782;126;9157;6;17;23;6;0,142857142857143;0,19047619047619
"9158";10782;126;9158;6;7;13;6;0,0634920634920635;0,111111111111111
"9159";10782;126;9159;6;23;29;6;0,19047619047619;0,238095238095238
"9160";10782;126;9160;6;102;108;6;0,80952380952381;0,857142857142857
"9161";10782;126;9161;6;39;47;8;0,317460317460317;0,380952380952381
"9162";10782;126;9162;6;98;104;6;0,777777777777778;0,825396825396825
"9163";10782;126;9163;6;100;106;6;0,793650793650794;0,841269841269841
"9164";10782;126;9164;6;102;110;8;0,80952380952381;0,873015873015873
"9165";10782;126;9165;6;59;66;7;0,476190476190476;0,523809523809524
"9166";10782;126;9166;6;53;59;6;0,428571428571429;0,476190476190476
"9167";10782;126;9167;6;110;116;6;0,873015873015873;0,920634920634921
"9168";10782;126;9168;6;112;118;6;0,888888888888889;0,936507936507937
"9169";10782;126;9169;6;41;49;8;0,333333333333333;0,396825396825397
"9170";10782;126;9170;6;90;96;6;0,714285714285714;0,761904761904762
"9171";10782;126;9171;6;35;41;6;0,285714285714286;0,333333333333333
"9172";10782;126;9172;6;78;84;6;0,619047619047619;0,666666666666667
"9173";10782;126;9173;6;3;9;6;0,0317460317460317;0,0793650793650794
"9174";10782;126;9174;6;118;126;8;0,936507936507937;1
"9175";10782;126;9175;6;31;37;6;0,253968253968254;0,301587301587302
"9176";10782;126;9176;6;55;61;6;0,444444444444444;0,492063492063492
"9177";10782;126;9177;6;70;76;6;0,555555555555556;0,603174603174603
"9178";10782;126;9178;6;33;41;8;0,26984126984127;0,333333333333333
"9179";10782;126;9179;6;98;106;8;0,777777777777778;0,841269841269841
"9180";10782;126;9180;6;92;100;8;0,73015873015873;0,793650793650794
"9181";10822;75;9181;3;18;75;57;0,25;1
"9182";10822;75;9182;4;50;75;25;0,666666666666667;1
"9183";10822;75;9183;4;41;67;26;0,555555555555556;0,888888888888889
"9184";10822;75;9184;5;11;23;12;0,157894736842105;0,315789473684211
"9185";10822;75;9185;5;51;63;12;0,684210526315789;0,842105263157895
"9186";10822;75;9186;5;59;71;12;0,789473684210526;0,947368421052632
"9187";10822;75;9187;5;7;19;12;0,105263157894737;0,263157894736842
"9188";10822;75;9188;5;7;23;16;0,105263157894737;0,315789473684211
"9189";10822;75;9189;5;7;27;20;0,105263157894737;0,368421052631579
"9190";10822;75;9190;5;7;31;24;0,105263157894737;0,421052631578947
"9191";10822;75;9191;5;11;27;16;0,157894736842105;0,368421052631579
"9192";10822;75;9192;5;11;31;20;0,157894736842105;0,421052631578947
"9193";10822;75;9193;5;51;67;16;0,684210526315789;0,894736842105263
"9194";10822;75;9194;5;55;67;12;0,736842105263158;0,894736842105263
"9195";10822;75;9195;5;35;47;12;0,473684210526316;0,631578947368421
"9196";10822;75;9196;5;47;59;12;0,631578947368421;0,789473684210526
"9197";10822;75;9197;5;47;63;16;0,631578947368421;0,842105263157895
"9198";10822;75;9198;5;51;71;20;0,684210526315789;0,947368421052632
"9199";10822;75;9199;5;51;75;24;0,684210526315789;1
"9200";10822;75;9200;5;55;71;16;0,736842105263158;0,947368421052632
"9201";10822;75;9201;5;55;75;20;0,736842105263158;1
"9202";10822;75;9202;5;59;75;16;0,789473684210526;1
"9203";10822;75;9203;5;63;75;12;0,842105263157895;1
"9204";10822;75;9204;5;3;15;12;0,0526315789473684;0,210526315789474
"9205";10822;75;9205;5;47;67;20;0,631578947368421;0,894736842105263
"9206";10822;75;9206;5;47;71;24;0,631578947368421;0,947368421052632
"9207";10822;75;9207;5;47;75;28;0,631578947368421;1
"9208";10822;75;9208;5;31;43;12;0,421052631578947;0,578947368421053
"9209";10822;75;9209;5;3;19;16;0,0526315789473684;0,263157894736842
"9210";10822;75;9210;6;3;9;6;0,0526315789473684;0,131578947368421
"9211";10822;75;9211;6;9;15;6;0,131578947368421;0,210526315789474
"9212";10822;75;9212;6;25;31;6;0,342105263157895;0,421052631578947
"9213";10822;75;9213;6;37;43;6;0,5;0,578947368421053
"9214";10822;75;9214;6;49;55;6;0,657894736842105;0,736842105263158
"9215";10822;75;9215;6;59;65;6;0,789473684210526;0,868421052631579
"9216";10822;75;9216;6;63;69;6;0,842105263157895;0,921052631578947
"9217";10822;75;9217;6;1;7;6;0,0263157894736842;0,105263157894737
"9218";10822;75;9218;6;1;9;8;0,0263157894736842;0,131578947368421
"9219";10822;75;9219;6;9;17;8;0,131578947368421;0,236842105263158
"9220";10822;75;9220;6;9;19;10;0,131578947368421;0,263157894736842
"9221";10822;75;9221;6;9;21;12;0,131578947368421;0,289473684210526
"9222";10822;75;9222;6;43;49;6;0,578947368421053;0,657894736842105
"9223";10822;75;9223;6;49;57;8;0,657894736842105;0,763157894736842
"9224";10822;75;9224;6;49;59;10;0,657894736842105;0,789473684210526
"9225";10822;75;9225;6;51;57;6;0,684210526315789;0,763157894736842
"9226";10822;75;9226;6;51;59;8;0,684210526315789;0,789473684210526
"9227";10822;75;9227;6;53;59;6;0,710526315789474;0,789473684210526
"9228";10822;75;9228;6;55;61;6;0,736842105263158;0,815789473684211
"9229";10822;75;9229;6;55;63;8;0,736842105263158;0,842105263157895
"9230";10822;75;9230;6;55;65;10;0,736842105263158;0,868421052631579
"9231";10822;75;9231;6;57;63;6;0,763157894736842;0,842105263157895
"9232";10822;75;9232;6;57;65;8;0,763157894736842;0,868421052631579
"9233";10822;75;9233;6;57;67;10;0,763157894736842;0,894736842105263
"9234";10822;75;9234;6;59;67;8;0,789473684210526;0,894736842105263
"9235";10822;75;9235;6;59;69;10;0,789473684210526;0,921052631578947
"9236";10822;75;9236;6;59;71;12;0,789473684210526;0,947368421052632
"9237";10822;75;9237;6;63;71;8;0,842105263157895;0,947368421052632
"9238";10822;75;9238;6;63;73;10;0,842105263157895;0,973684210526316
"9239";10822;75;9239;6;9;23;14;0,131578947368421;0,315789473684211
"9240";10822;75;9240;6;49;61;12;0,657894736842105;0,815789473684211
"9241";10822;75;9241;6;51;61;10;0,684210526315789;0,815789473684211
"9242";10822;75;9242;6;51;63;12;0,684210526315789;0,842105263157895
"9243";10822;75;9243;6;53;61;8;0,710526315789474;0,815789473684211
"9244";10822;75;9244;6;53;63;10;0,710526315789474;0,842105263157895
"9245";10822;75;9245;6;53;65;12;0,710526315789474;0,868421052631579
"9246";10822;75;9246;6;53;67;14;0,710526315789474;0,894736842105263
"9247";10822;75;9247;6;53;69;16;0,710526315789474;0,921052631578947
"9248";10822;75;9248;6;53;71;18;0,710526315789474;0,947368421052632
"9249";10822;75;9249;6;53;73;20;0,710526315789474;0,973684210526316
"9250";10822;75;9250;6;55;67;12;0,736842105263158;0,894736842105263
"9251";10822;75;9251;6;55;69;14;0,736842105263158;0,921052631578947
"9252";10822;75;9252;6;55;71;16;0,736842105263158;0,947368421052632
"9253";10822;75;9253;6;55;73;18;0,736842105263158;0,973684210526316
"9254";10822;75;9254;6;57;69;12;0,763157894736842;0,921052631578947
"9255";10822;75;9255;6;35;41;6;0,473684210526316;0,552631578947368
"9256";10822;75;9256;6;51;65;14;0,684210526315789;0,868421052631579
"9257";10822;75;9257;6;59;73;14;0,789473684210526;0,973684210526316
"9258";10822;75;9258;6;59;75;16;0,789473684210526;1
"9259";10822;75;9259;6;63;75;12;0,842105263157895;1
"9260";10822;75;9260;6;69;75;6;0,921052631578947;1
"9261";10822;75;9261;6;33;39;6;0,447368421052632;0,526315789473684
"9262";10822;75;9262;6;9;25;16;0,131578947368421;0,342105263157895
"9263";10822;75;9263;6;9;27;18;0,131578947368421;0,368421052631579
"9264";10822;75;9264;6;9;29;20;0,131578947368421;0,394736842105263
"9265";10822;75;9265;6;51;67;16;0,684210526315789;0,894736842105263
"9266";10822;75;9266;6;51;69;18;0,684210526315789;0,921052631578947
"9267";10822;75;9267;6;51;71;20;0,684210526315789;0,947368421052632
"9268";10822;75;9268;6;51;73;22;0,684210526315789;0,973684210526316
"9269";10822;75;9269;6;55;75;20;0,736842105263158;1
"9270";10822;75;9270;6;35;43;8;0,473684210526316;0,578947368421053
"9271";10822;75;9271;6;3;11;8;0,0526315789473684;0,157894736842105
"9272";10822;75;9272;6;9;31;22;0,131578947368421;0,421052631578947
"9273";10822;75;9273;6;51;75;24;0,684210526315789;1
"9274";10822;75;9274;6;57;71;14;0,763157894736842;0,947368421052632
"9275";10822;75;9275;6;57;73;16;0,763157894736842;0,973684210526316
"9276";10822;75;9276;6;57;75;18;0,763157894736842;1
"9277";10822;75;9277;6;53;75;22;0,710526315789474;1
"9278";10822;75;9278;6;31;37;6;0,421052631578947;0,5
"9279";10822;75;9279;6;49;63;14;0,657894736842105;0,842105263157895
"9280";10822;75;9280;6;49;65;16;0,657894736842105;0,868421052631579
"9281";10822;75;9281;6;49;67;18;0,657894736842105;0,894736842105263
"9282";10822;75;9282;6;49;69;20;0,657894736842105;0,921052631578947
"9283";10822;75;9283;6;49;71;22;0,657894736842105;0,947368421052632
"9284";10822;75;9284;6;37;45;8;0,5;0,605263157894737
"9285";10822;75;9285;6;37;47;10;0,5;0,631578947368421
"9286";11082;102;9286;4;59;85;26;0,583333333333333;0,833333333333333
"9287";11082;102;9287;4;50;76;26;0,5;0,75
"9288";11082;102;9288;5;57;69;12;0,56;0,68
"9289";11082;102;9289;5;57;73;16;0,56;0,72
"9290";11082;102;9290;5;61;73;12;0,6;0,72
"9291";11082;102;9291;5;65;77;12;0,64;0,76
"9292";11082;102;9292;5;90;102;12;0,88;1
"9293";11082;102;9293;5;53;65;12;0,52;0,64
"9294";11082;102;9294;5;57;77;20;0,56;0,76
"9295";11082;102;9295;5;61;77;16;0,6;0,76
"9296";11082;102;9296;5;73;86;13;0,72;0,84
"9297";11082;102;9297;5;53;69;16;0,52;0,68
"9298";11082;102;9298;6;60;66;6;0,588235294117647;0,647058823529412
"9299";11082;102;9299;6;62;68;6;0,607843137254902;0,666666666666667
"9300";11082;102;9300;6;70;76;6;0,686274509803922;0,745098039215686
"9301";11082;102;9301;6;72;78;6;0,705882352941177;0,764705882352941
"9302";11082;102;9302;6;78;84;6;0,764705882352941;0,823529411764706
"9303";11082;102;9303;6;78;86;8;0,764705882352941;0,843137254901961
"9304";11082;102;9304;6;80;86;6;0,784313725490196;0,843137254901961
"9305";11082;102;9305;6;88;94;6;0,862745098039216;0,92156862745098
"9306";11082;102;9306;6;90;96;6;0,882352941176471;0,941176470588235
"9307";11082;102;9307;6;1;7;6;0,0196078431372549;0,0784313725490196
"9308";11082;102;9308;6;58;64;6;0,568627450980392;0,627450980392157
"9309";11082;102;9309;6;60;68;8;0,588235294117647;0,666666666666667
"9310";11082;102;9310;6;60;70;10;0,588235294117647;0,686274509803922
"9311";11082;102;9311;6;60;72;12;0,588235294117647;0,705882352941177
"9312";11082;102;9312;6;62;70;8;0,607843137254902;0,686274509803922
"9313";11082;102;9313;6;62;72;10;0,607843137254902;0,705882352941177
"9314";11082;102;9314;6;62;74;12;0,607843137254902;0,725490196078431
"9315";11082;102;9315;6;66;72;6;0,647058823529412;0,705882352941177
"9316";11082;102;9316;6;66;74;8;0,647058823529412;0,725490196078431
"9317";11082;102;9317;6;66;76;10;0,647058823529412;0,745098039215686
"9318";11082;102;9318;6;68;74;6;0,666666666666667;0,725490196078431
"9319";11082;102;9319;6;68;76;8;0,666666666666667;0,745098039215686
"9320";11082;102;9320;6;90;98;8;0,882352941176471;0,96078431372549
"9321";11082;102;9321;6;90;100;10;0,882352941176471;0,980392156862745
"9322";11082;102;9322;6;92;98;6;0,901960784313726;0,96078431372549
"9323";11082;102;9323;6;92;100;8;0,901960784313726;0,980392156862745
"9324";11082;102;9324;6;94;100;6;0,92156862745098;0,980392156862745
"9325";11082;102;9325;6;76;82;6;0,745098039215686;0,803921568627451
"9326";11082;102;9326;6;90;102;12;0,882352941176471;1
"9327";11082;102;9327;6;92;102;10;0,901960784313726;1
"9328";11082;102;9328;6;94;102;8;0,92156862745098;1
"9329";11082;102;9329;6;96;102;6;0,941176470588235;1
"9330";11082;102;9330;6;60;74;14;0,588235294117647;0,725490196078431
"9331";11082;102;9331;6;60;76;16;0,588235294117647;0,745098039215686
"9332";11082;102;9332;6;62;76;14;0,607843137254902;0,745098039215686
"9333";11082;102;9333;6;27;33;6;0,274509803921569;0,333333333333333
"9334";11082;102;9334;6;1;9;8;0,0196078431372549;0,0980392156862745
"9335";11082;102;9335;6;29;35;6;0,294117647058824;0,352941176470588
"9336";11082;102;9336;6;41;47;6;0,411764705882353;0,470588235294118
"9337";11082;102;9337;6;58;66;8;0,568627450980392;0,647058823529412
"9338";11082;102;9338;6;58;68;10;0,568627450980392;0,666666666666667
"9339";11082;102;9339;6;64;70;6;0,627450980392157;0,686274509803922
"9340";11082;102;9340;6;64;72;8;0,627450980392157;0,705882352941177
"9341";11082;102;9341;6;52;58;6;0,509803921568627;0,568627450980392
"9342";11082;102;9342;6;64;74;10;0,627450980392157;0,725490196078431
"9343";11082;102;9343;6;64;76;12;0,627450980392157;0,745098039215686
"9344";11082;102;9344;6;80;88;8;0,784313725490196;0,862745098039216
"9345";11082;102;9345;6;56;62;6;0,549019607843137;0,607843137254902
"9346";11082;102;9346;6;58;70;12;0,568627450980392;0,686274509803922
"9347";11082;102;9347;6;74;80;6;0,725490196078431;0,784313725490196
"9348";11082;102;9348;6;82;88;6;0,803921568627451;0,862745098039216
"9349";11082;102;9349;6;25;31;6;0,254901960784314;0,313725490196078
"9350";11082;102;9350;6;88;96;8;0,862745098039216;0,941176470588235
"9351";11082;102;9351;6;88;98;10;0,862745098039216;0,96078431372549
"9352";11082;102;9352;6;88;100;12;0,862745098039216;0,980392156862745
"9353";11082;102;9353;6;88;102;14;0,862745098039216;1
"9354";11082;102;9354;6;39;45;6;0,392156862745098;0,450980392156863
"9355";11082;102;9355;6;58;72;14;0,568627450980392;0,705882352941177
"9356";11082;102;9356;6;58;74;16;0,568627450980392;0,725490196078431
"9357";11082;102;9357;6;58;76;18;0,568627450980392;0,745098039215686
"9358";11082;102;9358;6;54;60;6;0,529411764705882;0,588235294117647
"9359";11082;102;9359;6;76;84;8;0,745098039215686;0,823529411764706
"9360";11082;102;9360;6;56;64;8;0,549019607843137;0,627450980392157
"9361";11082;102;9361;6;49;56;7;0,490196078431373;0,549019607843137
"9362";11082;102;9362;6;3;9;6;0,0392156862745098;0,0980392156862745
"9363";11082;102;9363;6;27;35;8;0,274509803921569;0,352941176470588
"9364";11082;102;9364;6;56;66;10;0,549019607843137;0,647058823529412
"9365";11082;102;9365;6;56;68;12;0,549019607843137;0,666666666666667
"9366";11164;76;9366;4;25;50;25;0,333333333333333;0,666666666666667
"9367";11164;76;9367;5;60;72;12;0,789473684210526;0,947368421052632
"9368";11164;76;9368;5;60;76;16;0,789473684210526;1
"9369";11164;76;9369;5;64;76;12;0,842105263157895;1
"9370";11164;76;9370;5;35;48;13;0,473684210526316;0,631578947368421
"9371";11164;76;9371;5;31;44;13;0,421052631578947;0,578947368421053
"9372";11164;76;9372;5;48;60;12;0,631578947368421;0,789473684210526
"9373";11164;76;9373;5;44;56;12;0,578947368421053;0,736842105263158
"9374";11164;76;9374;5;40;52;12;0,526315789473684;0,684210526315789
"9375";11164;76;9375;5;27;40;13;0,368421052631579;0,526315789473684
"9376";11164;76;9376;6;60;66;6;0,789473684210526;0,868421052631579
"9377";11164;76;9377;6;60;68;8;0,789473684210526;0,894736842105263
"9378";11164;76;9378;6;64;70;6;0,842105263157895;0,921052631578947
"9379";11164;76;9379;6;68;74;6;0,894736842105263;0,973684210526316
"9380";11164;76;9380;6;70;76;6;0,921052631578947;1
"9381";11164;76;9381;6;13;19;6;0,184210526315789;0,263157894736842
"9382";11164;76;9382;6;66;72;6;0,868421052631579;0,947368421052632
"9383";11164;76;9383;6;38;44;6;0,5;0,578947368421053
"9384";11164;76;9384;6;68;76;8;0,894736842105263;1
"9385";11164;76;9385;6;66;74;8;0,868421052631579;0,973684210526316
"9386";11164;76;9386;6;66;76;10;0,868421052631579;1
"9387";11164;76;9387;6;62;68;6;0,815789473684211;0,894736842105263
"9388";11164;76;9388;6;40;46;6;0,526315789473684;0,605263157894737
"9389";11164;76;9389;6;27;33;6;0,368421052631579;0,447368421052632
"9390";11164;76;9390;6;31;38;7;0,421052631578947;0,5
"9391";11164;76;9391;6;54;60;6;0,710526315789474;0,789473684210526
"9392";11164;76;9392;6;62;70;8;0,815789473684211;0,921052631578947
"9393";11164;76;9393;6;62;72;10;0,815789473684211;0,947368421052632
"9394";11164;76;9394;6;62;74;12;0,815789473684211;0,973684210526316
"9395";11164;76;9395;6;64;72;8;0,842105263157895;0,947368421052632
"9396";11164;76;9396;6;64;74;10;0,842105263157895;0,973684210526316
"9397";11164;76;9397;6;64;76;12;0,842105263157895;1
"9398";11164;76;9398;6;11;17;6;0,157894736842105;0,236842105263158
"9399";11164;76;9399;6;46;52;6;0,605263157894737;0,684210526315789
"9400";11164;76;9400;6;52;58;6;0,684210526315789;0,763157894736842
"9401";11164;76;9401;6;9;15;6;0,131578947368421;0,210526315789474
"9402";11164;76;9402;6;17;23;6;0,236842105263158;0,315789473684211
"9403";11164;76;9403;6;3;9;6;0,0526315789473684;0,131578947368421
"9404";11164;76;9404;6;29;35;6;0,394736842105263;0,473684210526316
"9405";11164;76;9405;6;60;70;10;0,789473684210526;0,921052631578947
"9406";11164;76;9406;6;60;72;12;0,789473684210526;0,947368421052632
"9407";11164;76;9407;6;60;74;14;0,789473684210526;0,973684210526316
"9408";11164;76;9408;6;1;7;6;0,0263157894736842;0,105263157894737
"9409";11164;76;9409;6;62;76;14;0,815789473684211;1
"9410";11164;76;9410;6;33;40;7;0,447368421052632;0,526315789473684
"9411";11164;76;9411;6;5;11;6;0,0789473684210526;0,157894736842105
"9412";11164;76;9412;6;44;50;6;0,578947368421053;0,657894736842105
"9413";11164;76;9413;6;42;48;6;0,552631578947368;0,631578947368421
"9414";11164;76;9414;6;48;54;6;0,631578947368421;0,710526315789474
"9415";11164;76;9415;6;38;46;8;0,5;0,605263157894737
"9416";11187;75;9416;3;18;75;57;0,25;1
"9417";11187;75;9417;4;41;67;26;0,555555555555556;0,888888888888889
"9418";11187;75;9418;4;41;75;34;0,555555555555556;1
"9419";11187;75;9419;4;50;75;25;0,666666666666667;1
"9420";11187;75;9420;4;24;50;26;0,333333333333333;0,666666666666667
"9421";11187;75;9421;5;43;55;12;0,578947368421053;0,736842105263158
"9422";11187;75;9422;5;43;59;16;0,578947368421053;0,789473684210526
"9423";11187;75;9423;5;51;63;12;0,684210526315789;0,842105263157895
"9424";11187;75;9424;5;55;67;12;0,736842105263158;0,894736842105263
"9425";11187;75;9425;5;55;71;16;0,736842105263158;0,947368421052632
"9426";11187;75;9426;5;27;39;12;0,368421052631579;0,526315789473684
"9427";11187;75;9427;5;27;43;16;0,368421052631579;0,578947368421053
"9428";11187;75;9428;5;43;63;20;0,578947368421053;0,842105263157895
"9429";11187;75;9429;5;43;67;24;0,578947368421053;0,894736842105263
"9430";11187;75;9430;5;43;71;28;0,578947368421053;0,947368421052632
"9431";11187;75;9431;5;43;75;32;0,578947368421053;1
"9432";11187;75;9432;5;51;67;16;0,684210526315789;0,894736842105263
"9433";11187;75;9433;5;51;71;20;0,684210526315789;0,947368421052632
"9434";11187;75;9434;5;51;75;24;0,684210526315789;1
"9435";11187;75;9435;5;55;75;20;0,736842105263158;1
"9436";11187;75;9436;5;27;47;20;0,368421052631579;0,631578947368421
"9437";11187;75;9437;5;39;51;12;0,526315789473684;0,684210526315789
"9438";11187;75;9438;5;7;19;12;0,105263157894737;0,263157894736842
"9439";11187;75;9439;6;43;49;6;0,578947368421053;0,657894736842105
"9440";11187;75;9440;6;43;51;8;0,578947368421053;0,684210526315789
"9441";11187;75;9441;6;53;59;6;0,710526315789474;0,789473684210526
"9442";11187;75;9442;6;55;61;6;0,736842105263158;0,815789473684211
"9443";11187;75;9443;6;55;63;8;0,736842105263158;0,842105263157895
"9444";11187;75;9444;6;13;19;6;0,184210526315789;0,263157894736842
"9445";11187;75;9445;6;27;33;6;0,368421052631579;0,447368421052632
"9446";11187;75;9446;6;27;35;8;0,368421052631579;0,473684210526316
"9447";11187;75;9447;6;27;37;10;0,368421052631579;0,5
"9448";11187;75;9448;6;43;53;10;0,578947368421053;0,710526315789474
"9449";11187;75;9449;6;43;55;12;0,578947368421053;0,736842105263158
"9450";11187;75;9450;6;43;57;14;0,578947368421053;0,763157894736842
"9451";11187;75;9451;6;43;59;16;0,578947368421053;0,789473684210526
"9452";11187;75;9452;6;53;61;8;0,710526315789474;0,815789473684211
"9453";11187;75;9453;6;53;63;10;0,710526315789474;0,842105263157895
"9454";11187;75;9454;6;53;65;12;0,710526315789474;0,868421052631579
"9455";11187;75;9455;6;55;65;10;0,736842105263158;0,868421052631579
"9456";11187;75;9456;6;55;67;12;0,736842105263158;0,894736842105263
"9457";11187;75;9457;6;55;69;14;0,736842105263158;0,921052631578947
"9458";11187;75;9458;6;55;71;16;0,736842105263158;0,947368421052632
"9459";11187;75;9459;6;27;39;12;0,368421052631579;0,526315789473684
"9460";11187;75;9460;6;27;41;14;0,368421052631579;0,552631578947368
"9461";11187;75;9461;6;27;43;16;0,368421052631579;0,578947368421053
"9462";11187;75;9462;6;43;61;18;0,578947368421053;0,815789473684211
"9463";11187;75;9463;6;43;63;20;0,578947368421053;0,842105263157895
"9464";11187;75;9464;6;53;67;14;0,710526315789474;0,894736842105263
"9465";11187;75;9465;6;53;69;16;0,710526315789474;0,921052631578947
"9466";11187;75;9466;6;53;71;18;0,710526315789474;0,947368421052632
"9467";11187;75;9467;6;53;73;20;0,710526315789474;0,973684210526316
"9468";11187;75;9468;6;43;65;22;0,578947368421053;0,868421052631579
"9469";11187;75;9469;6;53;75;22;0,710526315789474;1
"9470";11187;75;9470;6;55;73;18;0,736842105263158;0,973684210526316
"9471";11187;75;9471;6;55;75;20;0,736842105263158;1
"9472";11187;75;9472;6;11;17;6;0,157894736842105;0,236842105263158
"9473";11187;75;9473;6;39;45;6;0,526315789473684;0,605263157894737
"9474";11187;75;9474;6;41;47;6;0,552631578947368;0,631578947368421
"9475";11187;75;9475;6;7;13;6;0,105263157894737;0,184210526315789
"9476";11187;75;9476;6;5;11;6;0,0789473684210526;0,157894736842105
"9477";11187;75;9477;6;1;7;6;0,0263157894736842;0,105263157894737
"9478";11187;75;9478;6;43;67;24;0,578947368421053;0,894736842105263
"9479";11187;75;9479;6;43;69;26;0,578947368421053;0,921052631578947
"9480";11187;75;9480;6;43;71;28;0,578947368421053;0,947368421052632
"9481";11187;75;9481;6;43;73;30;0,578947368421053;0,973684210526316
"9482";11187;75;9482;6;43;75;32;0,578947368421053;1
"9483";11261;66;9483;3;16;66;50;0,25;1
"9484";11261;66;9484;4;41;66;25;0,625;1
"9485";11261;66;9485;4;24;49;25;0,375;0,75
"9486";11261;66;9486;4;32;58;26;0,5;0,875
"9487";11261;66;9487;4;32;66;34;0,5;1
"9488";11261;66;9488;4;16;41;25;0,25;0,625
"9489";11261;66;9489;5;53;66;13;0,8125;1
"9490";11261;66;9490;5;16;28;12;0,25;0,4375
"9491";11261;66;9491;5;24;37;13;0,375;0,5625
"9492";11261;66;9492;5;28;41;13;0,4375;0,625
"9493";11261;66;9493;5;28;45;17;0,4375;0,6875
"9494";11261;66;9494;5;32;45;13;0,5;0,6875
"9495";11261;66;9495;5;32;49;17;0,5;0,75
"9496";11261;66;9496;5;32;53;21;0,5;0,8125
"9497";11261;66;9497;5;37;49;12;0,5625;0,75
"9498";11261;66;9498;5;41;53;12;0,625;0,8125
"9499";11261;66;9499;5;45;58;13;0,6875;0,875
"9500";11261;66;9500;5;45;62;17;0,6875;0,9375
"9501";11261;66;9501;5;45;66;21;0,6875;1
"9502";11261;66;9502;5;24;41;17;0,375;0,625
"9503";11261;66;9503;5;49;62;13;0,75;0,9375
"9504";11261;66;9504;5;3;16;13;0,0625;0,25
"9505";11261;66;9505;5;24;45;21;0,375;0,6875
"9506";11261;66;9506;5;49;66;17;0,75;1
"9507";11261;66;9507;5;37;53;16;0,5625;0,8125
"9508";11261;66;9508;5;28;49;21;0,4375;0,75
"9509";11261;66;9509;5;20;32;12;0,3125;0,5
"9510";11261;66;9510;5;12;24;12;0,1875;0,375
"9511";11261;66;9511;6;27;34;7;0,424242424242424;0,515151515151515
"9512";11261;66;9512;6;9;15;6;0,151515151515152;0,242424242424242
"9513";11261;66;9513;6;19;25;6;0,303030303030303;0,393939393939394
"9514";11261;66;9514;6;27;36;9;0,424242424242424;0,545454545454545
"9515";11261;66;9515;6;29;36;7;0,454545454545455;0,545454545454545
"9516";11261;66;9516;6;31;38;7;0,484848484848485;0,575757575757576
"9517";11261;66;9517;6;31;40;9;0,484848484848485;0,606060606060606
"9518";11261;66;9518;6;31;42;11;0,484848484848485;0,636363636363636
"9519";11261;66;9519;6;34;40;6;0,515151515151515;0,606060606060606
"9520";11261;66;9520;6;36;42;6;0,545454545454545;0,636363636363636
"9521";11261;66;9521;6;36;44;8;0,545454545454545;0,666666666666667
"9522";11261;66;9522;6;38;44;6;0,575757575757576;0,666666666666667
"9523";11261;66;9523;6;40;46;6;0,606060606060606;0,696969696969697
"9524";11261;66;9524;6;40;48;8;0,606060606060606;0,727272727272727
"9525";11261;66;9525;6;40;50;10;0,606060606060606;0,757575757575758
"9526";11261;66;9526;6;44;50;6;0,666666666666667;0,757575757575758
"9527";11261;66;9527;6;46;52;6;0,696969696969697;0,787878787878788
"9528";11261;66;9528;6;48;54;6;0,727272727272727;0,818181818181818
"9529";11261;66;9529;6;50;56;6;0,757575757575758;0,848484848484849
"9530";11261;66;9530;6;50;58;8;0,757575757575758;0,878787878787879
"9531";11261;66;9531;6;52;58;6;0,787878787878788;0,878787878787879
"9532";11261;66;9532;6;58;64;6;0,878787878787879;0,96969696969697
"9533";11261;66;9533;6;60;66;6;0,909090909090909;1
"9534";11261;66;9534;6;3;9;6;0,0606060606060606;0,151515151515152
"9535";11261;66;9535;6;5;11;6;0,0909090909090909;0,181818181818182
"9536";11261;66;9536;6;15;21;6;0,242424242424242;0,333333333333333
"9537";11261;66;9537;6;29;38;9;0,454545454545455;0,575757575757576
"9538";11261;66;9538;6;31;44;13;0,484848484848485;0,666666666666667
"9539";11261;66;9539;6;31;46;15;0,484848484848485;0,696969696969697
"9540";11261;66;9540;6;31;48;17;0,484848484848485;0,727272727272727
"9541";11261;66;9541;6;34;42;8;0,515151515151515;0,636363636363636
"9542";11261;66;9542;6;34;44;10;0,515151515151515;0,666666666666667
"9543";11261;66;9543;6;36;46;10;0,545454545454545;0,696969696969697
"9544";11261;66;9544;6;36;48;12;0,545454545454545;0,727272727272727
"9545";11261;66;9545;6;36;50;14;0,545454545454545;0,757575757575758
"9546";11261;66;9546;6;38;46;8;0,575757575757576;0,696969696969697
"9547";11261;66;9547;6;42;48;6;0,636363636363636;0,727272727272727
"9548";11261;66;9548;6;54;60;6;0,818181818181818;0,909090909090909
"9549";11261;66;9549;6;34;46;12;0,515151515151515;0,696969696969697
"9550";11261;66;9550;6;38;48;10;0,575757575757576;0,727272727272727
"9551";11261;66;9551;6;58;66;8;0,878787878787879;1
"9552";11261;66;9552;6;1;7;6;0,0303030303030303;0,121212121212121
"9553";11261;66;9553;6;21;27;6;0,333333333333333;0,424242424242424
"9554";11261;66;9554;6;25;31;6;0,393939393939394;0,484848484848485
"9555";11261;66;9555;6;29;40;11;0,454545454545455;0,606060606060606
"9556";11261;66;9556;6;25;34;9;0,393939393939394;0,515151515151515
"9557";11261;66;9557;6;48;56;8;0,727272727272727;0,848484848484849
"9558";11261;66;9558;6;48;58;10;0,727272727272727;0,878787878787879
"9559";11261;66;9559;6;27;38;11;0,424242424242424;0,575757575757576
"9560";11261;66;9560;6;29;42;13;0,454545454545455;0,636363636363636
"9561";11261;66;9561;6;29;44;15;0,454545454545455;0,666666666666667
"9562";11261;66;9562;6;29;46;17;0,454545454545455;0,696969696969697
"9563";11261;66;9563;6;29;48;19;0,454545454545455;0,727272727272727
"9564";11261;66;9564;6;38;50;12;0,575757575757576;0,757575757575758
"9565";11261;66;9565;6;50;60;10;0,757575757575758;0,909090909090909
"9566";11261;66;9566;6;50;62;12;0,757575757575758;0,939393939393939
"9567";11261;66;9567;6;52;60;8;0,787878787878788;0,909090909090909
"9568";11261;66;9568;6;52;62;10;0,787878787878788;0,939393939393939
"9569";11261;66;9569;6;52;64;12;0,787878787878788;0,96969696969697
"9570";11261;66;9570;6;54;62;8;0,818181818181818;0,939393939393939
"9571";11261;66;9571;6;54;64;10;0,818181818181818;0,96969696969697
"9572";11261;66;9572;6;56;62;6;0,848484848484849;0,939393939393939
"9573";11261;66;9573;6;1;9;8;0,0303030303030303;0,151515151515152
"9574";11261;66;9574;6;5;13;8;0,0909090909090909;0,212121212121212
"9575";11261;66;9575;6;56;64;8;0,848484848484849;0,96969696969697
"9576";11261;66;9576;6;3;11;8;0,0606060606060606;0,181818181818182
"9577";11261;66;9577;6;17;23;6;0,272727272727273;0,363636363636364
"9578";11261;66;9578;6;7;13;6;0,121212121212121;0,212121212121212
"9579";11261;66;9579;6;34;48;14;0,515151515151515;0,727272727272727
"9580";11261;66;9580;6;11;17;6;0,181818181818182;0,272727272727273
"9581";11261;66;9581;6;48;60;12;0,727272727272727;0,909090909090909
"9582";11261;66;9582;6;25;36;11;0,393939393939394;0,545454545454545
"9583";11261;66;9583;6;46;54;8;0,696969696969697;0,818181818181818
"9584";11261;66;9584;6;46;56;10;0,696969696969697;0,848484848484849
"9585";11261;66;9585;6;46;58;12;0,696969696969697;0,878787878787879
"9586";11261;66;9586;6;44;52;8;0,666666666666667;0,787878787878788
"9587";11261;66;9587;6;27;40;13;0,424242424242424;0,606060606060606
"9588";11261;66;9588;6;27;42;15;0,424242424242424;0,636363636363636
"9589";11261;66;9589;6;27;44;17;0,424242424242424;0,666666666666667
"9590";11261;66;9590;6;27;46;19;0,424242424242424;0,696969696969697
"9591";11389;65;9591;4;40;65;25;0,625;1
"9592";11389;65;9592;4;7;32;25;0,125;0,5
"9593";11389;65;9593;4;16;40;24;0,25;0,625
"9594";11389;65;9594;5;16;28;12;0,25;0,4375
"9595";11389;65;9595;5;16;32;16;0,25;0,5
"9596";11389;65;9596;5;16;36;20;0,25;0,5625
"9597";11389;65;9597;5;40;53;13;0,625;0,8125
"9598";11389;65;9598;5;40;57;17;0,625;0,875
"9599";11389;65;9599;5;44;57;13;0,6875;0,875
"9600";11389;65;9600;5;44;61;17;0,6875;0,9375
"9601";11389;65;9601;5;44;65;21;0,6875;1
"9602";11389;65;9602;5;7;20;13;0,125;0,3125
"9603";11389;65;9603;5;11;24;13;0,1875;0,375
"9604";11389;65;9604;5;11;28;17;0,1875;0,4375
"9605";11389;65;9605;5;11;32;21;0,1875;0,5
"9606";11389;65;9606;5;11;36;25;0,1875;0,5625
"9607";11389;65;9607;5;7;24;17;0,125;0,375
"9608";11389;65;9608;5;7;28;21;0,125;0,4375
"9609";11389;65;9609;5;7;32;25;0,125;0,5
"9610";11389;65;9610;5;7;36;29;0,125;0,5625
"9611";11389;65;9611;6;9;15;6;0,151515151515152;0,242424242424242
"9612";11389;65;9612;6;9;17;8;0,151515151515152;0,272727272727273
"9613";11389;65;9613;6;11;17;6;0,181818181818182;0,272727272727273
"9614";11389;65;9614;6;17;23;6;0,272727272727273;0,363636363636364
"9615";11389;65;9615;6;17;25;8;0,272727272727273;0,393939393939394
"9616";11389;65;9616;6;17;27;10;0,272727272727273;0,424242424242424
"9617";11389;65;9617;6;41;47;6;0,636363636363636;0,727272727272727
"9618";11389;65;9618;6;43;49;6;0,666666666666667;0,757575757575758
"9619";11389;65;9619;6;43;51;8;0,666666666666667;0,787878787878788
"9620";11389;65;9620;6;43;53;10;0,666666666666667;0,818181818181818
"9621";11389;65;9621;6;45;51;6;0,696969696969697;0,787878787878788
"9622";11389;65;9622;6;45;53;8;0,696969696969697;0,818181818181818
"9623";11389;65;9623;6;45;55;10;0,696969696969697;0,848484848484849
"9624";11389;65;9624;6;7;13;6;0,121212121212121;0,212121212121212
"9625";11389;65;9625;6;17;29;12;0,272727272727273;0,454545454545455
"9626";11389;65;9626;6;17;31;14;0,272727272727273;0,484848484848485
"9627";11389;65;9627;6;17;33;16;0,272727272727273;0,515151515151515
"9628";11389;65;9628;6;17;35;18;0,272727272727273;0,545454545454545
"9629";11389;65;9629;6;17;37;20;0,272727272727273;0,575757575757576
"9630";11389;65;9630;6;17;39;22;0,272727272727273;0,606060606060606
"9631";11389;65;9631;6;43;55;12;0,666666666666667;0,848484848484849
"9632";11389;65;9632;6;43;57;14;0,666666666666667;0,878787878787879
"9633";11389;65;9633;6;43;59;16;0,666666666666667;0,909090909090909
"9634";11389;65;9634;6;43;61;18;0,666666666666667;0,939393939393939
"9635";11389;65;9635;6;43;63;20;0,666666666666667;0,96969696969697
"9636";11389;65;9636;6;9;19;10;0,151515151515152;0,303030303030303
"9637";11389;65;9637;6;9;21;12;0,151515151515152;0,333333333333333
"9638";11389;65;9638;6;9;23;14;0,151515151515152;0,363636363636364
"9639";11389;65;9639;6;9;25;16;0,151515151515152;0,393939393939394
"9640";11389;65;9640;6;9;27;18;0,151515151515152;0,424242424242424
"9641";11389;65;9641;6;9;29;20;0,151515151515152;0,454545454545455
"9642";11389;65;9642;6;9;31;22;0,151515151515152;0,484848484848485
"9643";11389;65;9643;6;45;57;12;0,696969696969697;0,878787878787879
"9644";11389;65;9644;6;45;59;14;0,696969696969697;0,909090909090909
"9645";11389;65;9645;6;45;61;16;0,696969696969697;0,939393939393939
"9646";11389;65;9646;6;45;63;18;0,696969696969697;0,96969696969697
"9647";11389;65;9647;6;45;65;20;0,696969696969697;1
"9648";11389;65;9648;6;11;19;8;0,181818181818182;0,303030303030303
"9649";11389;65;9649;6;11;21;10;0,181818181818182;0,333333333333333
"9650";11389;65;9650;6;11;23;12;0,181818181818182;0,363636363636364
"9651";11389;65;9651;6;11;25;14;0,181818181818182;0,393939393939394
"9652";11389;65;9652;6;11;27;16;0,181818181818182;0,424242424242424
"9653";11389;65;9653;6;11;29;18;0,181818181818182;0,454545454545455
"9654";11389;65;9654;6;11;31;20;0,181818181818182;0,484848484848485
"9655";11389;65;9655;6;11;33;22;0,181818181818182;0,515151515151515
"9656";11389;65;9656;6;11;35;24;0,181818181818182;0,545454545454545
"9657";11389;65;9657;6;11;37;26;0,181818181818182;0,575757575757576
"9658";11389;65;9658;6;11;39;28;0,181818181818182;0,606060606060606
"9659";11389;65;9659;6;43;65;22;0,666666666666667;1
"9660";11615;117;9660;3;66;117;51;0,571428571428571;1
"9661";11615;117;9661;4;75;100;25;0,642857142857143;0,857142857142857
"9662";11615;117;9662;4;75;109;34;0,642857142857143;0,928571428571429
"9663";11615;117;9663;4;75;117;42;0,642857142857143;1
"9664";11615;117;9664;4;83;109;26;0,714285714285714;0,928571428571429
"9665";11615;117;9665;4;83;117;34;0,714285714285714;1
"9666";11615;117;9666;4;92;117;25;0,785714285714286;1
"9667";11615;117;9667;4;66;92;26;0,571428571428571;0,785714285714286
"9668";11615;117;9668;4;66;100;34;0,571428571428571;0,857142857142857
"9669";11615;117;9669;4;66;109;43;0,571428571428571;0,928571428571429
"9670";11615;117;9670;4;41;66;25;0,357142857142857;0,571428571428571
"9671";11615;117;9671;4;66;117;51;0,571428571428571;1
"9672";11615;117;9672;5;76;89;13;0,655172413793103;0,758620689655172
"9673";11615;117;9673;5;76;93;17;0,655172413793103;0,793103448275862
"9674";11615;117;9674;5;76;97;21;0,655172413793103;0,827586206896552
"9675";11615;117;9675;5;80;93;13;0,689655172413793;0,793103448275862
"9676";11615;117;9676;5;80;97;17;0,689655172413793;0,827586206896552
"9677";11615;117;9677;5;84;97;13;0,724137931034483;0,827586206896552
"9678";11615;117;9678;5;97;109;12;0,827586206896552;0,931034482758621
"9679";11615;117;9679;5;101;113;12;0,862068965517241;0,96551724137931
"9680";11615;117;9680;5;101;117;16;0,862068965517241;1
"9681";11615;117;9681;5;105;117;12;0,896551724137931;1
"9682";11615;117;9682;5;72;84;12;0,620689655172414;0,724137931034483
"9683";11615;117;9683;5;52;64;12;0,448275862068966;0,551724137931034
"9684";11615;117;9684;5;72;89;17;0,620689655172414;0,758620689655172
"9685";11615;117;9685;5;72;93;21;0,620689655172414;0,793103448275862
"9686";11615;117;9686;5;72;97;25;0,620689655172414;0,827586206896552
"9687";11615;117;9687;5;76;101;25;0,655172413793103;0,862068965517241
"9688";11615;117;9688;5;76;105;29;0,655172413793103;0,896551724137931
"9689";11615;117;9689;5;76;109;33;0,655172413793103;0,931034482758621
"9690";11615;117;9690;5;76;113;37;0,655172413793103;0,96551724137931
"9691";11615;117;9691;5;76;117;41;0,655172413793103;1
"9692";11615;117;9692;5;80;101;21;0,689655172413793;0,862068965517241
"9693";11615;117;9693;5;80;105;25;0,689655172413793;0,896551724137931
"9694";11615;117;9694;5;80;109;29;0,689655172413793;0,931034482758621
"9695";11615;117;9695;5;80;113;33;0,689655172413793;0,96551724137931
"9696";11615;117;9696;5;80;117;37;0,689655172413793;1
"9697";11615;117;9697;5;84;101;17;0,724137931034483;0,862068965517241
"9698";11615;117;9698;5;84;105;21;0,724137931034483;0,896551724137931
"9699";11615;117;9699;5;84;109;25;0,724137931034483;0,931034482758621
"9700";11615;117;9700;5;84;113;29;0,724137931034483;0,96551724137931
"9701";11615;117;9701;5;84;117;33;0,724137931034483;1
"9702";11615;117;9702;5;97;113;16;0,827586206896552;0,96551724137931
"9703";11615;117;9703;5;97;117;20;0,827586206896552;1
"9704";11615;117;9704;5;32;44;12;0,275862068965517;0,379310344827586
"9705";11615;117;9705;5;68;80;12;0,586206896551724;0,689655172413793
"9706";11615;117;9706;5;72;101;29;0,620689655172414;0,862068965517241
"9707";11615;117;9707;5;72;105;33;0,620689655172414;0,896551724137931
"9708";11615;117;9708;5;68;84;16;0,586206896551724;0,724137931034483
"9709";11615;117;9709;5;48;60;12;0,413793103448276;0,517241379310345
"9710";11615;117;9710;5;36;48;12;0,310344827586207;0,413793103448276
"9711";11615;117;9711;5;44;56;12;0,379310344827586;0,482758620689655
"9712";11615;117;9712;5;72;109;37;0,620689655172414;0,931034482758621
"9713";11615;117;9713;5;72;113;41;0,620689655172414;0,96551724137931
"9714";11615;117;9714;5;72;117;45;0,620689655172414;1
"9715";11615;117;9715;6;75;81;6;0,644067796610169;0,694915254237288
"9716";11615;117;9716;6;77;83;6;0,661016949152542;0,711864406779661
"9717";11615;117;9717;6;79;85;6;0,677966101694915;0,728813559322034
"9718";11615;117;9718;6;81;87;6;0,694915254237288;0,745762711864407
"9719";11615;117;9719;6;81;89;8;0,694915254237288;0,76271186440678
"9720";11615;117;9720;6;83;89;6;0,711864406779661;0,76271186440678
"9721";11615;117;9721;6;83;91;8;0,711864406779661;0,779661016949153
"9722";11615;117;9722;6;83;93;10;0,711864406779661;0,796610169491525
"9723";11615;117;9723;6;97;103;6;0,830508474576271;0,88135593220339
"9724";11615;117;9724;6;101;107;6;0,864406779661017;0,915254237288136
"9725";11615;117;9725;6;101;109;8;0,864406779661017;0,932203389830508
"9726";11615;117;9726;6;103;109;6;0,88135593220339;0,932203389830508
"9727";11615;117;9727;6;103;111;8;0,88135593220339;0,949152542372881
"9728";11615;117;9728;6;105;111;6;0,898305084745763;0,949152542372881
"9729";11615;117;9729;6;105;113;8;0,898305084745763;0,966101694915254
"9730";11615;117;9730;6;105;115;10;0,898305084745763;0,983050847457627
"9731";11615;117;9731;6;13;19;6;0,11864406779661;0,169491525423729
"9732";11615;117;9732;6;59;65;6;0,508474576271186;0,559322033898305
"9733";11615;117;9733;6;73;79;6;0,627118644067797;0,677966101694915
"9734";11615;117;9734;6;77;85;8;0,661016949152542;0,728813559322034
"9735";11615;117;9735;6;77;87;10;0,661016949152542;0,745762711864407
"9736";11615;117;9736;6;79;87;8;0,677966101694915;0,745762711864407
"9737";11615;117;9737;6;79;89;10;0,677966101694915;0,76271186440678
"9738";11615;117;9738;6;79;91;12;0,677966101694915;0,779661016949153
"9739";11615;117;9739;6;79;93;14;0,677966101694915;0,796610169491525
"9740";11615;117;9740;6;79;95;16;0,677966101694915;0,813559322033898
"9741";11615;117;9741;6;79;97;18;0,677966101694915;0,830508474576271
"9742";11615;117;9742;6;79;99;20;0,677966101694915;0,847457627118644
"9743";11615;117;9743;6;81;91;10;0,694915254237288;0,779661016949153
"9744";11615;117;9744;6;81;93;12;0,694915254237288;0,796610169491525
"9745";11615;117;9745;6;81;95;14;0,694915254237288;0,813559322033898
"9746";11615;117;9746;6;81;97;16;0,694915254237288;0,830508474576271
"9747";11615;117;9747;6;81;99;18;0,694915254237288;0,847457627118644
"9748";11615;117;9748;6;83;95;12;0,711864406779661;0,813559322033898
"9749";11615;117;9749;6;83;97;14;0,711864406779661;0,830508474576271
"9750";11615;117;9750;6;83;99;16;0,711864406779661;0,847457627118644
"9751";11615;117;9751;6;97;105;8;0,830508474576271;0,898305084745763
"9752";11615;117;9752;6;97;107;10;0,830508474576271;0,915254237288136
"9753";11615;117;9753;6;101;111;10;0,864406779661017;0,949152542372881
"9754";11615;117;9754;6;101;113;12;0,864406779661017;0,966101694915254
"9755";11615;117;9755;6;101;115;14;0,864406779661017;0,983050847457627
"9756";11615;117;9756;6;101;117;16;0,864406779661017;1
"9757";11615;117;9757;6;103;113;10;0,88135593220339;0,966101694915254
"9758";11615;117;9758;6;103;115;12;0,88135593220339;0,983050847457627
"9759";11615;117;9759;6;103;117;14;0,88135593220339;1
"9760";11615;117;9760;6;105;117;12;0,898305084745763;1
"9761";11615;117;9761;6;49;55;6;0,423728813559322;0,474576271186441
"9762";11615;117;9762;6;75;83;8;0,644067796610169;0,711864406779661
"9763";11615;117;9763;6;75;85;10;0,644067796610169;0,728813559322034
"9764";11615;117;9764;6;75;87;12;0,644067796610169;0,745762711864407
"9765";11615;117;9765;6;75;89;14;0,644067796610169;0,76271186440678
"9766";11615;117;9766;6;75;91;16;0,644067796610169;0,779661016949153
"9767";11615;117;9767;6;75;93;18;0,644067796610169;0,796610169491525
"9768";11615;117;9768;6;75;95;20;0,644067796610169;0,813559322033898
"9769";11615;117;9769;6;75;97;22;0,644067796610169;0,830508474576271
"9770";11615;117;9770;6;75;99;24;0,644067796610169;0,847457627118644
"9771";11615;117;9771;6;75;101;26;0,644067796610169;0,864406779661017
"9772";11615;117;9772;6;75;103;28;0,644067796610169;0,88135593220339
"9773";11615;117;9773;6;75;105;30;0,644067796610169;0,898305084745763
"9774";11615;117;9774;6;75;107;32;0,644067796610169;0,915254237288136
"9775";11615;117;9775;6;75;109;34;0,644067796610169;0,932203389830508
"9776";11615;117;9776;6;77;89;12;0,661016949152542;0,76271186440678
"9777";11615;117;9777;6;77;91;14;0,661016949152542;0,779661016949153
"9778";11615;117;9778;6;77;93;16;0,661016949152542;0,796610169491525
"9779";11615;117;9779;6;77;95;18;0,661016949152542;0,813559322033898
"9780";11615;117;9780;6;77;97;20;0,661016949152542;0,830508474576271
"9781";11615;117;9781;6;97;109;12;0,830508474576271;0,932203389830508
"9782";11615;117;9782;6;33;39;6;0,288135593220339;0,338983050847458
"9783";11615;117;9783;6;39;45;6;0,338983050847458;0,389830508474576
"9784";11615;117;9784;6;53;59;6;0,457627118644068;0,508474576271186
"9785";11615;117;9785;6;69;75;6;0,593220338983051;0,644067796610169
"9786";11615;117;9786;6;71;77;6;0,610169491525424;0,661016949152542
"9787";11615;117;9787;6;71;79;8;0,610169491525424;0,677966101694915
"9788";11615;117;9788;6;71;81;10;0,610169491525424;0,694915254237288
"9789";11615;117;9789;6;73;81;8;0,627118644067797;0,694915254237288
"9790";11615;117;9790;6;73;83;10;0,627118644067797;0,711864406779661
"9791";11615;117;9791;6;73;85;12;0,627118644067797;0,728813559322034
"9792";11615;117;9792;6;43;49;6;0,372881355932203;0,423728813559322
"9793";11615;117;9793;6;37;43;6;0,322033898305085;0,372881355932203
"9794";11615;117;9794;6;45;51;6;0,389830508474576;0,440677966101695
"9795";11615;117;9795;6;47;53;6;0,406779661016949;0,457627118644068
"9796";11615;117;9796;6;55;61;6;0,474576271186441;0,525423728813559
"9797";11615;117;9797;6;77;99;22;0,661016949152542;0,847457627118644
"9798";11615;117;9798;6;77;101;24;0,661016949152542;0,864406779661017
"9799";11615;117;9799;6;79;101;22;0,677966101694915;0,864406779661017
"9800";11615;117;9800;6;79;103;24;0,677966101694915;0,88135593220339
"9801";11615;117;9801;6;81;101;20;0,694915254237288;0,864406779661017
"9802";11615;117;9802;6;81;103;22;0,694915254237288;0,88135593220339
"9803";11615;117;9803;6;81;105;24;0,694915254237288;0,898305084745763
"9804";11615;117;9804;6;83;101;18;0,711864406779661;0,864406779661017
"9805";11615;117;9805;6;83;103;20;0,711864406779661;0,88135593220339
"9806";11615;117;9806;6;83;105;22;0,711864406779661;0,898305084745763
"9807";11615;117;9807;6;83;107;24;0,711864406779661;0,915254237288136
"9808";11615;117;9808;6;97;111;14;0,830508474576271;0,949152542372881
"9809";11615;117;9809;6;97;113;16;0,830508474576271;0,966101694915254
"9810";11615;117;9810;6;97;115;18;0,830508474576271;0,983050847457627
"9811";11615;117;9811;6;97;117;20;0,830508474576271;1
"9812";11615;117;9812;6;51;57;6;0,440677966101695;0,491525423728814
"9813";11615;117;9813;6;27;33;6;0,23728813559322;0,288135593220339
"9814";11615;117;9814;6;61;67;6;0,525423728813559;0,576271186440678
"9815";11615;117;9815;6;73;87;14;0,627118644067797;0,745762711864407
"9816";11615;117;9816;6;73;89;16;0,627118644067797;0,76271186440678
"9817";11615;117;9817;6;73;91;18;0,627118644067797;0,779661016949153
"9818";11615;117;9818;6;73;93;20;0,627118644067797;0,796610169491525
"9819";11615;117;9819;6;73;95;22;0,627118644067797;0,813559322033898
"9820";11615;117;9820;6;73;97;24;0,627118644067797;0,830508474576271
"9821";11615;117;9821;6;73;99;26;0,627118644067797;0,847457627118644
"9822";11615;117;9822;6;99;105;6;0,847457627118644;0,898305084745763
"9823";11615;117;9823;6;99;107;8;0,847457627118644;0,915254237288136
"9824";11615;117;9824;6;99;109;10;0,847457627118644;0,932203389830508
"9825";11615;117;9825;6;99;111;12;0,847457627118644;0,949152542372881
"9826";11615;117;9826;6;25;31;6;0,220338983050847;0,271186440677966
"9827";11615;117;9827;6;15;21;6;0,135593220338983;0,186440677966102
"9828";11615;117;9828;6;35;41;6;0,305084745762712;0,355932203389831
"9829";11615;117;9829;6;67;73;6;0,576271186440678;0,627118644067797
"9830";11615;117;9830;6;77;103;26;0,661016949152542;0,88135593220339
"9831";11615;117;9831;6;99;113;14;0,847457627118644;0,966101694915254
"9832";11615;117;9832;6;99;115;16;0,847457627118644;0,983050847457627
"9833";11615;117;9833;6;99;117;18;0,847457627118644;1
"9834";11615;117;9834;6;69;77;8;0,593220338983051;0,661016949152542
"9835";11615;117;9835;6;69;79;10;0,593220338983051;0,677966101694915
"9836";11615;117;9836;6;71;83;12;0,610169491525424;0,711864406779661
"9837";11615;117;9837;6;71;85;14;0,610169491525424;0,728813559322034
"9838";11615;117;9838;6;71;87;16;0,610169491525424;0,745762711864407
"9839";11615;117;9839;6;71;89;18;0,610169491525424;0,76271186440678
"9840";11615;117;9840;6;71;91;20;0,610169491525424;0,779661016949153
"9841";11615;117;9841;6;77;105;28;0,661016949152542;0,898305084745763
"9842";11615;117;9842;6;77;107;30;0,661016949152542;0,915254237288136
"9843";11615;117;9843;6;77;109;32;0,661016949152542;0,932203389830508
"9844";11615;117;9844;6;53;61;8;0,457627118644068;0,525423728813559
"9845";11615;117;9845;6;79;105;26;0,677966101694915;0,898305084745763
"9846";11615;117;9846;6;83;109;26;0,711864406779661;0,932203389830508
"9847";11992;110;9847;3;36;92;56;0,333333333333333;0,833333333333333
"9848";11992;110;9848;4;76;101;25;0,692307692307692;0,923076923076923
"9849";11992;110;9849;4;76;110;34;0,692307692307692;1
"9850";11992;110;9850;4;84;110;26;0,769230769230769;1
"9851";11992;110;9851;4;67;93;26;0,615384615384615;0,846153846153846
"9852";11992;110;9852;5;73;85;12;0,666666666666667;0,777777777777778
"9853";11992;110;9853;5;73;89;16;0,666666666666667;0,814814814814815
"9854";11992;110;9854;5;81;94;13;0,740740740740741;0,851851851851852
"9855";11992;110;9855;5;7;20;13;0,0740740740740741;0,185185185185185
"9856";11992;110;9856;5;77;89;12;0,703703703703704;0,814814814814815
"9857";11992;110;9857;5;77;94;17;0,703703703703704;0,851851851851852
"9858";11992;110;9858;5;77;98;21;0,703703703703704;0,888888888888889
"9859";11992;110;9859;5;85;98;13;0,777777777777778;0,888888888888889
"9860";11992;110;9860;5;98;110;12;0,888888888888889;1
"9861";11992;110;9861;5;20;32;12;0,185185185185185;0,296296296296296
"9862";11992;110;9862;5;40;52;12;0,37037037037037;0,481481481481481
"9863";11992;110;9863;5;81;98;17;0,740740740740741;0,888888888888889
"9864";11992;110;9864;5;69;81;12;0,62962962962963;0,740740740740741
"9865";11992;110;9865;5;73;94;21;0,666666666666667;0,851851851851852
"9866";11992;110;9866;5;73;98;25;0,666666666666667;0,888888888888889
"9867";11992;110;9867;5;65;77;12;0,592592592592593;0,703703703703704
"9868";11992;110;9868;5;3;15;12;0,037037037037037;0,148148148148148
"9869";11992;110;9869;5;89;102;13;0,814814814814815;0,925925925925926
"9870";11992;110;9870;6;13;19;6;0,127272727272727;0,181818181818182
"9871";11992;110;9871;6;15;21;6;0,145454545454545;0,2
"9872";11992;110;9872;6;27;33;6;0,254545454545455;0,309090909090909
"9873";11992;110;9873;6;29;35;6;0,272727272727273;0,327272727272727
"9874";11992;110;9874;6;39;45;6;0,363636363636364;0,418181818181818
"9875";11992;110;9875;6;49;56;7;0,454545454545455;0,509090909090909
"9876";11992;110;9876;6;76;82;6;0,690909090909091;0,745454545454545
"9877";11992;110;9877;6;76;84;8;0,690909090909091;0,763636363636364
"9878";11992;110;9878;6;76;86;10;0,690909090909091;0,781818181818182
"9879";11992;110;9879;6;80;86;6;0,727272727272727;0,781818181818182
"9880";11992;110;9880;6;82;88;6;0,745454545454545;0,8
"9881";11992;110;9881;6;88;94;6;0,8;0,854545454545454
"9882";11992;110;9882;6;90;96;6;0,818181818181818;0,872727272727273
"9883";11992;110;9883;6;98;104;6;0,890909090909091;0,945454545454545
"9884";11992;110;9884;6;100;106;6;0,909090909090909;0,963636363636364
"9885";11992;110;9885;6;27;35;8;0,254545454545455;0,327272727272727
"9886";11992;110;9886;6;39;47;8;0,363636363636364;0,436363636363636
"9887";11992;110;9887;6;70;76;6;0,636363636363636;0,690909090909091
"9888";11992;110;9888;6;74;80;6;0,672727272727273;0,727272727272727
"9889";11992;110;9889;6;74;82;8;0,672727272727273;0,745454545454545
"9890";11992;110;9890;6;74;84;10;0,672727272727273;0,763636363636364
"9891";11992;110;9891;6;78;84;6;0,709090909090909;0,763636363636364
"9892";11992;110;9892;6;78;86;8;0,709090909090909;0,781818181818182
"9893";11992;110;9893;6;78;88;10;0,709090909090909;0,8
"9894";11992;110;9894;6;78;90;12;0,709090909090909;0,818181818181818
"9895";11992;110;9895;6;78;92;14;0,709090909090909;0,836363636363636
"9896";11992;110;9896;6;80;88;8;0,727272727272727;0,8
"9897";11992;110;9897;6;80;90;10;0,727272727272727;0,818181818181818
"9898";11992;110;9898;6;82;90;8;0,745454545454545;0,818181818181818
"9899";11992;110;9899;6;82;92;10;0,745454545454545;0,836363636363636
"9900";11992;110;9900;6;82;94;12;0,745454545454545;0,854545454545454
"9901";11992;110;9901;6;82;96;14;0,745454545454545;0,872727272727273
"9902";11992;110;9902;6;84;90;6;0,763636363636364;0,818181818181818
"9903";11992;110;9903;6;88;96;8;0,8;0,872727272727273
"9904";11992;110;9904;6;88;98;10;0,8;0,890909090909091
"9905";11992;110;9905;6;90;98;8;0,818181818181818;0,890909090909091
"9906";11992;110;9906;6;98;106;8;0,890909090909091;0,963636363636364
"9907";11992;110;9907;6;11;17;6;0,109090909090909;0,163636363636364
"9908";11992;110;9908;6;37;43;6;0,345454545454545;0,4
"9909";11992;110;9909;6;37;45;8;0,345454545454545;0,418181818181818
"9910";11992;110;9910;6;66;72;6;0,6;0,654545454545455
"9911";11992;110;9911;6;66;74;8;0,6;0,672727272727273
"9912";11992;110;9912;6;66;76;10;0,6;0,690909090909091
"9913";11992;110;9913;6;84;92;8;0,763636363636364;0,836363636363636
"9914";11992;110;9914;6;84;94;10;0,763636363636364;0,854545454545454
"9915";11992;110;9915;6;86;92;6;0,781818181818182;0,836363636363636
"9916";11992;110;9916;6;86;94;8;0,781818181818182;0,854545454545454
"9917";11992;110;9917;6;86;96;10;0,781818181818182;0,872727272727273
"9918";11992;110;9918;6;98;108;10;0,890909090909091;0,981818181818182
"9919";11992;110;9919;6;100;108;8;0,909090909090909;0,981818181818182
"9920";11992;110;9920;6;100;110;10;0,909090909090909;1
"9921";11992;110;9921;6;13;21;8;0,127272727272727;0,2
"9922";11992;110;9922;6;80;92;12;0,727272727272727;0,836363636363636
"9923";11992;110;9923;6;80;94;14;0,727272727272727;0,854545454545454
"9924";11992;110;9924;6;80;96;16;0,727272727272727;0,872727272727273
"9925";11992;110;9925;6;80;98;18;0,727272727272727;0,890909090909091
"9926";11992;110;9926;6;82;98;16;0,745454545454545;0,890909090909091
"9927";11992;110;9927;6;84;96;12;0,763636363636364;0,872727272727273
"9928";11992;110;9928;6;84;98;14;0,763636363636364;0,890909090909091
"9929";11992;110;9929;6;86;98;12;0,781818181818182;0,890909090909091
"9930";11992;110;9930;6;98;110;12;0,890909090909091;1
"9931";11992;110;9931;6;3;9;6;0,0363636363636364;0,0909090909090909
"9932";11992;110;9932;6;74;86;12;0,672727272727273;0,781818181818182
"9933";11992;110;9933;6;76;88;12;0,690909090909091;0,8
"9934";11992;110;9934;6;76;90;14;0,690909090909091;0,818181818181818
"9935";11992;110;9935;6;78;94;16;0,709090909090909;0,854545454545454
"9936";11992;110;9936;6;78;96;18;0,709090909090909;0,872727272727273
"9937";11992;110;9937;6;1;7;6;0,0181818181818182;0,0727272727272727
"9938";11992;110;9938;6;45;51;6;0,418181818181818;0,472727272727273
"9939";11992;110;9939;6;11;19;8;0,109090909090909;0,181818181818182
"9940";11992;110;9940;6;21;27;6;0,2;0,254545454545455
"9941";11992;110;9941;6;43;49;6;0,4;0,454545454545455
"9942";11992;110;9942;6;41;47;6;0,381818181818182;0,436363636363636
"9943";11992;110;9943;6;47;53;6;0,436363636363636;0,490909090909091
"9944";11992;110;9944;6;25;31;6;0,236363636363636;0,290909090909091
"9945";11992;110;9945;6;25;33;8;0,236363636363636;0,309090909090909
"9946";11992;110;9946;6;9;15;6;0,0909090909090909;0,145454545454545
"9947";11992;110;9947;6;11;21;10;0,109090909090909;0,2
"9948";11992;110;9948;6;47;56;9;0,436363636363636;0,509090909090909
"9949";11992;110;9949;6;17;23;6;0,163636363636364;0,218181818181818
"9950";11992;110;9950;6;64;70;6;0,581818181818182;0,636363636363636
"9951";11992;110;9951;6;64;72;8;0,581818181818182;0,654545454545455
"9952";11992;110;9952;6;5;11;6;0,0545454545454545;0,109090909090909
"9953";11992;110;9953;6;45;53;8;0,418181818181818;0,490909090909091
"9954";11992;110;9954;6;76;92;16;0,690909090909091;0,836363636363636
"9955";11992;110;9955;6;76;94;18;0,690909090909091;0,854545454545454
"9956";11992;110;9956;6;23;29;6;0,218181818181818;0,272727272727273
"9957";12053;87;9957;3;34;87;53;0,4;1
"9958";12053;87;9958;4;63;87;24;0,727272727272727;1
"9959";12053;87;9959;4;55;79;24;0,636363636363636;0,909090909090909
"9960";12053;87;9960;4;55;87;32;0,636363636363636;1
"9961";12053;87;9961;4;15;39;24;0,181818181818182;0,454545454545455
"9962";12053;87;9962;4;23;47;24;0,272727272727273;0,545454545454545
"9963";12053;87;9963;4;47;71;24;0,545454545454545;0,818181818181818
"9964";12053;87;9964;4;47;79;32;0,545454545454545;0,909090909090909
"9965";12053;87;9965;4;47;87;40;0,545454545454545;1
"9966";12053;87;9966;5;59;71;12;0,681818181818182;0,818181818181818
"9967";12053;87;9967;5;67;79;12;0,772727272727273;0,909090909090909
"9968";12053;87;9968;5;11;23;12;0,136363636363636;0,272727272727273
"9969";12053;87;9969;5;19;31;12;0,227272727272727;0,363636363636364
"9970";12053;87;9970;5;59;75;16;0,681818181818182;0,863636363636364
"9971";12053;87;9971;5;59;79;20;0,681818181818182;0,909090909090909
"9972";12053;87;9972;5;15;27;12;0,181818181818182;0,318181818181818
"9973";12053;87;9973;5;19;35;16;0,227272727272727;0,409090909090909
"9974";12053;87;9974;5;23;35;12;0,272727272727273;0,409090909090909
"9975";12053;87;9975;5;35;47;12;0,409090909090909;0,545454545454545
"9976";12053;87;9976;5;47;59;12;0,545454545454545;0,681818181818182
"9977";12053;87;9977;5;55;67;12;0,636363636363636;0,772727272727273
"9978";12053;87;9978;5;55;71;16;0,636363636363636;0,818181818181818
"9979";12053;87;9979;5;59;83;24;0,681818181818182;0,954545454545455
"9980";12053;87;9980;5;59;87;28;0,681818181818182;1
"9981";12053;87;9981;5;63;75;12;0,727272727272727;0,863636363636364
"9982";12053;87;9982;5;63;79;16;0,727272727272727;0,909090909090909
"9983";12053;87;9983;5;63;83;20;0,727272727272727;0,954545454545455
"9984";12053;87;9984;5;63;87;24;0,727272727272727;1
"9985";12053;87;9985;5;67;83;16;0,772727272727273;0,954545454545455
"9986";12053;87;9986;5;67;87;20;0,772727272727273;1
"9987";12053;87;9987;5;7;19;12;0,0909090909090909;0,227272727272727
"9988";12053;87;9988;5;31;43;12;0,363636363636364;0,5
"9989";12053;87;9989;5;51;63;12;0,590909090909091;0,727272727272727
"9990";12053;87;9990;5;55;75;20;0,636363636363636;0,863636363636364
"9991";12053;87;9991;5;15;31;16;0,181818181818182;0,363636363636364
"9992";12053;87;9992;5;55;79;24;0,636363636363636;0,909090909090909
"9993";12053;87;9993;5;55;83;28;0,636363636363636;0,954545454545455
"9994";12053;87;9994;5;55;87;32;0,636363636363636;1
"9995";12053;87;9995;5;11;27;16;0,136363636363636;0,318181818181818
"9996";12053;87;9996;6;63;69;6;0,727272727272727;0,795454545454545
"9997";12053;87;9997;6;27;33;6;0,318181818181818;0,386363636363636
"9998";12053;87;9998;6;35;41;6;0,409090909090909;0,477272727272727
"9999";12053;87;9999;6;35;43;8;0,409090909090909;0,5
"10000";12053;87;10000;6;37;43;6;0,431818181818182;0,5
"10001";12053;87;10001;6;39;45;6;0,454545454545455;0,522727272727273
"10002";12053;87;10002;6;57;63;6;0,659090909090909;0,727272727272727
"10003";12053;87;10003;6;65;71;6;0,75;0,818181818181818
"10004";12053;87;10004;6;9;15;6;0,113636363636364;0,181818181818182
"10005";12053;87;10005;6;15;21;6;0,181818181818182;0,25
"10006";12053;87;10006;6;15;23;8;0,181818181818182;0,272727272727273
"10007";12053;87;10007;6;35;45;10;0,409090909090909;0,522727272727273
"10008";12053;87;10008;6;37;45;8;0,431818181818182;0,522727272727273
"10009";12053;87;10009;6;51;57;6;0,590909090909091;0,659090909090909
"10010";12053;87;10010;6;51;59;8;0,590909090909091;0,681818181818182
"10011";12053;87;10011;6;53;59;6;0,613636363636364;0,681818181818182
"10012";12053;87;10012;6;57;65;8;0,659090909090909;0,75
"10013";12053;87;10013;6;57;67;10;0,659090909090909;0,772727272727273
"10014";12053;87;10014;6;57;69;12;0,659090909090909;0,795454545454545
"10015";12053;87;10015;6;57;71;14;0,659090909090909;0,818181818181818
"10016";12053;87;10016;6;61;67;6;0,704545454545455;0,772727272727273
"10017";12053;87;10017;6;61;69;8;0,704545454545455;0,795454545454545
"10018";12053;87;10018;6;61;71;10;0,704545454545455;0,818181818181818
"10019";12053;87;10019;6;61;73;12;0,704545454545455;0,840909090909091
"10020";12053;87;10020;6;63;71;8;0,727272727272727;0,818181818181818
"10021";12053;87;10021;6;63;73;10;0,727272727272727;0,840909090909091
"10022";12053;87;10022;6;65;73;8;0,75;0,840909090909091
"10023";12053;87;10023;6;65;75;10;0,75;0,863636363636364
"10024";12053;87;10024;6;65;77;12;0,75;0,886363636363636
"10025";12053;87;10025;6;65;79;14;0,75;0,909090909090909
"10026";12053;87;10026;6;5;11;6;0,0681818181818182;0,136363636363636
"10027";12053;87;10027;6;13;19;6;0,159090909090909;0,227272727272727
"10028";12053;87;10028;6;45;51;6;0,522727272727273;0,590909090909091
"10029";12053;87;10029;6;57;73;16;0,659090909090909;0,840909090909091
"10030";12053;87;10030;6;57;75;18;0,659090909090909;0,863636363636364
"10031";12053;87;10031;6;57;77;20;0,659090909090909;0,886363636363636
"10032";12053;87;10032;6;57;79;22;0,659090909090909;0,909090909090909
"10033";12053;87;10033;6;63;75;12;0,727272727272727;0,863636363636364
"10034";12053;87;10034;6;63;77;14;0,727272727272727;0,886363636363636
"10035";12053;87;10035;6;63;79;16;0,727272727272727;0,909090909090909
"10036";12053;87;10036;6;63;81;18;0,727272727272727;0,931818181818182
"10037";12053;87;10037;6;63;83;20;0,727272727272727;0,954545454545455
"10038";12053;87;10038;6;63;85;22;0,727272727272727;0,977272727272727
"10039";12053;87;10039;6;11;17;6;0,136363636363636;0,204545454545455
"10040";12053;87;10040;6;11;19;8;0,136363636363636;0,227272727272727
"10041";12053;87;10041;6;21;27;6;0,25;0,318181818181818
"10042";12053;87;10042;6;49;55;6;0,568181818181818;0,636363636363636
"10043";12053;87;10043;6;17;23;6;0,204545454545455;0,272727272727273
"10044";12053;87;10044;6;19;25;6;0,227272727272727;0,295454545454545
"10045";12053;87;10045;6;5;13;8;0,0681818181818182;0,159090909090909
"10046";12053;87;10046;6;23;29;6;0,272727272727273;0,340909090909091
"10047";12053;87;10047;6;33;39;6;0,386363636363636;0,454545454545455
"10048";12053;87;10048;6;33;41;8;0,386363636363636;0,477272727272727
"10049";12053;87;10049;6;33;43;10;0,386363636363636;0,5
"10050";12053;87;10050;6;33;45;12;0,386363636363636;0,522727272727273
"10051";12053;87;10051;6;53;61;8;0,613636363636364;0,704545454545455
"10052";12053;87;10052;6;55;61;6;0,636363636363636;0,704545454545455
"10053";12053;87;10053;6;55;63;8;0,636363636363636;0,727272727272727
"10054";12053;87;10054;6;65;81;16;0,75;0,931818181818182
"10055";12053;87;10055;6;65;83;18;0,75;0,954545454545455
"10056";12053;87;10056;6;7;13;6;0,0909090909090909;0,159090909090909
"10057";12053;87;10057;6;9;17;8;0,113636363636364;0,204545454545455
"10058";12053;87;10058;6;23;31;8;0,272727272727273;0,363636363636364
"10059";12053;87;10059;6;17;25;8;0,204545454545455;0,295454545454545
"10060";12053;87;10060;6;17;27;10;0,204545454545455;0,318181818181818
"10061";12053;87;10061;6;61;75;14;0,704545454545455;0,863636363636364
"10062";12053;87;10062;6;61;77;16;0,704545454545455;0,886363636363636
"10063";12053;87;10063;6;61;79;18;0,704545454545455;0,909090909090909
"10064";12053;87;10064;6;61;81;20;0,704545454545455;0,931818181818182
"10065";12053;87;10065;6;61;83;22;0,704545454545455;0,954545454545455
"10066";12053;87;10066;6;61;85;24;0,704545454545455;0,977272727272727
"10067";12053;87;10067;6;63;87;24;0,727272727272727;1
"10068";12053;87;10068;6;65;85;20;0,75;0,977272727272727
"10069";12053;87;10069;6;65;87;22;0,75;1
"10070";12053;87;10070;6;21;29;8;0,25;0,340909090909091
"10071";12053;87;10071;6;21;31;10;0,25;0,363636363636364
"10072";12053;87;10072;6;47;53;6;0,545454545454545;0,613636363636364
"10073";12053;87;10073;6;13;21;8;0,159090909090909;0,25
"10074";12053;87;10074;6;25;31;6;0,295454545454545;0,363636363636364
"10075";12053;87;10075;6;25;33;8;0,295454545454545;0,386363636363636
"10076";12053;87;10076;6;39;47;8;0,454545454545455;0,545454545454545
"10077";12053;87;10077;6;49;57;8;0,568181818181818;0,659090909090909
"10078";12053;87;10078;6;11;21;10;0,136363636363636;0,25
"10079";12053;87;10079;6;55;65;10;0,636363636363636;0,75
"10080";12053;87;10080;6;55;67;12;0,636363636363636;0,772727272727273
"10081";12053;87;10081;6;55;69;14;0,636363636363636;0,795454545454545
"10082";12053;87;10082;6;19;27;8;0,227272727272727;0,318181818181818
"10083";12053;87;10083;6;57;81;24;0,659090909090909;0,931818181818182
"10084";12053;87;10084;6;57;83;26;0,659090909090909;0,954545454545455
"10085";12053;87;10085;6;57;85;28;0,659090909090909;0,977272727272727
"10086";12053;87;10086;6;3;9;6;0,0454545454545455;0,113636363636364
"10087";12053;87;10087;6;23;33;10;0,272727272727273;0,386363636363636
"10088";12053;87;10088;6;57;87;30;0,659090909090909;1
"10089";12421;78;10089;5;45;57;12;0,578947368421053;0,736842105263158
"10090";12421;78;10090;5;3;16;13;0,0526315789473684;0,210526315789474
"10091";12421;78;10091;5;66;78;12;0,842105263157895;1
"10092";12421;78;10092;5;61;74;13;0,789473684210526;0,947368421052632
"10093";12421;78;10093;6;5;11;6;0,0769230769230769;0,153846153846154
"10094";12421;78;10094;6;52;58;6;0,666666666666667;0,743589743589744
"10095";12421;78;10095;6;50;56;6;0,641025641025641;0,717948717948718
"10096";12421;78;10096;6;50;58;8;0,641025641025641;0,743589743589744
"10097";12421;78;10097;6;66;72;6;0,846153846153846;0,923076923076923
"10098";12421;78;10098;6;72;78;6;0,923076923076923;1
"10099";12421;78;10099;6;64;70;6;0,82051282051282;0,897435897435897
"10100";12421;78;10100;6;15;21;6;0,205128205128205;0,282051282051282
"10101";12421;78;10101;6;48;54;6;0,615384615384615;0,692307692307692
"10102";12421;78;10102;6;29;35;6;0,384615384615385;0,461538461538462
"10103";12421;78;10103;6;27;33;6;0,358974358974359;0,435897435897436
"10104";12421;78;10104;6;17;23;6;0,230769230769231;0,307692307692308
"10105";12421;78;10105;6;68;74;6;0,871794871794872;0,948717948717949
"10106";12421;78;10106;6;58;64;6;0,743589743589744;0,82051282051282
"10107";12421;78;10107;6;66;74;8;0,846153846153846;0,948717948717949
"10108";12421;78;10108;6;70;76;6;0,897435897435897;0,974358974358974
"10109";12421;78;10109;6;46;52;6;0,58974358974359;0,666666666666667
"10110";12421;78;10110;6;3;9;6;0,0512820512820513;0,128205128205128
"10111";12421;78;10111;6;13;19;6;0,179487179487179;0,256410256410256
"10112";12421;78;10112;6;48;56;8;0,615384615384615;0,717948717948718
"10113";12421;78;10113;6;64;72;8;0,82051282051282;0,923076923076923
"10114";12421;78;10114;6;1;7;6;0,0256410256410256;0,102564102564103
"10115";12421;78;10115;6;62;68;6;0,794871794871795;0,871794871794872
"10116";12421;78;10116;6;37;44;7;0,487179487179487;0,564102564102564
"10117";12421;78;10117;6;68;76;8;0,871794871794872;0,974358974358974
"10118";12421;78;10118;6;60;66;6;0,769230769230769;0,846153846153846
"10119";12421;78;10119;6;48;58;10;0,615384615384615;0,743589743589744
"10120";12547;157;10120;4;69;122;53;0,444444444444444;0,777777777777778
"10121";12547;157;10121;5;7;32;25;0,0526315789473684;0,210526315789474
"10122";12547;157;10122;5;41;66;25;0,263157894736842;0,421052631578947
"10123";12547;157;10123;5;74;99;25;0,473684210526316;0,631578947368421
"10124";12547;157;10124;5;74;107;33;0,473684210526316;0,684210526315789
"10125";12547;157;10125;5;82;107;25;0,526315789473684;0,684210526315789
"10126";12547;157;10126;5;132;157;25;0,842105263157895;1
"10127";12547;157;10127;5;16;41;25;0,105263157894737;0,263157894736842
"10128";12547;157;10128;5;24;49;25;0,157894736842105;0,315789473684211
"10129";12547;157;10129;5;32;57;25;0,210526315789474;0,368421052631579
"10130";12547;157;10130;5;32;66;34;0,210526315789474;0,421052631578947
"10131";12547;157;10131;5;16;49;33;0,105263157894737;0,315789473684211
"10132";12547;157;10132;5;82;115;33;0,526315789473684;0,736842105263158
"10133";12547;157;10133;6;15;27;12;0,102564102564103;0,179487179487179
"10134";12547;157;10134;6;48;60;12;0,307692307692308;0,384615384615385
"10135";12547;157;10135;6;80;92;12;0,512820512820513;0,58974358974359
"10136";12547;157;10136;6;84;96;12;0,538461538461538;0,615384615384615
"10137";12547;157;10137;6;88;100;12;0,564102564102564;0,641025641025641
"10138";12547;157;10138;6;92;104;12;0,58974358974359;0,666666666666667
"10139";12547;157;10139;6;108;121;13;0,692307692307692;0,769230769230769
"10140";12547;157;10140;6;108;125;17;0,692307692307692;0,794871794871795
"10141";12547;157;10141;6;112;125;13;0,717948717948718;0,794871794871795
"10142";12547;157;10142;6;133;145;12;0,846153846153846;0,923076923076923
"10143";12547;157;10143;6;141;153;12;0,897435897435897;0,974358974358974
"10144";12547;157;10144;6;48;64;16;0,307692307692308;0,41025641025641
"10145";12547;157;10145;6;48;68;20;0,307692307692308;0,435897435897436
"10146";12547;157;10146;6;52;64;12;0,333333333333333;0,41025641025641
"10147";12547;157;10147;6;52;68;16;0,333333333333333;0,435897435897436
"10148";12547;157;10148;6;56;68;12;0,358974358974359;0,435897435897436
"10149";12547;157;10149;6;80;96;16;0,512820512820513;0,615384615384615
"10150";12547;157;10150;6;80;100;20;0,512820512820513;0,641025641025641
"10151";12547;157;10151;6;84;100;16;0,538461538461538;0,641025641025641
"10152";12547;157;10152;6;88;104;16;0,564102564102564;0,666666666666667
"10153";12547;157;10153;6;88;108;20;0,564102564102564;0,692307692307692
"10154";12547;157;10154;6;92;108;16;0,58974358974359;0,692307692307692
"10155";12547;157;10155;6;137;149;12;0,871794871794872;0,948717948717949
"10156";12547;157;10156;6;137;153;16;0,871794871794872;0,974358974358974
"10157";12547;157;10157;6;11;23;12;0,0769230769230769;0,153846153846154
"10158";12547;157;10158;6;137;157;20;0,871794871794872;1
"10159";12547;157;10159;6;141;157;16;0,897435897435897;1
"10160";12547;157;10160;6;31;44;13;0,205128205128205;0,282051282051282
"10161";12547;157;10161;6;35;48;13;0,230769230769231;0,307692307692308
"10162";12547;157;10162;6;35;52;17;0,230769230769231;0,333333333333333
"10163";12547;157;10163;6;76;88;12;0,487179487179487;0,564102564102564
"10164";12547;157;10164;6;80;104;24;0,512820512820513;0,666666666666667
"10165";12547;157;10165;6;84;104;20;0,538461538461538;0,666666666666667
"10166";12547;157;10166;6;84;108;24;0,538461538461538;0,692307692307692
"10167";12547;157;10167;6;96;108;12;0,615384615384615;0,692307692307692
"10168";12547;157;10168;6;44;56;12;0,282051282051282;0,358974358974359
"10169";12547;157;10169;6;40;52;12;0,256410256410256;0,333333333333333
"10170";12547;157;10170;6;133;149;16;0,846153846153846;0,948717948717949
"10171";12547;157;10171;6;133;153;20;0,846153846153846;0,974358974358974
"10172";12547;157;10172;6;133;157;24;0,846153846153846;1
"10173";12547;157;10173;6;76;92;16;0,487179487179487;0,58974358974359
"10174";12547;157;10174;6;40;56;16;0,256410256410256;0,358974358974359
"10175";12547;157;10175;6;80;108;28;0,512820512820513;0,692307692307692
"10176";12547;157;10176;6;31;48;17;0,205128205128205;0,307692307692308
"10177";12547;157;10177;6;7;19;12;0,0512820512820513;0,128205128205128
"10178";12547;157;10178;6;72;84;12;0,461538461538462;0,538461538461538
"10179";12547;157;10179;6;76;96;20;0,487179487179487;0,615384615384615
"10180";12547;157;10180;6;76;100;24;0,487179487179487;0,641025641025641
"10181";12547;157;10181;6;76;104;28;0,487179487179487;0,666666666666667
"10182";12547;157;10182;6;76;108;32;0,487179487179487;0,692307692307692
"10183";12547;157;10183;6;19;31;12;0,128205128205128;0,205128205128205
"10184";12678;65;10184;3;16;65;49;0,25;1
"10185";12678;65;10185;4;32;57;25;0,5;0,875
"10186";12678;65;10186;4;40;65;25;0,625;1
"10187";12678;65;10187;4;24;48;24;0,375;0,75
"10188";12678;65;10188;4;32;65;33;0,5;1
"10189";12678;65;10189;4;24;57;33;0,375;0,875
"10190";12678;65;10190;4;24;65;41;0,375;1
"10191";12678;65;10191;5;11;24;13;0,1875;0,375
"10192";12678;65;10192;5;36;48;12;0,5625;0,75
"10193";12678;65;10193;5;48;61;13;0,75;0,9375
"10194";12678;65;10194;5;28;40;12;0,4375;0,625
"10195";12678;65;10195;5;44;57;13;0,6875;0,875
"10196";12678;65;10196;5;44;61;17;0,6875;0,9375
"10197";12678;65;10197;5;44;65;21;0,6875;1
"10198";12678;65;10198;5;48;65;17;0,75;1
"10199";12678;65;10199;5;53;65;12;0,8125;1
"10200";12678;65;10200;5;28;44;16;0,4375;0,6875
"10201";12678;65;10201;5;32;44;12;0,5;0,6875
"10202";12678;65;10202;5;32;48;16;0,5;0,75
"10203";12678;65;10203;5;36;53;17;0,5625;0,8125
"10204";12678;65;10204;5;40;53;13;0,625;0,8125
"10205";12678;65;10205;5;40;57;17;0,625;0,875
"10206";12678;65;10206;5;40;61;21;0,625;0,9375
"10207";12678;65;10207;5;20;32;12;0,3125;0,5
"10208";12678;65;10208;5;40;65;25;0,625;1
"10209";12678;65;10209;5;36;57;21;0,5625;0,875
"10210";12678;65;10210;5;32;53;21;0,5;0,8125
"10211";12678;65;10211;5;36;61;25;0,5625;0,9375
"10212";12678;65;10212;5;36;65;29;0,5625;1
"10213";12678;65;10213;5;28;48;20;0,4375;0,75
"10214";12678;65;10214;5;28;53;25;0,4375;0,8125
"10215";12678;65;10215;5;24;36;12;0,375;0,5625
"10216";12678;65;10216;6;17;23;6;0,272727272727273;0,363636363636364
"10217";12678;65;10217;6;55;61;6;0,848484848484849;0,939393939393939
"10218";12678;65;10218;6;27;33;6;0,424242424242424;0,515151515151515
"10219";12678;65;10219;6;27;35;8;0,424242424242424;0,545454545454545
"10220";12678;65;10220;6;31;37;6;0,484848484848485;0,575757575757576
"10221";12678;65;10221;6;37;43;6;0,575757575757576;0,666666666666667
"10222";12678;65;10222;6;37;45;8;0,575757575757576;0,696969696969697
"10223";12678;65;10223;6;37;47;10;0,575757575757576;0,727272727272727
"10224";12678;65;10224;6;39;45;6;0,606060606060606;0,696969696969697
"10225";12678;65;10225;6;39;47;8;0,606060606060606;0,727272727272727
"10226";12678;65;10226;6;43;49;6;0,666666666666667;0,757575757575758
"10227";12678;65;10227;6;45;51;6;0,696969696969697;0,787878787878788
"10228";12678;65;10228;6;45;53;8;0,696969696969697;0,818181818181818
"10229";12678;65;10229;6;45;55;10;0,696969696969697;0,848484848484849
"10230";12678;65;10230;6;47;53;6;0,727272727272727;0,818181818181818
"10231";12678;65;10231;6;47;55;8;0,727272727272727;0,848484848484849
"10232";12678;65;10232;6;47;57;10;0,727272727272727;0,878787878787879
"10233";12678;65;10233;6;49;55;6;0,757575757575758;0,848484848484849
"10234";12678;65;10234;6;49;57;8;0,757575757575758;0,878787878787879
"10235";12678;65;10235;6;55;63;8;0,848484848484849;0,96969696969697
"10236";12678;65;10236;6;55;65;10;0,848484848484849;1
"10237";12678;65;10237;6;57;63;6;0,878787878787879;0,96969696969697
"10238";12678;65;10238;6;57;65;8;0,878787878787879;1
"10239";12678;65;10239;6;59;65;6;0,909090909090909;1
"10240";12678;65;10240;6;27;37;10;0,424242424242424;0,575757575757576
"10241";12678;65;10241;6;29;35;6;0,454545454545455;0,545454545454545
"10242";12678;65;10242;6;29;37;8;0,454545454545455;0,575757575757576
"10243";12678;65;10243;6;31;39;8;0,484848484848485;0,606060606060606
"10244";12678;65;10244;6;33;39;6;0,515151515151515;0,606060606060606
"10245";12678;65;10245;6;39;49;10;0,606060606060606;0,757575757575758
"10246";12678;65;10246;6;41;47;6;0,636363636363636;0,727272727272727
"10247";12678;65;10247;6;41;49;8;0,636363636363636;0,757575757575758
"10248";12678;65;10248;6;43;51;8;0,666666666666667;0,787878787878788
"10249";12678;65;10249;6;45;57;12;0,696969696969697;0,878787878787879
"10250";12678;65;10250;6;45;59;14;0,696969696969697;0,909090909090909
"10251";12678;65;10251;6;45;61;16;0,696969696969697;0,939393939393939
"10252";12678;65;10252;6;45;63;18;0,696969696969697;0,96969696969697
"10253";12678;65;10253;6;49;59;10;0,757575757575758;0,909090909090909
"10254";12678;65;10254;6;9;15;6;0,151515151515152;0,242424242424242
"10255";12678;65;10255;6;11;17;6;0,181818181818182;0,272727272727273
"10256";12678;65;10256;6;15;21;6;0,242424242424242;0,333333333333333
"10257";12678;65;10257;6;25;31;6;0,393939393939394;0,484848484848485
"10258";12678;65;10258;6;53;59;6;0,818181818181818;0,909090909090909
"10259";12678;65;10259;6;53;61;8;0,818181818181818;0,939393939393939
"10260";12678;65;10260;6;53;63;10;0,818181818181818;0,96969696969697
"10261";12678;65;10261;6;53;65;12;0,818181818181818;1
"10262";12678;65;10262;6;7;13;6;0,121212121212121;0,212121212121212
"10263";12678;65;10263;6;9;17;8;0,151515151515152;0,272727272727273
"10264";12678;65;10264;6;43;53;10;0,666666666666667;0,818181818181818
"10265";12678;65;10265;6;43;55;12;0,666666666666667;0,848484848484849
"10266";12678;65;10266;6;45;65;20;0,696969696969697;1
"10267";12678;65;10267;6;47;59;12;0,727272727272727;0,909090909090909
"10268";12678;65;10268;6;47;61;14;0,727272727272727;0,939393939393939
"10269";12678;65;10269;6;47;63;16;0,727272727272727;0,96969696969697
"10270";12678;65;10270;6;47;65;18;0,727272727272727;1
"10271";12678;65;10271;6;49;61;12;0,757575757575758;0,939393939393939
"10272";12678;65;10272;6;49;63;14;0,757575757575758;0,96969696969697
"10273";12678;65;10273;6;49;65;16;0,757575757575758;1
"10274";12678;65;10274;6;19;25;6;0,303030303030303;0,393939393939394
"10275";12678;65;10275;6;35;41;6;0,545454545454545;0,636363636363636
"10276";12678;65;10276;6;17;25;8;0,272727272727273;0,393939393939394
"10277";12678;65;10277;6;37;49;12;0,575757575757576;0,757575757575758
"10278";12678;65;10278;6;37;51;14;0,575757575757576;0,787878787878788
"10279";12678;65;10279;6;37;53;16;0,575757575757576;0,818181818181818
"10280";12678;65;10280;6;37;55;18;0,575757575757576;0,848484848484849
"10281";12678;65;10281;6;39;51;12;0,606060606060606;0,787878787878788
"10282";12678;65;10282;6;39;53;14;0,606060606060606;0,818181818181818
"10283";12678;65;10283;6;39;55;16;0,606060606060606;0,848484848484849
"10284";12678;65;10284;6;39;57;18;0,606060606060606;0,878787878787879
"10285";12678;65;10285;6;39;59;20;0,606060606060606;0,909090909090909
"10286";12678;65;10286;6;39;61;22;0,606060606060606;0,939393939393939
"10287";12678;65;10287;6;13;19;6;0,212121212121212;0,303030303030303
"10288";12678;65;10288;6;15;23;8;0,242424242424242;0,363636363636364
"10289";12678;65;10289;6;43;57;14;0,666666666666667;0,878787878787879
"10290";12678;65;10290;6;33;41;8;0,515151515151515;0,636363636363636
"10291";12678;65;10291;6;33;43;10;0,515151515151515;0,666666666666667
"10292";12678;65;10292;6;41;51;10;0,636363636363636;0,787878787878788
"10293";12678;65;10293;6;41;53;12;0,636363636363636;0,818181818181818
"10294";12678;65;10294;6;41;55;14;0,636363636363636;0,848484848484849
"10295";12678;65;10295;6;23;29;6;0,363636363636364;0,454545454545455
"10296";12678;65;10296;6;25;33;8;0,393939393939394;0,515151515151515
"10297";12678;65;10297;6;27;39;12;0,424242424242424;0,606060606060606
"10298";12678;65;10298;6;43;59;16;0,666666666666667;0,909090909090909
"10299";12678;65;10299;6;43;61;18;0,666666666666667;0,939393939393939
"10300";12678;65;10300;6;13;21;8;0,212121212121212;0,333333333333333
"10301";12678;65;10301;6;25;35;10;0,393939393939394;0,545454545454545
"10302";12678;65;10302;6;39;63;24;0,606060606060606;0,96969696969697
"10303";12678;65;10303;6;37;57;20;0,575757575757576;0,878787878787879
"10304";13044;80;10304;4;15;40;25;0,2;0,5
"10305";13044;80;10305;4;23;48;25;0,3;0,6
"10306";13044;80;10306;5;3;15;12;0,05;0,2
"10307";13044;80;10307;5;15;27;12;0,2;0,35
"10308";13044;80;10308;5;35;48;13;0,45;0,6
"10309";13044;80;10309;5;48;60;12;0,6;0,75
"10310";13044;80;10310;5;23;35;12;0,3;0,45
"10311";13044;80;10311;5;7;19;12;0,1;0,25
"10312";13044;80;10312;5;64;76;12;0,8;0,95
"10313";13044;80;10313;5;11;23;12;0,15;0,3
"10314";13044;80;10314;5;27;40;13;0,35;0,5
"10315";13044;80;10315;5;68;80;12;0,85;1
"10316";13044;80;10316;5;31;44;13;0,4;0,55
"10317";13044;80;10317;5;19;31;12;0,25;0,4
"10318";13044;80;10318;6;15;21;6;0,2;0,275
"10319";13044;80;10319;6;1;7;6;0,025;0,1
"10320";13044;80;10320;6;11;17;6;0,15;0,225
"10321";13044;80;10321;6;19;25;6;0,25;0,325
"10322";13044;80;10322;6;29;35;6;0,375;0,45
"10323";13044;80;10323;6;70;76;6;0,875;0,95
"10324";13044;80;10324;6;72;78;6;0,9;0,975
"10325";13044;80;10325;6;27;33;6;0,35;0,425
"10326";13044;80;10326;6;7;13;6;0,1;0,175
"10327";13044;80;10327;6;15;23;8;0,2;0,3
"10328";13044;80;10328;6;17;23;6;0,225;0,3
"10329";13044;80;10329;6;40;46;6;0,5;0,575
"10330";13044;80;10330;6;54;60;6;0,675;0,75
"10331";13044;80;10331;6;68;74;6;0,85;0,925
"10332";13044;80;10332;6;70;78;8;0,875;0,975
"10333";13044;80;10333;6;9;15;6;0,125;0,2
"10334";13044;80;10334;6;68;76;8;0,85;0,95
"10335";13044;80;10335;6;68;78;10;0,85;0,975
"10336";13044;80;10336;6;5;11;6;0,075;0,15
"10337";13044;80;10337;6;42;48;6;0,525;0,6
"10338";13044;80;10338;6;35;42;7;0,45;0,525
"10339";13044;80;10339;6;31;37;6;0,4;0,475
"10340";13044;80;10340;6;21;27;6;0,275;0,35
"10341";13044;80;10341;6;25;31;6;0,325;0,4
"10342";13044;80;10342;6;33;40;7;0,425;0,5
"10343";13044;80;10343;6;3;9;6;0,05;0,125
"10344";13044;80;10344;6;13;19;6;0,175;0,25
"10345";13044;80;10345;6;74;80;6;0,925;1
"10346";13044;80;10346;6;62;68;6;0,775;0,85
"10347";13044;80;10347;6;66;72;6;0,825;0,9
"10348";13044;80;10348;6;1;9;8;0,025;0,125
"10349";13079;96;10349;3;31;80;49;0,333333333333333;0,833333333333333
"10350";13079;96;10350;3;48;96;48;0,5;1
"10351";13079;96;10351;4;64;88;24;0,666666666666667;0,916666666666667
"10352";13079;96;10352;4;64;96;32;0,666666666666667;1
"10353";13079;96;10353;4;72;96;24;0,75;1
"10354";13079;96;10354;4;31;56;25;0,333333333333333;0,583333333333333
"10355";13079;96;10355;4;56;80;24;0,583333333333333;0,833333333333333
"10356";13079;96;10356;4;56;88;32;0,583333333333333;0,916666666666667
"10357";13079;96;10357;4;56;96;40;0,583333333333333;1
"10358";13079;96;10358;4;7;31;24;0,0833333333333333;0,333333333333333
"10359";13079;96;10359;4;23;48;25;0,25;0,5
"10360";13079;96;10360;5;35;48;13;0,375;0,5
"10361";13079;96;10361;5;64;76;12;0,666666666666667;0,791666666666667
"10362";13079;96;10362;5;64;80;16;0,666666666666667;0,833333333333333
"10363";13079;96;10363;5;72;84;12;0,75;0,875
"10364";13079;96;10364;5;76;88;12;0,791666666666667;0,916666666666667
"10365";13079;96;10365;5;7;19;12;0,0833333333333333;0,208333333333333
"10366";13079;96;10366;5;56;68;12;0,583333333333333;0,708333333333333
"10367";13079;96;10367;5;72;88;16;0,75;0,916666666666667
"10368";13079;96;10368;5;72;92;20;0,75;0,958333333333333
"10369";13079;96;10369;5;76;92;16;0,791666666666667;0,958333333333333
"10370";13079;96;10370;5;76;96;20;0,791666666666667;1
"10371";13079;96;10371;5;68;80;12;0,708333333333333;0,833333333333333
"10372";13079;96;10372;5;72;96;24;0,75;1
"10373";13079;96;10373;5;27;39;12;0,291666666666667;0,416666666666667
"10374";13079;96;10374;5;60;72;12;0,625;0,75
"10375";13079;96;10375;5;60;76;16;0,625;0,791666666666667
"10376";13079;96;10376;5;11;23;12;0,125;0,25
"10377";13079;96;10377;5;23;35;12;0,25;0,375
"10378";13079;96;10378;5;19;31;12;0,208333333333333;0,333333333333333
"10379";13079;96;10379;5;68;84;16;0,708333333333333;0,875
"10380";13079;96;10380;5;68;88;20;0,708333333333333;0,916666666666667
"10381";13079;96;10381;5;64;84;20;0,666666666666667;0,875
"10382";13079;96;10382;5;31;43;12;0,333333333333333;0,458333333333333
"10383";13079;96;10383;5;56;72;16;0,583333333333333;0,75
"10384";13079;96;10384;5;56;76;20;0,583333333333333;0,791666666666667
"10385";13079;96;10385;5;64;88;24;0,666666666666667;0,916666666666667
"10386";13079;96;10386;5;64;92;28;0,666666666666667;0,958333333333333
"10387";13079;96;10387;5;64;96;32;0,666666666666667;1
"10388";13079;96;10388;5;68;92;24;0,708333333333333;0,958333333333333
"10389";13079;96;10389;5;68;96;28;0,708333333333333;1
"10390";13079;96;10390;5;39;52;13;0,416666666666667;0,541666666666667
"10391";13079;96;10391;5;39;56;17;0,416666666666667;0,583333333333333
"10392";13079;96;10392;5;48;60;12;0,5;0,625
"10393";13079;96;10393;5;31;48;17;0,333333333333333;0,5
"10394";13079;96;10394;5;56;80;24;0,583333333333333;0,833333333333333
"10395";13079;96;10395;5;56;84;28;0,583333333333333;0,875
"10396";13079;96;10396;6;66;72;6;0,6875;0,75
"10397";13079;96;10397;6;56;62;6;0,583333333333333;0,645833333333333
"10398";13079;96;10398;6;58;64;6;0,604166666666667;0,666666666666667
"10399";13079;96;10399;6;66;74;8;0,6875;0,770833333333333
"10400";13079;96;10400;6;74;80;6;0,770833333333333;0,833333333333333
"10401";13079;96;10401;6;56;64;8;0,583333333333333;0,666666666666667
"10402";13079;96;10402;6;56;66;10;0,583333333333333;0,6875
"10403";13079;96;10403;6;64;70;6;0,666666666666667;0,729166666666667
"10404";13079;96;10404;6;68;74;6;0,708333333333333;0,770833333333333
"10405";13079;96;10405;6;74;82;8;0,770833333333333;0,854166666666667
"10406";13079;96;10406;6;74;84;10;0,770833333333333;0,875
"10407";13079;96;10407;6;13;19;6;0,145833333333333;0,208333333333333
"10408";13079;96;10408;6;25;31;6;0,270833333333333;0,333333333333333
"10409";13079;96;10409;6;35;41;6;0,375;0,4375
"10410";13079;96;10410;6;37;43;6;0,395833333333333;0,458333333333333
"10411";13079;96;10411;6;37;45;8;0,395833333333333;0,479166666666667
"10412";13079;96;10412;6;39;45;6;0,416666666666667;0,479166666666667
"10413";13079;96;10413;6;39;48;9;0,416666666666667;0,5
"10414";13079;96;10414;6;50;56;6;0,520833333333333;0,583333333333333
"10415";13079;96;10415;6;56;68;12;0,583333333333333;0,708333333333333
"10416";13079;96;10416;6;56;70;14;0,583333333333333;0,729166666666667
"10417";13079;96;10417;6;56;72;16;0,583333333333333;0,75
"10418";13079;96;10418;6;56;74;18;0,583333333333333;0,770833333333333
"10419";13079;96;10419;6;56;76;20;0,583333333333333;0,791666666666667
"10420";13079;96;10420;6;60;66;6;0,625;0,6875
"10421";13079;96;10421;6;60;68;8;0,625;0,708333333333333
"10422";13079;96;10422;6;60;70;10;0,625;0,729166666666667
"10423";13079;96;10423;6;60;72;12;0,625;0,75
"10424";13079;96;10424;6;64;72;8;0,666666666666667;0,75
"10425";13079;96;10425;6;48;54;6;0,5;0,5625
"10426";13079;96;10426;6;48;56;8;0,5;0,583333333333333
"10427";13079;96;10427;6;62;68;6;0,645833333333333;0,708333333333333
"10428";13079;96;10428;6;70;76;6;0,729166666666667;0,791666666666667
"10429";13079;96;10429;6;70;78;8;0,729166666666667;0,8125
"10430";13079;96;10430;6;70;80;10;0,729166666666667;0,833333333333333
"10431";13079;96;10431;6;70;82;12;0,729166666666667;0,854166666666667
"10432";13079;96;10432;6;74;86;12;0,770833333333333;0,895833333333333
"10433";13079;96;10433;6;15;21;6;0,166666666666667;0,229166666666667
"10434";13079;96;10434;6;33;39;6;0,354166666666667;0,416666666666667
"10435";13079;96;10435;6;35;43;8;0,375;0,458333333333333
"10436";13079;96;10436;6;7;13;6;0,0833333333333333;0,145833333333333
"10437";13079;96;10437;6;23;29;6;0,25;0,3125
"10438";13079;96;10438;6;33;41;8;0,354166666666667;0,4375
"10439";13079;96;10439;6;45;52;7;0,479166666666667;0,541666666666667
"10440";13079;96;10440;6;45;54;9;0,479166666666667;0,5625
"10441";13079;96;10441;6;45;56;11;0,479166666666667;0,583333333333333
"10442";13079;96;10442;6;62;70;8;0,645833333333333;0,729166666666667
"10443";13079;96;10443;6;62;72;10;0,645833333333333;0,75
"10444";13079;96;10444;6;62;74;12;0,645833333333333;0,770833333333333
"10445";13079;96;10445;6;64;74;10;0,666666666666667;0,770833333333333
"10446";13079;96;10446;6;31;37;6;0,333333333333333;0,395833333333333
"10447";13079;96;10447;6;60;74;14;0,625;0,770833333333333
"10448";13079;96;10448;6;58;66;8;0,604166666666667;0,6875
"10449";13079;96;10449;6;72;78;6;0,75;0,8125
"10450";13079;96;10450;6;72;80;8;0,75;0,833333333333333
"10451";13079;96;10451;6;21;27;6;0,229166666666667;0,291666666666667
"10452";13079;96;10452;6;62;76;14;0,645833333333333;0,791666666666667
"10453";13079;96;10453;6;31;39;8;0,333333333333333;0,416666666666667
"10454";13079;96;10454;6;37;48;11;0,395833333333333;0,5
"10455";13079;96;10455;6;60;76;16;0,625;0,791666666666667
"10456";13079;96;10456;6;60;78;18;0,625;0,8125
"10457";13079;96;10457;6;60;80;20;0,625;0,833333333333333
"10458";13079;96;10458;6;62;78;16;0,645833333333333;0,8125
"10459";13079;96;10459;6;62;80;18;0,645833333333333;0,833333333333333
"10460";13079;96;10460;6;62;82;20;0,645833333333333;0,854166666666667
"10461";13079;96;10461;6;64;76;12;0,666666666666667;0,791666666666667
"10462";13079;96;10462;6;64;78;14;0,666666666666667;0,8125
"10463";13079;96;10463;6;64;80;16;0,666666666666667;0,833333333333333
"10464";13079;96;10464;6;64;82;18;0,666666666666667;0,854166666666667
"10465";13079;96;10465;6;74;88;14;0,770833333333333;0,916666666666667
"10466";13079;96;10466;6;74;90;16;0,770833333333333;0,9375
"10467";13079;96;10467;6;74;92;18;0,770833333333333;0,958333333333333
"10468";13079;96;10468;6;74;94;20;0,770833333333333;0,979166666666667
"10469";13079;96;10469;6;66;76;10;0,6875;0,791666666666667
"10470";13079;96;10470;6;72;82;10;0,75;0,854166666666667
"10471";13079;96;10471;6;35;45;10;0,375;0,479166666666667
"10472";13079;96;10472;6;60;82;22;0,625;0,854166666666667
"10473";13079;96;10473;6;60;84;24;0,625;0,875
"10474";13079;96;10474;6;60;86;26;0,625;0,895833333333333
"10475";13079;96;10475;6;62;84;22;0,645833333333333;0,875
"10476";13079;96;10476;6;62;86;24;0,645833333333333;0,895833333333333
"10477";13079;96;10477;6;62;88;26;0,645833333333333;0,916666666666667
"10478";13079;96;10478;6;64;84;20;0,666666666666667;0,875
"10479";13079;96;10479;6;64;86;22;0,666666666666667;0,895833333333333
"10480";13079;96;10480;6;64;88;24;0,666666666666667;0,916666666666667
"10481";13079;96;10481;6;66;78;12;0,6875;0,8125
"10482";13079;96;10482;6;68;76;8;0,708333333333333;0,791666666666667
"10483";13079;96;10483;6;68;78;10;0,708333333333333;0,8125
"10484";13079;96;10484;6;70;84;14;0,729166666666667;0,875
"10485";13079;96;10485;6;70;86;16;0,729166666666667;0,895833333333333
"10486";13079;96;10486;6;70;88;18;0,729166666666667;0,916666666666667
"10487";13079;96;10487;6;52;58;6;0,541666666666667;0,604166666666667
"10488";13079;96;10488;6;58;68;10;0,604166666666667;0,708333333333333
"10489";13079;96;10489;6;58;70;12;0,604166666666667;0,729166666666667
"10490";13079;96;10490;6;29;35;6;0,3125;0,375
"10491";13079;96;10491;6;21;29;8;0,229166666666667;0,3125
"10492";13079;96;10492;6;43;50;7;0,458333333333333;0,520833333333333
"10493";13079;96;10493;6;29;37;8;0,3125;0,395833333333333
"10494";13079;96;10494;6;64;90;26;0,666666666666667;0,9375
"10495";13137;132;10495;5;32;57;25;0,25;0,4375
"10496";13137;132;10496;5;107;132;25;0,8125;1
"10497";13137;132;10497;6;31;43;12;0,242424242424242;0,333333333333333
"10498";13137;132;10498;6;35;47;12;0,272727272727273;0,363636363636364
"10499";13137;132;10499;6;112;124;12;0,848484848484849;0,939393939393939
"10500";13137;132;10500;6;112;128;16;0,848484848484849;0,96969696969697
"10501";13137;132;10501;6;116;128;12;0,878787878787879;0,96969696969697
"10502";13137;132;10502;6;35;51;16;0,272727272727273;0,393939393939394
"10503";13137;132;10503;6;35;55;20;0,272727272727273;0,424242424242424
"10504";13137;132;10504;6;116;132;16;0,878787878787879;1
"10505";13137;132;10505;6;120;132;12;0,909090909090909;1
"10506";13137;132;10506;6;68;80;12;0,515151515151515;0,606060606060606
"10507";13137;132;10507;6;108;120;12;0,818181818181818;0,909090909090909
"10508";13137;132;10508;6;39;51;12;0,303030303030303;0,393939393939394
"10509";13137;132;10509;6;39;55;16;0,303030303030303;0,424242424242424
"10510";13137;132;10510;6;39;59;20;0,303030303030303;0,454545454545455
"10511";13137;132;10511;6;39;63;24;0,303030303030303;0,484848484848485
"10512";13137;132;10512;6;84;96;12;0,636363636363636;0,727272727272727
"10513";13137;132;10513;6;11;23;12;0,0909090909090909;0,181818181818182
"10514";13137;132;10514;6;15;27;12;0,121212121212121;0,212121212121212
"10515";13137;132;10515;6;35;59;24;0,272727272727273;0,454545454545455
"10516";13137;132;10516;6;35;63;28;0,272727272727273;0,484848484848485
"10517";13137;132;10517;6;112;132;20;0,848484848484849;1
"10518";13137;132;10518;6;23;35;12;0,181818181818182;0,272727272727273
"10519";13137;132;10519;6;108;124;16;0,818181818181818;0,939393939393939
"10520";13137;132;10520;6;108;128;20;0,818181818181818;0,96969696969697
"10521";13939;40;10521;4;28;40;12;0,7;1
"10522";13939;40;10522;4;24;36;12;0,6;0,9
"10523";13939;40;10523;5;17;24;7;0,45;0,6
"10524";13939;40;10524;5;28;34;6;0,7;0,85
"10525";13939;40;10525;5;28;36;8;0,7;0,9
"10526";13939;40;10526;5;28;38;10;0,7;0,95
"10527";13939;40;10527;5;26;32;6;0,65;0,8
"10528";13939;40;10528;5;15;22;7;0,4;0,55
"10529";13939;40;10529;5;15;24;9;0,4;0,6
"10530";14564;96;10530;3;15;64;49;0,166666666666667;0,666666666666667
"10531";14564;96;10531;4;7;31;24;0,0833333333333333;0,333333333333333
"10532";14564;96;10532;4;15;39;24;0,166666666666667;0,416666666666667
"10533";14564;96;10533;4;72;96;24;0,75;1
"10534";14564;96;10534;4;64;88;24;0,666666666666667;0,916666666666667
"10535";14564;96;10535;5;7;19;12;0,0833333333333333;0,208333333333333
"10536";14564;96;10536;5;11;23;12;0,125;0,25
"10537";14564;96;10537;5;27;39;12;0,291666666666667;0,416666666666667
"10538";14564;96;10538;5;27;43;16;0,291666666666667;0,458333333333333
"10539";14564;96;10539;5;31;43;12;0,333333333333333;0,458333333333333
"10540";14564;96;10540;5;7;23;16;0,0833333333333333;0,25
"10541";14564;96;10541;5;7;27;20;0,0833333333333333;0,291666666666667
"10542";14564;96;10542;5;11;27;16;0,125;0,291666666666667
"10543";14564;96;10543;5;11;31;20;0,125;0,333333333333333
"10544";14564;96;10544;5;15;27;12;0,166666666666667;0,291666666666667
"10545";14564;96;10545;5;15;31;16;0,166666666666667;0,333333333333333
"10546";14564;96;10546;5;19;31;12;0,208333333333333;0,333333333333333
"10547";14564;96;10547;5;19;35;16;0,208333333333333;0,375
"10548";14564;96;10548;5;3;15;12;0,0416666666666667;0,166666666666667
"10549";14564;96;10549;5;3;19;16;0,0416666666666667;0,208333333333333
"10550";14564;96;10550;5;35;48;13;0,375;0,5
"10551";14564;96;10551;5;60;72;12;0,625;0,75
"10552";14564;96;10552;5;84;96;12;0,875;1
"10553";14564;96;10553;5;72;84;12;0,75;0,875
"10554";14564;96;10554;5;7;31;24;0,0833333333333333;0,333333333333333
"10555";14564;96;10555;5;15;35;20;0,166666666666667;0,375
"10556";14564;96;10556;5;56;68;12;0,583333333333333;0,708333333333333
"10557";14564;96;10557;5;76;88;12;0,791666666666667;0,916666666666667
"10558";14564;96;10558;6;5;11;6;0,0625;0,125
"10559";14564;96;10559;6;39;45;6;0,416666666666667;0,479166666666667
"10560";14564;96;10560;6;56;62;6;0,583333333333333;0,645833333333333
"10561";14564;96;10561;6;60;66;6;0,625;0,6875
"10562";14564;96;10562;6;64;70;6;0,666666666666667;0,729166666666667
"10563";14564;96;10563;6;78;84;6;0,8125;0,875
"10564";14564;96;10564;6;7;13;6;0,0833333333333333;0,145833333333333
"10565";14564;96;10565;6;7;15;8;0,0833333333333333;0,166666666666667
"10566";14564;96;10566;6;11;17;6;0,125;0,1875
"10567";14564;96;10567;6;11;19;8;0,125;0,208333333333333
"10568";14564;96;10568;6;11;21;10;0,125;0,229166666666667
"10569";14564;96;10569;6;13;19;6;0,145833333333333;0,208333333333333
"10570";14564;96;10570;6;13;21;8;0,145833333333333;0,229166666666667
"10571";14564;96;10571;6;17;23;6;0,1875;0,25
"10572";14564;96;10572;6;19;25;6;0,208333333333333;0,270833333333333
"10573";14564;96;10573;6;19;27;8;0,208333333333333;0,291666666666667
"10574";14564;96;10574;6;19;29;10;0,208333333333333;0,3125
"10575";14564;96;10575;6;21;27;6;0,229166666666667;0,291666666666667
"10576";14564;96;10576;6;21;29;8;0,229166666666667;0,3125
"10577";14564;96;10577;6;29;35;6;0,3125;0,375
"10578";14564;96;10578;6;31;37;6;0,333333333333333;0,395833333333333
"10579";14564;96;10579;6;62;68;6;0,645833333333333;0,708333333333333
"10580";14564;96;10580;6;64;72;8;0,666666666666667;0,75
"10581";14564;96;10581;6;66;72;6;0,6875;0,75
"10582";14564;96;10582;6;3;9;6;0,0416666666666667;0,104166666666667
"10583";14564;96;10583;6;5;13;8;0,0625;0,145833333333333
"10584";14564;96;10584;6;5;15;10;0,0625;0,166666666666667
"10585";14564;96;10585;6;5;17;12;0,0625;0,1875
"10586";14564;96;10586;6;5;19;14;0,0625;0,208333333333333
"10587";14564;96;10587;6;11;23;12;0,125;0,25
"10588";14564;96;10588;6;11;25;14;0,125;0,270833333333333
"10589";14564;96;10589;6;11;27;16;0,125;0,291666666666667
"10590";14564;96;10590;6;17;25;8;0,1875;0,270833333333333
"10591";14564;96;10591;6;17;27;10;0,1875;0,291666666666667
"10592";14564;96;10592;6;43;50;7;0,458333333333333;0,520833333333333
"10593";14564;96;10593;6;27;33;6;0,291666666666667;0,354166666666667
"10594";14564;96;10594;6;76;82;6;0,791666666666667;0,854166666666667
"10595";14564;96;10595;6;31;39;8;0,333333333333333;0,416666666666667
"10596";14564;96;10596;6;37;43;6;0,395833333333333;0,458333333333333
"10597";14564;96;10597;6;58;64;6;0,604166666666667;0,666666666666667
"10598";14564;96;10598;6;62;70;8;0,645833333333333;0,729166666666667
"10599";14564;96;10599;6;86;92;6;0,895833333333333;0,958333333333333
"10600";14564;96;10600;6;86;94;8;0,895833333333333;0,979166666666667
"10601";14564;96;10601;6;76;84;8;0,791666666666667;0,875
"10602";14564;96;10602;6;13;23;10;0,145833333333333;0,25
"10603";14564;96;10603;6;17;29;12;0,1875;0,3125
"10604";14564;96;10604;6;29;37;8;0,3125;0,395833333333333
"10605";14564;96;10605;6;41;48;7;0,4375;0,5
"10606";14564;96;10606;6;41;50;9;0,4375;0,520833333333333
"10607";14564;96;10607;6;7;17;10;0,0833333333333333;0,1875
"10608";14564;96;10608;6;13;25;12;0,145833333333333;0,270833333333333
"10609";14564;96;10609;6;13;27;14;0,145833333333333;0,291666666666667
"10610";14564;96;10610;6;13;29;16;0,145833333333333;0,3125
"10611";14564;96;10611;6;33;39;6;0,354166666666667;0,416666666666667
"10612";14564;96;10612;6;58;66;8;0,604166666666667;0,6875
"10613";14564;96;10613;6;72;78;6;0,75;0,8125
"10614";14564;96;10614;6;84;90;6;0,875;0,9375
"10615";14564;96;10615;6;27;35;8;0,291666666666667;0,375
"10616";14564;96;10616;6;84;92;8;0,875;0,958333333333333
"10617";14564;96;10617;6;84;94;10;0,875;0,979166666666667
"10618";14564;96;10618;6;84;96;12;0,875;1
"10619";14564;96;10619;6;86;96;10;0,895833333333333;1
"10620";14564;96;10620;6;58;68;10;0,604166666666667;0,708333333333333
"10621";14564;96;10621;6;15;21;6;0,166666666666667;0,229166666666667
"10622";14564;96;10622;6;15;23;8;0,166666666666667;0,25
"10623";14564;96;10623;6;11;29;18;0,125;0,3125
"10624";14564;96;10624;6;15;25;10;0,166666666666667;0,270833333333333
"10625";14564;96;10625;6;15;27;12;0,166666666666667;0,291666666666667
"10626";14564;96;10626;6;62;72;10;0,645833333333333;0,75
"10627";14564;96;10627;6;72;80;8;0,75;0,833333333333333
"10628";14564;96;10628;6;27;37;10;0,291666666666667;0,395833333333333
"10629";14564;96;10629;6;3;11;8;0,0416666666666667;0,125
"10630";14564;96;10630;6;3;13;10;0,0416666666666667;0,145833333333333
"10631";14564;96;10631;6;7;19;12;0,0833333333333333;0,208333333333333
"10632";14564;96;10632;6;7;21;14;0,0833333333333333;0,229166666666667
"10633";14564;96;10633;6;37;45;8;0,395833333333333;0,479166666666667
"10634";14564;96;10634;6;78;86;8;0,8125;0,895833333333333
"10635";14564;96;10635;6;39;48;9;0,416666666666667;0,5
"10636";14564;96;10636;6;29;39;10;0,3125;0,416666666666667
"10637";14564;96;10637;6;7;23;16;0,0833333333333333;0,25
"10638";14564;96;10638;6;7;25;18;0,0833333333333333;0,270833333333333
"10639";14886;145;10639;4;80;129;49;0,555555555555556;0,888888888888889
"10640";14886;145;10640;4;96;145;49;0,666666666666667;1
"10641";14886;145;10641;4;64;113;49;0,444444444444444;0,777777777777778
"10642";14886;145;10642;5;96;121;25;0,666666666666667;0,833333333333333
"10643";14886;145;10643;5;56;80;24;0,388888888888889;0,555555555555556
"10644";14886;145;10644;5;80;104;24;0,555555555555556;0,722222222222222
"10645";14886;145;10645;5;88;113;25;0,611111111111111;0,777777777777778
"10646";14886;145;10646;5;88;121;33;0,611111111111111;0,833333333333333
"10647";14886;145;10647;5;64;88;24;0,444444444444444;0,611111111111111
"10648";14886;145;10648;5;40;64;24;0,277777777777778;0,444444444444444
"10649";14886;145;10649;5;72;96;24;0,5;0,666666666666667
"10650";14886;145;10650;5;48;72;24;0,333333333333333;0,5
"10651";14886;145;10651;5;104;129;25;0,722222222222222;0,888888888888889
"10652";14886;145;10652;5;113;137;24;0,777777777777778;0,944444444444444
"10653";14886;145;10653;5;96;129;33;0,666666666666667;0,888888888888889
"10654";14886;145;10654;6;56;68;12;0,388888888888889;0,472222222222222
"10655";14886;145;10655;6;60;72;12;0,416666666666667;0,5
"10656";14886;145;10656;6;44;56;12;0,305555555555556;0,388888888888889
"10657";14886;145;10657;6;84;96;12;0,583333333333333;0,666666666666667
"10658";14886;145;10658;6;52;64;12;0,361111111111111;0,444444444444444
"10659";14886;145;10659;6;100;113;13;0,694444444444444;0,777777777777778
"10660";14886;145;10660;6;121;133;12;0,833333333333333;0,916666666666667
"10661";14886;145;10661;6;23;36;13;0,166666666666667;0,25
"10662";14886;145;10662;6;56;72;16;0,388888888888889;0,5
"10663";14886;145;10663;6;60;76;16;0,416666666666667;0,527777777777778
"10664";14886;145;10664;6;64;76;12;0,444444444444444;0,527777777777778
"10665";14886;145;10665;6;88;100;12;0,611111111111111;0,694444444444444
"10666";14886;145;10666;6;100;117;17;0,694444444444444;0,805555555555556
"10667";14886;145;10667;6;100;121;21;0,694444444444444;0,833333333333333
"10668";14886;145;10668;6;104;117;13;0,722222222222222;0,805555555555556
"10669";14886;145;10669;6;104;121;17;0,722222222222222;0,833333333333333
"10670";14886;145;10670;6;72;84;12;0,5;0,583333333333333
"10671";14886;145;10671;6;96;108;12;0,666666666666667;0,75
"10672";14886;145;10672;6;96;113;17;0,666666666666667;0,777777777777778
"10673";14886;145;10673;6;96;117;21;0,666666666666667;0,805555555555556
"10674";14886;145;10674;6;113;125;12;0,777777777777778;0,861111111111111
"10675";14886;145;10675;6;48;60;12;0,333333333333333;0,416666666666667
"10676";14886;145;10676;6;68;80;12;0,472222222222222;0,555555555555556
"10677";14886;145;10677;6;27;40;13;0,194444444444444;0,277777777777778
"10678";14886;145;10678;6;92;104;12;0,638888888888889;0,722222222222222
"10679";14886;145;10679;6;84;100;16;0,583333333333333;0,694444444444444
"10680";14886;145;10680;6;108;121;13;0,75;0,833333333333333
"10681";14886;145;10681;6;88;104;16;0,611111111111111;0,722222222222222
"10682";14886;145;10682;6;64;80;16;0,444444444444444;0,555555555555556
"10683";14886;145;10683;6;19;31;12;0,138888888888889;0,222222222222222
"10684";14886;145;10684;6;80;92;12;0,555555555555556;0,638888888888889
"10685";14886;145;10685;6;40;52;12;0,277777777777778;0,361111111111111
"10686";14886;145;10686;6;52;68;16;0,361111111111111;0,472222222222222
"10687";14886;145;10687;6;84;104;20;0,583333333333333;0,722222222222222
"10688";14886;145;10688;6;117;129;12;0,805555555555556;0,888888888888889
"10689";14886;145;10689;6;80;96;16;0,555555555555556;0,666666666666667
"10690";14984;26;10690;3;12;26;14;0,5;1
"10691";14984;26;10691;3;8;22;14;0,333333333333333;0,833333333333333
"10692";14984;26;10692;3;4;17;13;0,166666666666667;0,666666666666667
"10693";14984;26;10693;4;1;7;6;0,0769230769230769;0,307692307692308
"10694";14984;26;10694;4;18;24;6;0,692307692307692;0,923076923076923
"10695";14984;26;10695;4;9;16;7;0,384615384615385;0,615384615384615
"10696";14984;26;10696;4;7;14;7;0,307692307692308;0,538461538461538
"10697";14984;26;10697;4;20;26;6;0,769230769230769;1
"10698";14984;26;10698;4;14;20;6;0,538461538461538;0,769230769230769
"10699";14984;26;10699;4;18;26;8;0,692307692307692;1
"10700";14984;26;10700;4;16;22;6;0,615384615384615;0,846153846153846
"10701";14984;26;10701;4;3;9;6;0,153846153846154;0,384615384615385
"10702";14984;26;10702;4;16;24;8;0,615384615384615;0,923076923076923
"10703";14984;26;10703;4;16;26;10;0,615384615384615;1
"10704";14984;26;10704;4;9;18;9;0,384615384615385;0,692307692307692
"10705";14984;26;10705;4;11;18;7;0,461538461538462;0,692307692307692
"10706";14984;26;10706;4;5;11;6;0,230769230769231;0,461538461538462
"10707";14984;26;10707;4;14;22;8;0,538461538461538;0,846153846153846
"10708";15309;59;10708;3;16;42;26;0,285714285714286;0,714285714285714
"10709";15309;59;10709;3;25;50;25;0,428571428571429;0,857142857142857
"10710";15309;59;10710;3;33;59;26;0,571428571428571;1
"10711";15309;59;10711;3;8;33;25;0,142857142857143;0,571428571428571
"10712";15309;59;10712;3;25;59;34;0,428571428571429;1
"10713";15309;59;10713;3;8;42;34;0,142857142857143;0,714285714285714
"10714";15309;59;10714;3;16;50;34;0,285714285714286;0,857142857142857
"10715";15309;59;10715;4;27;39;12;0,466666666666667;0,666666666666667
"10716";15309;59;10716;4;19;31;12;0,333333333333333;0,533333333333333
"10717";15309;59;10717;4;23;35;12;0,4;0,6
"10718";15309;59;10718;4;27;43;16;0,466666666666667;0,733333333333333
"10719";15309;59;10719;4;31;43;12;0,533333333333333;0,733333333333333
"10720";15309;59;10720;4;31;47;16;0,533333333333333;0,8
"10721";15309;59;10721;4;35;47;12;0,6;0,8
"10722";15309;59;10722;4;39;51;12;0,666666666666667;0,866666666666667
"10723";15309;59;10723;4;43;55;12;0,733333333333333;0,933333333333333
"10724";15309;59;10724;4;43;59;16;0,733333333333333;1
"10725";15309;59;10725;4;19;35;16;0,333333333333333;0,6
"10726";15309;59;10726;4;23;39;16;0,4;0,666666666666667
"10727";15309;59;10727;4;23;43;20;0,4;0,733333333333333
"10728";15309;59;10728;4;35;51;16;0,6;0,866666666666667
"10729";15309;59;10729;4;39;55;16;0,666666666666667;0,933333333333333
"10730";15309;59;10730;4;7;19;12;0,133333333333333;0,333333333333333
"10731";15309;59;10731;4;27;47;20;0,466666666666667;0,8
"10732";15309;59;10732;4;27;51;24;0,466666666666667;0,866666666666667
"10733";15309;59;10733;4;31;51;20;0,533333333333333;0,866666666666667
"10734";15309;59;10734;4;47;59;12;0,8;1
"10735";15309;59;10735;4;35;55;20;0,6;0,933333333333333
"10736";15309;59;10736;4;15;27;12;0,266666666666667;0,466666666666667
"10737";15309;59;10737;4;11;23;12;0,2;0,4
"10738";15309;59;10738;4;15;31;16;0,266666666666667;0,533333333333333
"10739";15309;59;10739;4;39;59;20;0,666666666666667;1
"10740";15309;59;10740;5;13;19;6;0,233333333333333;0,333333333333333
"10741";15309;59;10741;5;25;31;6;0,433333333333333;0,533333333333333
"10742";15309;59;10742;5;45;51;6;0,766666666666667;0,866666666666667
"10743";15309;59;10743;5;3;9;6;0,0666666666666667;0,166666666666667
"10744";15309;59;10744;5;9;15;6;0,166666666666667;0,266666666666667
"10745";15309;59;10745;5;15;21;6;0,266666666666667;0,366666666666667
"10746";15309;59;10746;5;25;33;8;0,433333333333333;0,566666666666667
"10747";15309;59;10747;5;31;37;6;0,533333333333333;0,633333333333333
"10748";15309;59;10748;5;37;43;6;0,633333333333333;0,733333333333333
"10749";15309;59;10749;5;39;45;6;0,666666666666667;0,766666666666667
"10750";15309;59;10750;5;43;49;6;0,733333333333333;0,833333333333333
"10751";15309;59;10751;5;43;51;8;0,733333333333333;0,866666666666667
"10752";15309;59;10752;5;11;17;6;0,2;0,3
"10753";15309;59;10753;5;23;29;6;0,4;0,5
"10754";15309;59;10754;5;25;35;10;0,433333333333333;0,6
"10755";15309;59;10755;5;25;37;12;0,433333333333333;0,633333333333333
"10756";15309;59;10756;5;27;33;6;0,466666666666667;0,566666666666667
"10757";15309;59;10757;5;27;35;8;0,466666666666667;0,6
"10758";15309;59;10758;5;27;37;10;0,466666666666667;0,633333333333333
"10759";15309;59;10759;5;31;39;8;0,533333333333333;0,666666666666667
"10760";15309;59;10760;5;31;41;10;0,533333333333333;0,7
"10761";15309;59;10761;5;31;43;12;0,533333333333333;0,733333333333333
"10762";15309;59;10762;5;33;39;6;0,566666666666667;0,666666666666667
"10763";15309;59;10763;5;41;47;6;0,7;0,8
"10764";15309;59;10764;5;37;45;8;0,633333333333333;0,766666666666667
"10765";15309;59;10765;5;37;47;10;0,633333333333333;0,8
"10766";15309;59;10766;5;39;47;8;0,666666666666667;0,8
"10767";15309;59;10767;5;7;13;6;0,133333333333333;0,233333333333333
"10768";15309;59;10768;5;25;39;14;0,433333333333333;0,666666666666667
"10769";15309;59;10769;5;33;41;8;0,566666666666667;0,7
"10770";15309;59;10770;5;37;49;12;0,633333333333333;0,833333333333333
"10771";15309;59;10771;5;37;51;14;0,633333333333333;0,866666666666667
"10772";15309;59;10772;5;39;49;10;0,666666666666667;0,833333333333333
"10773";15309;59;10773;5;39;51;12;0,666666666666667;0,866666666666667
"10774";15309;59;10774;5;53;59;6;0,9;1
"10775";15309;59;10775;5;11;19;8;0,2;0,333333333333333
"10776";15309;59;10776;5;35;41;6;0,6;0,7
"10777";15309;59;10777;5;35;43;8;0,6;0,733333333333333
"10778";15309;59;10778;5;43;53;10;0,733333333333333;0,9
"10779";15309;59;10779;5;43;55;12;0,733333333333333;0,933333333333333
"10780";15309;59;10780;5;45;53;8;0,766666666666667;0,9
"10781";15309;59;10781;5;51;57;6;0,866666666666667;0,966666666666667
"10782";15309;59;10782;5;41;49;8;0,7;0,833333333333333
"10783";15309;59;10783;5;41;51;10;0,7;0,866666666666667
"10784";15309;59;10784;5;45;55;10;0,766666666666667;0,933333333333333
"10785";15309;59;10785;5;13;21;8;0,233333333333333;0,366666666666667
"10786";15309;59;10786;5;39;53;14;0,666666666666667;0,9
"10787";15309;59;10787;5;43;57;14;0,733333333333333;0,966666666666667
"10788";15309;59;10788;5;45;57;12;0,766666666666667;0,966666666666667
"10789";15309;59;10789;5;45;59;14;0,766666666666667;1
"10790";15309;59;10790;5;47;53;6;0,8;0,9
"10791";15309;59;10791;5;47;55;8;0,8;0,933333333333333
"10792";15309;59;10792;5;47;57;10;0,8;0,966666666666667
"10793";15309;59;10793;5;27;39;12;0,466666666666667;0,666666666666667
"10794";15309;59;10794;5;29;35;6;0,5;0,6
"10795";15309;59;10795;5;29;37;8;0,5;0,633333333333333
"10796";15309;59;10796;5;23;31;8;0,4;0,533333333333333
"10797";15309;59;10797;5;33;43;10;0,566666666666667;0,733333333333333
"10798";15309;59;10798;5;5;11;6;0,1;0,2
"10799";15309;59;10799;5;23;33;10;0,4;0,566666666666667
"10800";15309;59;10800;5;51;59;8;0,866666666666667;1
"10801";15309;59;10801;5;33;45;12;0,566666666666667;0,766666666666667
"10802";15309;59;10802;5;35;45;10;0,6;0,766666666666667
"10803";15309;59;10803;5;35;47;12;0,6;0,8
"10804";15309;59;10804;5;17;23;6;0,3;0,4
"10805";15309;59;10805;5;21;27;6;0,366666666666667;0,466666666666667
"10806";15309;59;10806;5;31;45;14;0,533333333333333;0,766666666666667
"10807";15309;59;10807;5;31;47;16;0,533333333333333;0,8
"10808";15309;59;10808;5;33;47;14;0,566666666666667;0,8
"10809";15309;59;10809;5;49;55;6;0,833333333333333;0,933333333333333
"10810";15314;157;10810;3;38;157;119;0,25;1
"10811";15314;157;10811;4;69;122;53;0,444444444444444;0,777777777777778
"10812";15314;157;10812;4;87;139;52;0,555555555555556;0,888888888888889
"10813";15314;157;10813;4;52;104;52;0,333333333333333;0,666666666666667
"10814";15314;157;10814;5;82;107;25;0,526315789473684;0,684210526315789
"10815";15314;157;10815;5;82;115;33;0,526315789473684;0,736842105263158
"10816";15314;157;10816;5;82;124;42;0,526315789473684;0,789473684210526
"10817";15314;157;10817;5;90;115;25;0,578947368421053;0,736842105263158
"10818";15314;157;10818;5;90;124;34;0,578947368421053;0,789473684210526
"10819";15314;157;10819;5;99;124;25;0,631578947368421;0,789473684210526
"10820";15314;157;10820;5;132;157;25;0,842105263157895;1
"10821";15314;157;10821;5;74;99;25;0,473684210526316;0,631578947368421
"10822";15314;157;10822;5;124;149;25;0,789473684210526;0,947368421052632
"10823";15314;157;10823;5;57;82;25;0,368421052631579;0,526315789473684
"10824";15314;157;10824;5;74;107;33;0,473684210526316;0,684210526315789
"10825";15314;157;10825;5;107;132;25;0,684210526315789;0,842105263157895
"10826";15314;157;10826;5;41;66;25;0,263157894736842;0,421052631578947
"10827";15314;157;10827;5;66;90;24;0,421052631578947;0,578947368421053
"10828";15314;157;10828;5;66;99;33;0,421052631578947;0,631578947368421
"10829";15314;157;10829;5;66;107;41;0,421052631578947;0,684210526315789
"10830";15314;157;10830;5;74;115;41;0,473684210526316;0,736842105263158
"10831";15314;157;10831;5;49;74;25;0,315789473684211;0,473684210526316
"10832";15314;157;10832;6;15;27;12;0,102564102564103;0,179487179487179
"10833";15314;157;10833;6;15;31;16;0,102564102564103;0,205128205128205
"10834";15314;157;10834;6;121;133;12;0,769230769230769;0,846153846153846
"10835";15314;157;10835;6;11;23;12;0,0769230769230769;0,153846153846154
"10836";15314;157;10836;6;19;31;12;0,128205128205128;0,205128205128205
"10837";15314;157;10837;6;68;80;12;0,435897435897436;0,512820512820513
"10838";15314;157;10838;6;84;96;12;0,538461538461538;0,615384615384615
"10839";15314;157;10839;6;84;100;16;0,538461538461538;0,641025641025641
"10840";15314;157;10840;6;84;104;20;0,538461538461538;0,666666666666667
"10841";15314;157;10841;6;88;100;12;0,564102564102564;0,641025641025641
"10842";15314;157;10842;6;88;104;16;0,564102564102564;0,666666666666667
"10843";15314;157;10843;6;88;108;20;0,564102564102564;0,692307692307692
"10844";15314;157;10844;6;92;104;12;0,58974358974359;0,666666666666667
"10845";15314;157;10845;6;92;108;16;0,58974358974359;0,692307692307692
"10846";15314;157;10846;6;96;108;12;0,615384615384615;0,692307692307692
"10847";15314;157;10847;6;96;112;16;0,615384615384615;0,717948717948718
"10848";15314;157;10848;6;100;112;12;0,641025641025641;0,717948717948718
"10849";15314;157;10849;6;108;121;13;0,692307692307692;0,769230769230769
"10850";15314;157;10850;6;112;125;13;0,717948717948718;0,794871794871795
"10851";15314;157;10851;6;116;129;13;0,743589743589744;0,82051282051282
"10852";15314;157;10852;6;133;145;12;0,846153846153846;0,923076923076923
"10853";15314;157;10853;6;137;149;12;0,871794871794872;0,948717948717949
"10854";15314;157;10854;6;141;153;12;0,897435897435897;0,974358974358974
"10855";15314;157;10855;6;145;157;12;0,923076923076923;1
"10856";15314;157;10856;6;11;27;16;0,0769230769230769;0,179487179487179
"10857";15314;157;10857;6;11;31;20;0,0769230769230769;0,205128205128205
"10858";15314;157;10858;6;52;64;12;0,333333333333333;0,41025641025641
"10859";15314;157;10859;6;68;84;16;0,435897435897436;0,538461538461538
"10860";15314;157;10860;6;68;88;20;0,435897435897436;0,564102564102564
"10861";15314;157;10861;6;72;84;12;0,461538461538462;0,538461538461538
"10862";15314;157;10862;6;72;88;16;0,461538461538462;0,564102564102564
"10863";15314;157;10863;6;72;92;20;0,461538461538462;0,58974358974359
"10864";15314;157;10864;6;72;96;24;0,461538461538462;0,615384615384615
"10865";15314;157;10865;6;84;108;24;0,538461538461538;0,692307692307692
"10866";15314;157;10866;6;84;112;28;0,538461538461538;0,717948717948718
"10867";15314;157;10867;6;92;112;20;0,58974358974359;0,717948717948718
"10868";15314;157;10868;6;92;116;24;0,58974358974359;0,743589743589744
"10869";15314;157;10869;6;100;116;16;0,641025641025641;0,743589743589744
"10870";15314;157;10870;6;108;125;17;0,692307692307692;0,794871794871795
"10871";15314;157;10871;6;88;112;24;0,564102564102564;0,717948717948718
"10872";15314;157;10872;6;88;116;28;0,564102564102564;0,743589743589744
"10873";15314;157;10873;6;96;116;20;0,615384615384615;0,743589743589744
"10874";15314;157;10874;6;96;121;25;0,615384615384615;0,769230769230769
"10875";15314;157;10875;6;100;121;21;0,641025641025641;0,769230769230769
"10876";15314;157;10876;6;133;149;16;0,846153846153846;0,948717948717949
"10877";15314;157;10877;6;133;153;20;0,846153846153846;0,974358974358974
"10878";15314;157;10878;6;137;153;16;0,871794871794872;0,974358974358974
"10879";15314;157;10879;6;137;157;20;0,871794871794872;1
"10880";15314;157;10880;6;141;157;16;0,897435897435897;1
"10881";15314;157;10881;6;56;68;12;0,358974358974359;0,435897435897436
"10882";15314;157;10882;6;3;15;12;0,0256410256410256;0,102564102564103
"10883";15314;157;10883;6;64;76;12;0,41025641025641;0,487179487179487
"10884";15314;157;10884;6;31;44;13;0,205128205128205;0,282051282051282
"10885";15314;157;10885;6;92;121;29;0,58974358974359;0,769230769230769
"10886";15314;157;10886;6;7;19;12;0,0512820512820513;0,128205128205128
"10887";15314;157;10887;6;104;116;12;0,666666666666667;0,743589743589744
"10888";15314;157;10888;6;7;23;16;0,0512820512820513;0,153846153846154
"10889";15314;157;10889;6;129;141;12;0,82051282051282;0,897435897435897
"10890";15314;157;10890;6;88;121;33;0,564102564102564;0,769230769230769
"10891";15314;157;10891;6;76;88;12;0,487179487179487;0,564102564102564
"10892";15314;157;10892;6;112;129;17;0,717948717948718;0,82051282051282
"10893";15314;157;10893;6;108;129;21;0,692307692307692;0,82051282051282
"10894";15314;157;10894;6;84;116;32;0,538461538461538;0,743589743589744
"10895";15314;157;10895;6;84;121;37;0,538461538461538;0,769230769230769
"10896";15314;157;10896;6;100;125;25;0,641025641025641;0,794871794871795
"10897";15314;157;10897;6;133;157;24;0,846153846153846;1
"10898";15314;157;10898;6;104;121;17;0,666666666666667;0,769230769230769
"10899";15314;157;10899;6;48;60;12;0,307692307692308;0,384615384615385
"10900";15314;157;10900;6;80;92;12;0,512820512820513;0,58974358974359
"10901";15314;157;10901;6;80;96;16;0,512820512820513;0,615384615384615
"10902";15314;157;10902;6;96;125;29;0,615384615384615;0,794871794871795
"10903";15403;59;10903;3;25;50;25;0,428571428571429;0,857142857142857
"10904";15403;59;10904;3;16;42;26;0,285714285714286;0,714285714285714
"10905";15403;59;10905;4;15;27;12;0,266666666666667;0,466666666666667
"10906";15403;59;10906;4;27;39;12;0,466666666666667;0,666666666666667
"10907";15403;59;10907;4;27;43;16;0,466666666666667;0,733333333333333
"10908";15403;59;10908;4;31;43;12;0,533333333333333;0,733333333333333
"10909";15403;59;10909;4;47;59;12;0,8;1
"10910";15403;59;10910;4;35;47;12;0,6;0,8
"10911";15403;59;10911;4;31;47;16;0,533333333333333;0,8
"10912";15403;59;10912;4;11;23;12;0,2;0,4
"10913";15403;59;10913;4;27;47;20;0,466666666666667;0,8
"10914";15403;59;10914;5;11;17;6;0,2;0,3
"10915";15403;59;10915;5;15;21;6;0,266666666666667;0,366666666666667
"10916";15403;59;10916;5;17;23;6;0,3;0,4
"10917";15403;59;10917;5;17;25;8;0,3;0,433333333333333
"10918";15403;59;10918;5;19;25;6;0,333333333333333;0,433333333333333
"10919";15403;59;10919;5;21;27;6;0,366666666666667;0,466666666666667
"10920";15403;59;10920;5;27;33;6;0,466666666666667;0,566666666666667
"10921";15403;59;10921;5;27;35;8;0,466666666666667;0,6
"10922";15403;59;10922;5;29;35;6;0,5;0,6
"10923";15403;59;10923;5;31;37;6;0,533333333333333;0,633333333333333
"10924";15403;59;10924;5;33;39;6;0,566666666666667;0,666666666666667
"10925";15403;59;10925;5;35;41;6;0,6;0,7
"10926";15403;59;10926;5;35;43;8;0,6;0,733333333333333
"10927";15403;59;10927;5;43;49;6;0,733333333333333;0,833333333333333
"10928";15403;59;10928;5;49;55;6;0,833333333333333;0,933333333333333
"10929";15403;59;10929;5;49;57;8;0,833333333333333;0,966666666666667
"10930";15403;59;10930;5;51;57;6;0,866666666666667;0,966666666666667
"10931";15403;59;10931;5;53;59;6;0,9;1
"10932";15403;59;10932;5;17;27;10;0,3;0,466666666666667
"10933";15403;59;10933;5;19;27;8;0,333333333333333;0,466666666666667
"10934";15403;59;10934;5;27;37;10;0,466666666666667;0,633333333333333
"10935";15403;59;10935;5;29;37;8;0,5;0,633333333333333
"10936";15403;59;10936;5;29;39;10;0,5;0,666666666666667
"10937";15403;59;10937;5;29;41;12;0,5;0,7
"10938";15403;59;10938;5;31;39;8;0,533333333333333;0,666666666666667
"10939";15403;59;10939;5;31;41;10;0,533333333333333;0,7
"10940";15403;59;10940;5;33;41;8;0,566666666666667;0,7
"10941";15403;59;10941;5;31;43;12;0,533333333333333;0,733333333333333
"10942";15403;59;10942;5;33;43;10;0,566666666666667;0,733333333333333
"10943";15403;59;10943;5;49;59;10;0,833333333333333;1
"10944";15403;59;10944;5;51;59;8;0,866666666666667;1
"10945";15403;59;10945;5;29;43;14;0,5;0,733333333333333
"10946";15403;59;10946;5;27;39;12;0,466666666666667;0,666666666666667
"10947";15403;59;10947;5;27;41;14;0,466666666666667;0,7
"10948";15403;59;10948;5;27;43;16;0,466666666666667;0,733333333333333
"10949";15403;59;10949;5;15;23;8;0,266666666666667;0,4
"10950";15403;59;10950;5;1;7;6;0,0333333333333333;0,133333333333333
"10951";15403;59;10951;5;15;25;10;0,266666666666667;0,433333333333333
"10952";15403;59;10952;5;15;27;12;0,266666666666667;0,466666666666667
"10953";15403;59;10953;5;33;45;12;0,566666666666667;0,766666666666667
"10954";15549;88;10954;4;64;88;24;0,727272727272727;1
"10955";15549;88;10955;5;64;76;12;0,727272727272727;0,863636363636364
"10956";15549;88;10956;5;72;84;12;0,818181818181818;0,954545454545455
"10957";15549;88;10957;5;68;80;12;0,772727272727273;0,909090909090909
"10958";15549;88;10958;5;68;84;16;0,772727272727273;0,954545454545455
"10959";15549;88;10959;5;68;88;20;0,772727272727273;1
"10960";15549;88;10960;5;76;88;12;0,863636363636364;1
"10961";15549;88;10961;5;48;60;12;0,545454545454545;0,681818181818182
"10962";15549;88;10962;5;64;80;16;0,727272727272727;0,909090909090909
"10963";15549;88;10963;5;60;72;12;0,681818181818182;0,818181818181818
"10964";15549;88;10964;5;72;88;16;0,818181818181818;1
"10965";15549;88;10965;5;7;19;12;0,0909090909090909;0,227272727272727
"10966";15549;88;10966;5;44;56;12;0,5;0,636363636363636
"10967";15549;88;10967;5;23;35;12;0,272727272727273;0,409090909090909
"10968";15549;88;10968;5;19;31;12;0,227272727272727;0,363636363636364
"10969";15549;88;10969;6;54;60;6;0,613636363636364;0,681818181818182
"10970";15549;88;10970;6;76;82;6;0,863636363636364;0,931818181818182
"10971";15549;88;10971;6;62;68;6;0,704545454545455;0,772727272727273
"10972";15549;88;10972;6;66;72;6;0,75;0,818181818181818
"10973";15549;88;10973;6;66;74;8;0,75;0,840909090909091
"10974";15549;88;10974;6;68;74;6;0,772727272727273;0,840909090909091
"10975";15549;88;10975;6;68;76;8;0,772727272727273;0,863636363636364
"10976";15549;88;10976;6;70;76;6;0,795454545454545;0,863636363636364
"10977";15549;88;10977;6;70;78;8;0,795454545454545;0,886363636363636
"10978";15549;88;10978;6;72;78;6;0,818181818181818;0,886363636363636
"10979";15549;88;10979;6;60;66;6;0,681818181818182;0,75
"10980";15549;88;10980;6;64;70;6;0,727272727272727;0,795454545454545
"10981";15549;88;10981;6;35;41;6;0,409090909090909;0,477272727272727
"10982";15549;88;10982;6;78;84;6;0,886363636363636;0,954545454545455
"10983";15549;88;10983;6;82;88;6;0,931818181818182;1
"10984";15549;88;10984;6;15;21;6;0,181818181818182;0,25
"10985";15549;88;10985;6;27;33;6;0,318181818181818;0,386363636363636
"10986";15549;88;10986;6;62;70;8;0,704545454545455;0,795454545454545
"10987";15549;88;10987;6;62;72;10;0,704545454545455;0,818181818181818
"10988";15549;88;10988;6;66;76;10;0,75;0,863636363636364
"10989";15549;88;10989;6;72;80;8;0,818181818181818;0,909090909090909
"10990";15549;88;10990;6;74;80;6;0,840909090909091;0,909090909090909
"10991";15549;88;10991;6;80;86;6;0,909090909090909;0,977272727272727
"10992";15549;88;10992;6;68;78;10;0,772727272727273;0,886363636363636
"10993";15549;88;10993;6;68;80;12;0,772727272727273;0,909090909090909
"10994";15549;88;10994;6;76;84;8;0,863636363636364;0,954545454545455
"10995";15549;88;10995;6;76;86;10;0,863636363636364;0,977272727272727
"10996";15549;88;10996;6;52;58;6;0,590909090909091;0,659090909090909
"10997";15549;88;10997;6;70;80;10;0,795454545454545;0,909090909090909
"10998";15549;88;10998;6;13;19;6;0,159090909090909;0,227272727272727
"10999";15549;88;10999;6;72;82;10;0,818181818181818;0,931818181818182
"11000";15549;88;11000;6;21;27;6;0,25;0,318181818181818
"11001";15549;88;11001;6;64;72;8;0,727272727272727;0,818181818181818
"11002";15549;88;11002;6;21;29;8;0,25;0,340909090909091
"11003";15549;88;11003;6;48;54;6;0,545454545454545;0,613636363636364
"11004";15549;88;11004;6;17;23;6;0,204545454545455;0,272727272727273
"11005";15549;88;11005;6;64;74;10;0,727272727272727;0,840909090909091
"11006";15549;88;11006;6;78;86;8;0,886363636363636;0,977272727272727
"11007";15549;88;11007;6;23;29;6;0,272727272727273;0,340909090909091
"11008";15549;88;11008;6;46;52;6;0,522727272727273;0,590909090909091
"11009";15549;88;11009;6;19;25;6;0,227272727272727;0,295454545454545
"11010";15549;88;11010;6;66;78;12;0,75;0,886363636363636
"11011";15700;136;11011;4;85;136;51;0,625;1
"11012";15700;136;11012;5;112;136;24;0,823529411764706;1
"11013";15700;136;11013;5;88;112;24;0,647058823529412;0,823529411764706
"11014";15700;136;11014;5;96;120;24;0,705882352941177;0,882352941176471
"11015";15700;136;11015;5;96;128;32;0,705882352941177;0,941176470588235
"11016";15700;136;11016;5;104;128;24;0,764705882352941;0,941176470588235
"11017";15700;136;11017;5;104;136;32;0,764705882352941;1
"11018";15700;136;11018;5;96;136;40;0,705882352941177;1
"11019";15700;136;11019;5;47;72;25;0,352941176470588;0,529411764705882
"11020";15700;136;11020;6;96;108;12;0,705882352941177;0,794117647058823
"11021";15700;136;11021;6;112;124;12;0,823529411764706;0,911764705882353
"11022";15700;136;11022;6;116;128;12;0,852941176470588;0,941176470588235
"11023";15700;136;11023;6;120;132;12;0,882352941176471;0,970588235294118
"11024";15700;136;11024;6;96;112;16;0,705882352941177;0,823529411764706
"11025";15700;136;11025;6;100;112;12;0,735294117647059;0,823529411764706
"11026";15700;136;11026;6;100;116;16;0,735294117647059;0,852941176470588
"11027";15700;136;11027;6;112;128;16;0,823529411764706;0,941176470588235
"11028";15700;136;11028;6;112;132;20;0,823529411764706;0,970588235294118
"11029";15700;136;11029;6;116;132;16;0,852941176470588;0,970588235294118
"11030";15700;136;11030;6;35;47;12;0,264705882352941;0,352941176470588
"11031";15700;136;11031;6;84;96;12;0,617647058823529;0,705882352941177
"11032";15700;136;11032;6;120;136;16;0,882352941176471;1
"11033";15700;136;11033;6;100;120;20;0,735294117647059;0,882352941176471
"11034";15700;136;11034;6;100;124;24;0,735294117647059;0,911764705882353
"11035";15700;136;11035;6;100;128;28;0,735294117647059;0,941176470588235
"11036";15700;136;11036;6;100;132;32;0,735294117647059;0,970588235294118
"11037";15700;136;11037;6;104;116;12;0,764705882352941;0,852941176470588
"11038";15700;136;11038;6;108;120;12;0,794117647058823;0,882352941176471
"11039";15700;136;11039;6;108;124;16;0,794117647058823;0,911764705882353
"11040";15700;136;11040;6;108;128;20;0,794117647058823;0,941176470588235
"11041";15700;136;11041;6;108;132;24;0,794117647058823;0,970588235294118
"11042";15700;136;11042;6;108;136;28;0,794117647058823;1
"11043";15700;136;11043;6;112;136;24;0,823529411764706;1
"11044";15700;136;11044;6;116;136;20;0,852941176470588;1
"11045";15700;136;11045;6;51;63;12;0,382352941176471;0,470588235294118
"11046";15700;136;11046;6;96;116;20;0,705882352941177;0,852941176470588
"11047";15700;136;11047;6;104;120;16;0,764705882352941;0,882352941176471
"11048";15700;136;11048;6;31;43;12;0,235294117647059;0,323529411764706
"11049";15700;136;11049;6;55;68;13;0,411764705882353;0,5
"11050";15700;136;11050;6;88;100;12;0,647058823529412;0,735294117647059
"11051";15700;136;11051;6;96;120;24;0,705882352941177;0,882352941176471
"11052";15700;136;11052;6;96;124;28;0,705882352941177;0,911764705882353
"11053";15700;136;11053;6;92;104;12;0,676470588235294;0,764705882352941
"11054";15700;136;11054;6;104;124;20;0,764705882352941;0,911764705882353
"11055";15707;199;11055;4;16;66;50;0,0833333333333333;0,333333333333333
"11056";15707;199;11056;4;66;116;50;0,333333333333333;0,583333333333333
"11057";15707;199;11057;4;82;132;50;0,416666666666667;0,666666666666667
"11058";15707;199;11058;5;167;191;24;0,84;0,96
"11059";15707;199;11059;5;103;127;24;0,52;0,64
"11060";15707;199;11060;5;103;135;32;0,52;0,68
"11061";15707;199;11061;5;159;183;24;0,8;0,92
"11062";15707;199;11062;5;159;191;32;0,8;0,96
"11063";15707;199;11063;5;159;199;40;0,8;1
"11064";15707;199;11064;5;167;199;32;0,84;1
"11065";15707;199;11065;5;175;199;24;0,88;1
"11066";15707;199;11066;5;79;103;24;0,4;0,52
"11067";15707;199;11067;5;151;175;24;0,76;0,88
"11068";15707;199;11068;5;151;183;32;0,76;0,92
"11069";15707;199;11069;5;95;119;24;0,48;0,6
"11070";15707;199;11070;5;71;95;24;0,36;0,48
"11071";15707;199;11071;5;63;87;24;0,32;0,44
"11072";15707;199;11072;5;111;135;24;0,56;0,68
"11073";15707;199;11073;5;95;127;32;0,48;0,64
"11074";15707;199;11074;5;7;31;24;0,04;0,16
"11075";15707;199;11075;6;99;111;12;0,5;0,56
"11076";15707;199;11076;6;75;87;12;0,38;0,44
"11077";15707;199;11077;6;107;119;12;0,54;0,6
"11078";15707;199;11078;6;107;123;16;0,54;0,62
"11079";15707;199;11079;6;155;167;12;0,78;0,84
"11080";15707;199;11080;6;155;171;16;0,78;0,86
"11081";15707;199;11081;6;155;175;20;0,78;0,88
"11082";15707;199;11082;6;159;171;12;0,8;0,86
"11083";15707;199;11083;6;159;175;16;0,8;0,88
"11084";15707;199;11084;6;163;175;12;0,82;0,88
"11085";15707;199;11085;6;163;179;16;0,82;0,9
"11086";15707;199;11086;6;167;179;12;0,84;0,9
"11087";15707;199;11087;6;171;183;12;0,86;0,92
"11088";15707;199;11088;6;171;187;16;0,86;0,94
"11089";15707;199;11089;6;175;187;12;0,88;0,94
"11090";15707;199;11090;6;175;191;16;0,88;0,96
"11091";15707;199;11091;6;179;191;12;0,9;0,96
"11092";15707;199;11092;6;179;195;16;0,9;0,98
"11093";15707;199;11093;6;183;195;12;0,92;0,98
"11094";15707;199;11094;6;183;199;16;0,92;1
"11095";15707;199;11095;6;79;91;12;0,4;0,46
"11096";15707;199;11096;6;111;123;12;0,56;0,62
"11097";15707;199;11097;6;115;127;12;0,58;0,64
"11098";15707;199;11098;6;159;179;20;0,8;0,9
"11099";15707;199;11099;6;159;183;24;0,8;0,92
"11100";15707;199;11100;6;159;187;28;0,8;0,94
"11101";15707;199;11101;6;159;191;32;0,8;0,96
"11102";15707;199;11102;6;159;195;36;0,8;0,98
"11103";15707;199;11103;6;163;183;20;0,82;0,92
"11104";15707;199;11104;6;163;187;24;0,82;0,94
"11105";15707;199;11105;6;163;191;28;0,82;0,96
"11106";15707;199;11106;6;167;183;16;0,84;0,92
"11107";15707;199;11107;6;167;187;20;0,84;0,94
"11108";15707;199;11108;6;167;191;24;0,84;0,96
"11109";15707;199;11109;6;167;195;28;0,84;0,98
"11110";15707;199;11110;6;171;191;20;0,86;0,96
"11111";15707;199;11111;6;171;195;24;0,86;0,98
"11112";15707;199;11112;6;175;195;20;0,88;0,98
"11113";15707;199;11113;6;19;31;12;0,1;0,16
"11114";15707;199;11114;6;175;199;24;0,88;1
"11115";15707;199;11115;6;179;199;20;0,9;1
"11116";15707;199;11116;6;71;83;12;0,36;0,42
"11117";15707;199;11117;6;123;135;12;0,62;0,68
"11118";15707;199;11118;6;155;179;24;0,78;0,9
"11119";15707;199;11119;6;155;183;28;0,78;0,92
"11120";15707;199;11120;6;155;187;32;0,78;0,94
"11121";15707;199;11121;6;159;199;40;0,8;1
"11122";15707;199;11122;6;163;195;32;0,82;0,98
"11123";15707;199;11123;6;163;199;36;0,82;1
"11124";15707;199;11124;6;171;199;28;0,86;1
"11125";15707;199;11125;6;23;35;12;0,12;0,18
"11126";15707;199;11126;6;39;51;12;0,2;0,26
"11127";15707;199;11127;6;99;115;16;0,5;0,58
"11128";15707;199;11128;6;103;115;12;0,52;0,58
"11129";15707;199;11129;6;139;151;12;0,7;0,76
"11130";15707;199;11130;6;7;19;12;0,04;0,1
"11131";15707;199;11131;6;15;27;12;0,08;0,14
"11132";15707;199;11132;6;79;95;16;0,4;0,48
"11133";15707;199;11133;6;119;131;12;0,6;0,66
"11134";15707;199;11134;6;119;135;16;0,6;0,68
"11135";15707;199;11135;6;167;199;32;0,84;1
"11136";15707;199;11136;6;83;95;12;0,42;0,48
"11137";15707;199;11137;6;11;23;12;0,06;0,12
"11138";15707;199;11138;6;95;107;12;0,48;0,54
"11139";15707;199;11139;6;67;79;12;0,34;0,4
"11140";15707;199;11140;6;63;75;12;0,32;0,38
"11141";15707;199;11141;6;155;191;36;0,78;0,96
"11142";15707;199;11142;6;155;195;40;0,78;0,98
"11143";15707;199;11143;6;59;71;12;0,3;0,36
"11144";15707;199;11144;6;95;111;16;0,48;0,56
"11145";15707;199;11145;6;27;39;12;0,14;0,2
"11146";15707;199;11146;6;3;15;12;0,02;0,08
"11147";15707;199;11147;6;115;131;16;0,58;0,66
"11148";15707;199;11148;6;143;155;12;0,72;0,78
"11149";16025;92;11149;4;67;92;25;0,727272727272727;1
"11150";16025;92;11150;4;58;84;26;0,636363636363636;0,909090909090909
"11151";16025;92;11151;4;58;92;34;0,636363636363636;1
"11152";16025;92;11152;5;64;76;12;0,695652173913043;0,826086956521739
"11153";16025;92;11153;5;68;80;12;0,739130434782609;0,869565217391304
"11154";16025;92;11154;5;68;84;16;0,739130434782609;0,91304347826087
"11155";16025;92;11155;5;68;88;20;0,739130434782609;0,956521739130435
"11156";16025;92;11156;5;64;80;16;0,695652173913043;0,869565217391304
"11157";16025;92;11157;5;64;84;20;0,695652173913043;0,91304347826087
"11158";16025;92;11158;5;64;88;24;0,695652173913043;0,956521739130435
"11159";16025;92;11159;5;64;92;28;0,695652173913043;1
"11160";16025;92;11160;5;68;92;24;0,739130434782609;1
"11161";16025;92;11161;5;72;84;12;0,782608695652174;0,91304347826087
"11162";16025;92;11162;5;72;88;16;0,782608695652174;0,956521739130435
"11163";16025;92;11163;5;72;92;20;0,782608695652174;1
"11164";16025;92;11164;5;76;88;12;0,826086956521739;0,956521739130435
"11165";16025;92;11165;5;76;92;16;0,826086956521739;1
"11166";16025;92;11166;5;43;56;13;0,478260869565217;0,608695652173913
"11167";16025;92;11167;5;56;68;12;0,608695652173913;0,739130434782609
"11168";16025;92;11168;5;60;72;12;0,652173913043478;0,782608695652174
"11169";16025;92;11169;5;60;76;16;0,652173913043478;0,826086956521739
"11170";16025;92;11170;5;60;80;20;0,652173913043478;0,869565217391304
"11171";16025;92;11171;5;60;84;24;0,652173913043478;0,91304347826087
"11172";16025;92;11172;5;39;52;13;0,434782608695652;0,565217391304348
"11173";16025;92;11173;6;11;17;6;0,130434782608696;0,195652173913043
"11174";16025;92;11174;6;58;64;6;0,630434782608696;0,695652173913043
"11175";16025;92;11175;6;64;70;6;0,695652173913043;0,760869565217391
"11176";16025;92;11176;6;64;72;8;0,695652173913043;0,782608695652174
"11177";16025;92;11177;6;64;74;10;0,695652173913043;0,804347826086957
"11178";16025;92;11178;6;64;76;12;0,695652173913043;0,826086956521739
"11179";16025;92;11179;6;64;78;14;0,695652173913043;0,847826086956522
"11180";16025;92;11180;6;66;72;6;0,717391304347826;0,782608695652174
"11181";16025;92;11181;6;66;74;8;0,717391304347826;0,804347826086957
"11182";16025;92;11182;6;66;76;10;0,717391304347826;0,826086956521739
"11183";16025;92;11183;6;66;78;12;0,717391304347826;0,847826086956522
"11184";16025;92;11184;6;68;74;6;0,739130434782609;0,804347826086957
"11185";16025;92;11185;6;68;76;8;0,739130434782609;0,826086956521739
"11186";16025;92;11186;6;68;78;10;0,739130434782609;0,847826086956522
"11187";16025;92;11187;6;68;80;12;0,739130434782609;0,869565217391304
"11188";16025;92;11188;6;70;76;6;0,760869565217391;0,826086956521739
"11189";16025;92;11189;6;70;78;8;0,760869565217391;0,847826086956522
"11190";16025;92;11190;6;70;80;10;0,760869565217391;0,869565217391304
"11191";16025;92;11191;6;70;82;12;0,760869565217391;0,891304347826087
"11192";16025;92;11192;6;72;78;6;0,782608695652174;0,847826086956522
"11193";16025;92;11193;6;72;80;8;0,782608695652174;0,869565217391304
"11194";16025;92;11194;6;72;82;10;0,782608695652174;0,891304347826087
"11195";16025;92;11195;6;72;84;12;0,782608695652174;0,91304347826087
"11196";16025;92;11196;6;74;80;6;0,804347826086957;0,869565217391304
"11197";16025;92;11197;6;74;82;8;0,804347826086957;0,891304347826087
"11198";16025;92;11198;6;76;82;6;0,826086956521739;0,891304347826087
"11199";16025;92;11199;6;76;84;8;0,826086956521739;0,91304347826087
"11200";16025;92;11200;6;39;46;7;0,434782608695652;0,5
"11201";16025;92;11201;6;66;80;14;0,717391304347826;0,869565217391304
"11202";16025;92;11202;6;66;82;16;0,717391304347826;0,891304347826087
"11203";16025;92;11203;6;66;84;18;0,717391304347826;0,91304347826087
"11204";16025;92;11204;6;66;86;20;0,717391304347826;0,934782608695652
"11205";16025;92;11205;6;66;88;22;0,717391304347826;0,956521739130435
"11206";16025;92;11206;6;66;90;24;0,717391304347826;0,978260869565217
"11207";16025;92;11207;6;68;82;14;0,739130434782609;0,891304347826087
"11208";16025;92;11208;6;68;84;16;0,739130434782609;0,91304347826087
"11209";16025;92;11209;6;68;86;18;0,739130434782609;0,934782608695652
"11210";16025;92;11210;6;68;88;20;0,739130434782609;0,956521739130435
"11211";16025;92;11211;6;68;90;22;0,739130434782609;0,978260869565217
"11212";16025;92;11212;6;70;84;14;0,760869565217391;0,91304347826087
"11213";16025;92;11213;6;70;86;16;0,760869565217391;0,934782608695652
"11214";16025;92;11214;6;70;88;18;0,760869565217391;0,956521739130435
"11215";16025;92;11215;6;70;90;20;0,760869565217391;0,978260869565217
"11216";16025;92;11216;6;74;84;10;0,804347826086957;0,91304347826087
"11217";16025;92;11217;6;74;86;12;0,804347826086957;0,934782608695652
"11218";16025;92;11218;6;74;88;14;0,804347826086957;0,956521739130435
"11219";16025;92;11219;6;74;90;16;0,804347826086957;0,978260869565217
"11220";16025;92;11220;6;9;15;6;0,108695652173913;0,173913043478261
"11221";16025;92;11221;6;9;17;8;0,108695652173913;0,195652173913043
"11222";16025;92;11222;6;46;52;6;0,5;0,565217391304348
"11223";16025;92;11223;6;43;50;7;0,478260869565217;0,543478260869565
"11224";16025;92;11224;6;43;52;9;0,478260869565217;0,565217391304348
"11225";16025;92;11225;6;72;86;14;0,782608695652174;0,934782608695652
"11226";16025;92;11226;6;50;56;6;0,543478260869565;0,608695652173913
"11227";16025;92;11227;6;56;62;6;0,608695652173913;0,673913043478261
"11228";16025;92;11228;6;56;64;8;0,608695652173913;0,695652173913043
"11229";16025;92;11229;6;46;54;8;0,5;0,58695652173913
"11230";16025;92;11230;6;76;86;10;0,826086956521739;0,934782608695652
"11231";16025;92;11231;6;76;88;12;0,826086956521739;0,956521739130435
"11232";16025;92;11232;6;37;43;6;0,41304347826087;0,478260869565217
"11233";16025;92;11233;6;64;80;16;0,695652173913043;0,869565217391304
"11234";16025;92;11234;6;64;82;18;0,695652173913043;0,891304347826087
"11235";16025;92;11235;6;72;88;16;0,782608695652174;0,956521739130435
"11236";16025;92;11236;6;64;84;20;0,695652173913043;0,91304347826087
"11237";16025;92;11237;6;64;86;22;0,695652173913043;0,934782608695652
"11238";16025;92;11238;6;74;92;18;0,804347826086957;1
"11239";16025;92;11239;6;76;90;14;0,826086956521739;0,978260869565217
"11240";16025;92;11240;6;76;92;16;0,826086956521739;1
"11241";16025;92;11241;6;62;68;6;0,673913043478261;0,739130434782609
"11242";16025;92;11242;6;66;92;26;0,717391304347826;1
"11243";16025;92;11243;6;68;92;24;0,739130434782609;1
"11244";16025;92;11244;6;70;92;22;0,760869565217391;1
"11245";16025;92;11245;6;72;90;18;0,782608695652174;0,978260869565217
"11246";16025;92;11246;6;72;92;20;0,782608695652174;1
"11247";16025;92;11247;6;48;54;6;0,521739130434783;0,58695652173913
"11248";16025;92;11248;6;64;88;24;0,695652173913043;0,956521739130435
"11249";16025;92;11249;6;64;90;26;0,695652173913043;0,978260869565217
"11250";16025;92;11250;6;64;92;28;0,695652173913043;1
"11251";16055;22;11251;3;4;17;13;0,2;0,8
"11252";16055;22;11252;4;7;14;7;0,363636363636364;0,636363636363636
"11253";16055;22;11253;4;1;7;6;0,0909090909090909;0,363636363636364
"11254";16055;22;11254;4;3;9;6;0,181818181818182;0,454545454545455
"11255";16055;22;11255;4;5;12;7;0,272727272727273;0,545454545454545
"11256";16055;22;11256;4;3;12;9;0,181818181818182;0,545454545454545
"11257";16055;22;11257;4;5;14;9;0,272727272727273;0,636363636363636
"11258";16055;22;11258;4;5;16;11;0,272727272727273;0,727272727272727
"11259";16055;22;11259;4;9;16;7;0,454545454545455;0,727272727272727
"11260";16055;22;11260;4;3;14;11;0,181818181818182;0,636363636363636
"11261";16055;22;11261;4;3;16;13;0,181818181818182;0,727272727272727
"11262";16055;22;11262;4;7;16;9;0,363636363636364;0,727272727272727
"11263";16055;22;11263;4;14;20;6;0,636363636363636;0,909090909090909
"11264";16055;22;11264;4;1;9;8;0,0909090909090909;0,454545454545455
"11265";16055;22;11265;4;1;12;11;0,0909090909090909;0,545454545454545
"11266";16055;22;11266;4;1;14;13;0,0909090909090909;0,636363636363636
"11267";16234;152;11267;5;31;55;24;0,210526315789474;0,368421052631579
"11268";16234;152;11268;5;96;120;24;0,631578947368421;0,789473684210526
"11269";16234;152;11269;5;55;80;25;0,368421052631579;0,526315789473684
"11270";16234;152;11270;5;88;112;24;0,578947368421053;0,736842105263158
"11271";16234;152;11271;5;63;88;25;0,421052631578947;0,578947368421053
"11272";16234;152;11272;5;104;128;24;0,684210526315789;0,842105263157895
"11273";16234;152;11273;5;112;136;24;0,736842105263158;0,894736842105263
"11274";16234;152;11274;5;23;47;24;0,157894736842105;0,315789473684211
"11275";16234;152;11275;6;71;84;13;0,473684210526316;0,552631578947368
"11276";16234;152;11276;6;71;88;17;0,473684210526316;0,578947368421053
"11277";16234;152;11277;6;43;55;12;0,289473684210526;0,368421052631579
"11278";16234;152;11278;6;31;43;12;0,210526315789474;0,289473684210526
"11279";16234;152;11279;6;31;47;16;0,210526315789474;0,315789473684211
"11280";16234;152;11280;6;31;51;20;0,210526315789474;0,342105263157895
"11281";16234;152;11281;6;31;55;24;0,210526315789474;0,368421052631579
"11282";16234;152;11282;6;35;47;12;0,236842105263158;0,315789473684211
"11283";16234;152;11283;6;35;51;16;0,236842105263158;0,342105263157895
"11284";16234;152;11284;6;35;55;20;0,236842105263158;0,368421052631579
"11285";16234;152;11285;6;39;51;12;0,263157894736842;0,342105263157895
"11286";16234;152;11286;6;120;132;12;0,789473684210526;0,868421052631579
"11287";16234;152;11287;6;63;76;13;0,421052631578947;0,5
"11288";16234;152;11288;6;63;80;17;0,421052631578947;0,526315789473684
"11289";16234;152;11289;6;63;84;21;0,421052631578947;0,552631578947368
"11290";16234;152;11290;6;67;80;13;0,447368421052632;0,526315789473684
"11291";16234;152;11291;6;67;84;17;0,447368421052632;0,552631578947368
"11292";16234;152;11292;6;140;152;12;0,921052631578947;1
"11293";16234;152;11293;6;96;108;12;0,631578947368421;0,710526315789474
"11294";16234;152;11294;6;136;148;12;0,894736842105263;0,973684210526316
"11295";16234;152;11295;6;27;39;12;0,184210526315789;0,263157894736842
"11296";16234;152;11296;6;92;104;12;0,605263157894737;0,684210526315789
"11297";16234;152;11297;6;108;120;12;0,710526315789474;0,789473684210526
"11298";16234;152;11298;6;92;108;16;0,605263157894737;0,710526315789474
"11299";16234;152;11299;6;11;23;12;0,0789473684210526;0,157894736842105
"11300";16234;152;11300;6;7;19;12;0,0526315789473684;0,131578947368421
"11301";16234;152;11301;6;23;35;12;0,157894736842105;0,236842105263158
"11302";16234;152;11302;6;100;112;12;0,657894736842105;0,736842105263158
"11303";16234;152;11303;6;76;88;12;0,5;0,578947368421053
"11304";16234;152;11304;6;3;15;12;0,0263157894736842;0,105263157894737
"11305";16234;152;11305;6;112;124;12;0,736842105263158;0,815789473684211
"11306";16234;152;11306;6;39;55;16;0,263157894736842;0,368421052631579
"11307";16234;152;11307;6;88;100;12;0,578947368421053;0,657894736842105
"11308";16329;65;11308;4;40;65;25;0,625;1
"11309";16329;65;11309;4;32;57;25;0,5;0,875
"11310";16329;65;11310;4;32;65;33;0,5;1
"11311";16329;65;11311;4;24;48;24;0,375;0,75
"11312";16329;65;11312;5;40;53;13;0,625;0,8125
"11313";16329;65;11313;5;48;61;13;0,75;0,9375
"11314";16329;65;11314;5;53;65;12;0,8125;1
"11315";16329;65;11315;5;32;44;12;0,5;0,6875
"11316";16329;65;11316;5;28;40;12;0,4375;0,625
"11317";16329;65;11317;5;36;48;12;0,5625;0,75
"11318";16329;65;11318;5;36;53;17;0,5625;0,8125
"11319";16329;65;11319;5;36;57;21;0,5625;0,875
"11320";16329;65;11320;5;36;61;25;0,5625;0,9375
"11321";16329;65;11321;5;36;65;29;0,5625;1
"11322";16329;65;11322;5;40;57;17;0,625;0,875
"11323";16329;65;11323;5;40;61;21;0,625;0,9375
"11324";16329;65;11324;5;40;65;25;0,625;1
"11325";16329;65;11325;5;48;65;17;0,75;1
"11326";16329;65;11326;5;32;48;16;0,5;0,75
"11327";16329;65;11327;5;32;53;21;0,5;0,8125
"11328";16329;65;11328;5;32;57;25;0,5;0,875
"11329";16329;65;11329;6;35;41;6;0,545454545454545;0,636363636363636
"11330";16329;65;11330;6;37;43;6;0,575757575757576;0,666666666666667
"11331";16329;65;11331;6;39;45;6;0,606060606060606;0,696969696969697
"11332";16329;65;11332;6;49;55;6;0,757575757575758;0,848484848484849
"11333";16329;65;11333;6;53;59;6;0,818181818181818;0,909090909090909
"11334";16329;65;11334;6;55;61;6;0,848484848484849;0,939393939393939
"11335";16329;65;11335;6;57;63;6;0,878787878787879;0,96969696969697
"11336";16329;65;11336;6;59;65;6;0,909090909090909;1
"11337";16329;65;11337;6;35;43;8;0,545454545454545;0,666666666666667
"11338";16329;65;11338;6;37;45;8;0,575757575757576;0,696969696969697
"11339";16329;65;11339;6;37;47;10;0,575757575757576;0,727272727272727
"11340";16329;65;11340;6;37;49;12;0,575757575757576;0,757575757575758
"11341";16329;65;11341;6;37;51;14;0,575757575757576;0,787878787878788
"11342";16329;65;11342;6;39;47;8;0,606060606060606;0,727272727272727
"11343";16329;65;11343;6;39;49;10;0,606060606060606;0,757575757575758
"11344";16329;65;11344;6;39;51;12;0,606060606060606;0,787878787878788
"11345";16329;65;11345;6;41;47;6;0,636363636363636;0,727272727272727
"11346";16329;65;11346;6;41;49;8;0,636363636363636;0,757575757575758
"11347";16329;65;11347;6;49;57;8;0,757575757575758;0,878787878787879
"11348";16329;65;11348;6;51;57;6;0,787878787878788;0,878787878787879
"11349";16329;65;11349;6;51;59;8;0,787878787878788;0,909090909090909
"11350";16329;65;11350;6;51;61;10;0,787878787878788;0,939393939393939
"11351";16329;65;11351;6;51;63;12;0,787878787878788;0,96969696969697
"11352";16329;65;11352;6;53;61;8;0,818181818181818;0,939393939393939
"11353";16329;65;11353;6;53;63;10;0,818181818181818;0,96969696969697
"11354";16329;65;11354;6;53;65;12;0,818181818181818;1
"11355";16329;65;11355;6;55;63;8;0,848484848484849;0,96969696969697
"11356";16329;65;11356;6;55;65;10;0,848484848484849;1
"11357";16329;65;11357;6;57;65;8;0,878787878787879;1
"11358";16329;65;11358;6;33;39;6;0,515151515151515;0,606060606060606
"11359";16329;65;11359;6;33;41;8;0,515151515151515;0,636363636363636
"11360";16329;65;11360;6;35;45;10;0,545454545454545;0,696969696969697
"11361";16329;65;11361;6;35;47;12;0,545454545454545;0,727272727272727
"11362";16329;65;11362;6;35;49;14;0,545454545454545;0,757575757575758
"11363";16329;65;11363;6;35;51;16;0,545454545454545;0,787878787878788
"11364";16329;65;11364;6;39;53;14;0,606060606060606;0,818181818181818
"11365";16329;65;11365;6;39;55;16;0,606060606060606;0,848484848484849
"11366";16329;65;11366;6;39;57;18;0,606060606060606;0,878787878787879
"11367";16329;65;11367;6;39;59;20;0,606060606060606;0,909090909090909
"11368";16329;65;11368;6;39;61;22;0,606060606060606;0,939393939393939
"11369";16329;65;11369;6;39;63;24;0,606060606060606;0,96969696969697
"11370";16329;65;11370;6;41;51;10;0,636363636363636;0,787878787878788
"11371";16329;65;11371;6;41;53;12;0,636363636363636;0,818181818181818
"11372";16329;65;11372;6;41;55;14;0,636363636363636;0,848484848484849
"11373";16329;65;11373;6;43;49;6;0,666666666666667;0,757575757575758
"11374";16329;65;11374;6;43;51;8;0,666666666666667;0,787878787878788
"11375";16329;65;11375;6;43;53;10;0,666666666666667;0,818181818181818
"11376";16329;65;11376;6;43;55;12;0,666666666666667;0,848484848484849
"11377";16329;65;11377;6;43;57;14;0,666666666666667;0,878787878787879
"11378";16329;65;11378;6;43;59;16;0,666666666666667;0,909090909090909
"11379";16329;65;11379;6;43;61;18;0,666666666666667;0,939393939393939
"11380";16329;65;11380;6;43;63;20;0,666666666666667;0,96969696969697
"11381";16329;65;11381;6;49;59;10;0,757575757575758;0,909090909090909
"11382";16329;65;11382;6;49;61;12;0,757575757575758;0,939393939393939
"11383";16329;65;11383;6;27;33;6;0,424242424242424;0,515151515151515
"11384";16329;65;11384;6;47;53;6;0,727272727272727;0,818181818181818
"11385";16329;65;11385;6;47;55;8;0,727272727272727;0,848484848484849
"11386";16329;65;11386;6;29;35;6;0,454545454545455;0,545454545454545
"11387";16329;65;11387;6;25;31;6;0,393939393939394;0,484848484848485
"11388";16329;65;11388;6;31;37;6;0,484848484848485;0,575757575757576
"11389";16329;65;11389;6;45;51;6;0,696969696969697;0,787878787878788
"11390";16329;65;11390;6;45;53;8;0,696969696969697;0,818181818181818
"11391";16329;65;11391;6;45;55;10;0,696969696969697;0,848484848484849
"11392";16329;65;11392;6;45;57;12;0,696969696969697;0,878787878787879
"11393";16329;65;11393;6;45;59;14;0,696969696969697;0,909090909090909
"11394";16329;65;11394;6;45;61;16;0,696969696969697;0,939393939393939
"11395";16329;65;11395;6;45;63;18;0,696969696969697;0,96969696969697
"11396";16329;65;11396;6;51;65;14;0,787878787878788;1
"11397";16329;65;11397;6;37;53;16;0,575757575757576;0,818181818181818
"11398";16329;65;11398;6;41;57;16;0,636363636363636;0,878787878787879
"11399";16329;65;11399;6;49;63;14;0,757575757575758;0,96969696969697
"11400";16329;65;11400;6;49;65;16;0,757575757575758;1
"11401";16329;65;11401;6;33;43;10;0,515151515151515;0,666666666666667
"11402";16329;65;11402;6;33;45;12;0,515151515151515;0,696969696969697
"11403";16329;65;11403;6;33;47;14;0,515151515151515;0,727272727272727
"11404";16329;65;11404;6;45;65;20;0,696969696969697;1
"11405";16329;65;11405;6;47;57;10;0,727272727272727;0,878787878787879
"11406";16329;65;11406;6;47;59;12;0,727272727272727;0,909090909090909
"11407";16329;65;11407;6;35;53;18;0,545454545454545;0,818181818181818
"11408";16329;65;11408;6;41;59;18;0,636363636363636;0,909090909090909
"11409";16329;65;11409;6;41;61;20;0,636363636363636;0,939393939393939
"11410";16329;65;11410;6;41;63;22;0,636363636363636;0,96969696969697
"11411";16329;65;11411;6;41;65;24;0,636363636363636;1
"11412";16329;65;11412;6;9;15;6;0,151515151515152;0,242424242424242
"11413";16329;65;11413;6;37;55;18;0,575757575757576;0,848484848484849
"11414";16329;65;11414;6;37;57;20;0,575757575757576;0,878787878787879
"11415";16329;65;11415;6;37;59;22;0,575757575757576;0,909090909090909
"11416";16329;65;11416;6;37;61;24;0,575757575757576;0,939393939393939
"11417";16329;65;11417;6;31;39;8;0,484848484848485;0,606060606060606
"11418";16329;65;11418;6;35;55;20;0,545454545454545;0,848484848484849
"11419";16329;65;11419;6;35;57;22;0,545454545454545;0,878787878787879
"11420";16329;65;11420;6;35;59;24;0,545454545454545;0,909090909090909
"11421";16329;65;11421;6;35;61;26;0,545454545454545;0,939393939393939
"11422";16329;65;11422;6;35;63;28;0,545454545454545;0,96969696969697
"11423";16329;65;11423;6;35;65;30;0,545454545454545;1
"11424";16329;65;11424;6;39;65;26;0,606060606060606;1
"11425";16329;65;11425;6;43;65;22;0,666666666666667;1
"11426";16423;128;11426;4;80;128;48;0,625;1
"11427";16423;128;11427;5;88;112;24;0,6875;0,875
"11428";16423;128;11428;5;72;96;24;0,5625;0,75
"11429";16423;128;11429;5;80;104;24;0,625;0,8125
"11430";16423;128;11430;5;104;128;24;0,8125;1
"11431";16423;128;11431;5;88;120;32;0,6875;0,9375
"11432";16423;128;11432;5;80;112;32;0,625;0,875
"11433";16423;128;11433;6;112;124;12;0,875;0,96875
"11434";16423;128;11434;6;27;39;12;0,21875;0,3125
"11435";16423;128;11435;6;88;100;12;0,6875;0,78125
"11436";16423;128;11436;6;100;112;12;0,78125;0,875
"11437";16423;128;11437;6;112;128;16;0,875;1
"11438";16423;128;11438;6;100;116;16;0,78125;0,90625
"11439";16423;128;11439;6;100;120;20;0,78125;0,9375
"11440";16423;128;11440;6;88;104;16;0,6875;0,8125
"11441";16423;128;11441;6;88;108;20;0,6875;0,84375
"11442";16423;128;11442;6;88;112;24;0,6875;0,875
"11443";16423;128;11443;6;104;116;12;0,8125;0,90625
"11444";16423;128;11444;6;104;120;16;0,8125;0,9375
"11445";16423;128;11445;6;116;128;12;0,90625;1
"11446";16423;128;11446;6;59;72;13;0,46875;0,5625
"11447";16423;128;11447;6;92;104;12;0,71875;0,8125
"11448";16423;128;11448;6;96;108;12;0,75;0,84375
"11449";16423;128;11449;6;23;35;12;0,1875;0,28125
"11450";16423;128;11450;6;92;108;16;0,71875;0,84375
"11451";16423;128;11451;6;92;112;20;0,71875;0,875
"11452";16423;128;11452;6;96;112;16;0,75;0,875
"11453";16423;128;11453;6;19;31;12;0,15625;0,25
"11454";16423;128;11454;6;72;84;12;0,5625;0,65625
"11455";16423;128;11455;6;104;124;20;0,8125;0,96875
"11456";16423;128;11456;7;33;39;6;0,265625;0,3125
"11457";16423;128;11457;7;41;47;6;0,328125;0,375
"11458";16423;128;11458;7;86;92;6;0,671875;0,71875
"11459";16423;128;11459;7;88;94;6;0,6875;0,734375
"11460";16423;128;11460;7;92;98;6;0,71875;0,765625
"11461";16423;128;11461;7;110;116;6;0,859375;0,90625
"11462";16423;128;11462;7;112;118;6;0,875;0,921875
"11463";16423;128;11463;7;118;124;6;0,921875;0,96875
"11464";16423;128;11464;7;118;126;8;0,921875;0,984375
"11465";16423;128;11465;7;120;126;6;0,9375;0,984375
"11466";16423;128;11466;7;27;33;6;0,21875;0,265625
"11467";16423;128;11467;7;108;114;6;0,84375;0,890625
"11468";16423;128;11468;7;110;118;8;0,859375;0,921875
"11469";16423;128;11469;7;112;120;8;0,875;0,9375
"11470";16423;128;11470;7;120;128;8;0,9375;1
"11471";16423;128;11471;7;21;27;6;0,171875;0,21875
"11472";16423;128;11472;7;25;31;6;0,203125;0,25
"11473";16423;128;11473;7;61;68;7;0,484375;0,53125
"11474";16423;128;11474;7;86;94;8;0,671875;0,734375
"11475";16423;128;11475;7;86;96;10;0,671875;0,75
"11476";16423;128;11476;7;88;96;8;0,6875;0,75
"11477";16423;128;11477;7;88;98;10;0,6875;0,765625
"11478";16423;128;11478;7;108;116;8;0,84375;0,90625
"11479";16423;128;11479;7;108;118;10;0,84375;0,921875
"11480";16423;128;11480;7;116;122;6;0,90625;0,953125
"11481";16423;128;11481;7;122;128;6;0,953125;1
"11482";16423;128;11482;7;13;19;6;0,109375;0,15625
"11483";16423;128;11483;7;92;100;8;0,71875;0,78125
"11484";16423;128;11484;7;92;102;10;0,71875;0,796875
"11485";16423;128;11485;7;110;120;10;0,859375;0,9375
"11486";16423;128;11486;7;118;128;10;0,921875;1
"11487";16423;128;11487;7;59;66;7;0,46875;0,515625
"11488";16423;128;11488;7;31;37;6;0,25;0,296875
"11489";16423;128;11489;7;55;61;6;0,4375;0,484375
"11490";16423;128;11490;7;76;82;6;0,59375;0,640625
"11491";16423;128;11491;7;90;96;6;0,703125;0,75
"11492";16423;128;11492;7;90;98;8;0,703125;0,765625
"11493";16423;128;11493;7;100;106;6;0,78125;0,828125
"11494";16423;128;11494;7;23;29;6;0,1875;0,234375
"11495";16423;128;11495;7;106;112;6;0,828125;0,875
"11496";16423;128;11496;7;57;64;7;0,453125;0,5
"11497";16423;128;11497;7;90;100;10;0,703125;0,78125
"11498";16423;128;11498;7;90;102;12;0,703125;0,796875
"11499";16423;128;11499;7;29;35;6;0,234375;0,28125
"11500";16423;128;11500;7;70;76;6;0,546875;0,59375
"11501";16423;128;11501;7;23;31;8;0,1875;0,25
"11502";16423;128;11502;7;7;13;6;0,0625;0,109375
"11503";16423;128;11503;7;25;33;8;0,203125;0,265625
"11504";16423;128;11504;7;1;7;6;0,015625;0,0625
"11505";16423;128;11505;7;78;84;6;0,609375;0,65625
"11506";16423;128;11506;7;116;124;8;0,90625;0,96875
"11507";16423;128;11507;7;102;108;6;0,796875;0,84375
"11508";16423;128;11508;7;64;70;6;0,5;0,546875
"11509";16423;128;11509;7;106;114;8;0,828125;0,890625
"11510";16423;128;11510;7;106;116;10;0,828125;0,90625
"11511";16423;128;11511;7;114;120;6;0,890625;0,9375
"11512";16423;128;11512;7;86;98;12;0,671875;0,765625
"11513";16423;128;11513;7;72;78;6;0,5625;0,609375
"11514";16423;128;11514;7;108;120;12;0,84375;0,9375
"11515";16423;128;11515;7;112;122;10;0,875;0,953125
"11516";16423;128;11516;7;112;124;12;0,875;0,96875
"11517";16423;128;11517;7;9;15;6;0,078125;0,125
"11518";16423;128;11518;7;19;25;6;0,15625;0,203125
"11519";16423;128;11519;7;104;110;6;0,8125;0,859375
"11520";16493;73;11520;3;18;73;55;0,25;1
"11521";16493;73;11521;4;40;65;25;0,555555555555556;0,888888888888889
"11522";16493;73;11522;4;48;73;25;0,666666666666667;1
"11523";16493;73;11523;4;15;40;25;0,222222222222222;0,555555555555556
"11524";16493;73;11524;4;40;73;33;0,555555555555556;1
"11525";16493;73;11525;4;24;48;24;0,333333333333333;0,666666666666667
"11526";16493;73;11526;5;40;52;12;0,555555555555556;0,722222222222222
"11527";16493;73;11527;5;48;61;13;0,666666666666667;0,833333333333333
"11528";16493;73;11528;5;44;57;13;0,611111111111111;0,777777777777778
"11529";16493;73;11529;5;24;36;12;0,333333333333333;0,5
"11530";16493;73;11530;5;48;65;17;0,666666666666667;0,888888888888889
"11531";16493;73;11531;5;52;65;13;0,722222222222222;0,888888888888889
"11532";16493;73;11532;5;52;69;17;0,722222222222222;0,944444444444444
"11533";16493;73;11533;5;57;69;12;0,777777777777778;0,944444444444444
"11534";16493;73;11534;5;20;32;12;0,277777777777778;0,444444444444444
"11535";16493;73;11535;5;20;36;16;0,277777777777778;0,5
"11536";16493;73;11536;5;44;61;17;0,611111111111111;0,833333333333333
"11537";16493;73;11537;5;44;65;21;0,611111111111111;0,888888888888889
"11538";16493;73;11538;5;40;57;17;0,555555555555556;0,777777777777778
"11539";16493;73;11539;5;40;61;21;0,555555555555556;0,833333333333333
"11540";16493;73;11540;5;15;28;13;0,222222222222222;0,388888888888889
"11541";16493;73;11541;5;36;48;12;0,5;0,666666666666667
"11542";16493;73;11542;5;57;73;16;0,777777777777778;1
"11543";16493;73;11543;5;24;40;16;0,333333333333333;0,555555555555556
"11544";16493;73;11544;5;44;69;25;0,611111111111111;0,944444444444444
"11545";16493;73;11545;5;40;65;25;0,555555555555556;0,888888888888889
"11546";16493;73;11546;5;52;73;21;0,722222222222222;1
"11547";16493;73;11547;5;48;69;21;0,666666666666667;0,944444444444444
"11548";16493;73;11548;5;48;73;25;0,666666666666667;1
"11549";16493;73;11549;5;11;24;13;0,166666666666667;0,333333333333333
"11550";16493;73;11550;6;23;29;6;0,324324324324324;0,405405405405405
"11551";16493;73;11551;6;23;31;8;0,324324324324324;0,432432432432432
"11552";16493;73;11552;6;25;31;6;0,351351351351351;0,432432432432432
"11553";16493;73;11553;6;41;47;6;0,567567567567568;0,648648648648649
"11554";16493;73;11554;6;45;51;6;0,621621621621622;0,702702702702703
"11555";16493;73;11555;6;45;53;8;0,621621621621622;0,72972972972973
"11556";16493;73;11556;6;47;53;6;0,648648648648649;0,72972972972973
"11557";16493;73;11557;6;51;57;6;0,702702702702703;0,783783783783784
"11558";16493;73;11558;6;55;61;6;0,756756756756757;0,837837837837838
"11559";16493;73;11559;6;57;63;6;0,783783783783784;0,864864864864865
"11560";16493;73;11560;6;67;73;6;0,918918918918919;1
"11561";16493;73;11561;6;25;33;8;0,351351351351351;0,459459459459459
"11562";16493;73;11562;6;41;49;8;0,567567567567568;0,675675675675676
"11563";16493;73;11563;6;47;55;8;0,648648648648649;0,756756756756757
"11564";16493;73;11564;6;47;57;10;0,648648648648649;0,783783783783784
"11565";16493;73;11565;6;55;63;8;0,756756756756757;0,864864864864865
"11566";16493;73;11566;6;55;65;10;0,756756756756757;0,891891891891892
"11567";16493;73;11567;6;49;55;6;0,675675675675676;0,756756756756757
"11568";16493;73;11568;6;51;59;8;0,702702702702703;0,810810810810811
"11569";16493;73;11569;6;51;61;10;0,702702702702703;0,837837837837838
"11570";16493;73;11570;6;51;63;12;0,702702702702703;0,864864864864865
"11571";16493;73;11571;6;51;65;14;0,702702702702703;0,891891891891892
"11572";16493;73;11572;6;51;67;16;0,702702702702703;0,918918918918919
"11573";16493;73;11573;6;57;65;8;0,783783783783784;0,891891891891892
"11574";16493;73;11574;6;57;67;10;0,783783783783784;0,918918918918919
"11575";16493;73;11575;6;19;25;6;0,27027027027027;0,351351351351351
"11576";16493;73;11576;6;25;35;10;0,351351351351351;0,486486486486487
"11577";16493;73;11577;6;25;37;12;0,351351351351351;0,513513513513513
"11578";16493;73;11578;6;25;39;14;0,351351351351351;0,540540540540541
"11579";16493;73;11579;6;65;71;6;0,891891891891892;0,972972972972973
"11580";16493;73;11580;6;21;27;6;0,297297297297297;0,378378378378378
"11581";16493;73;11581;6;39;45;6;0,540540540540541;0,621621621621622
"11582";16493;73;11582;6;41;51;10;0,567567567567568;0,702702702702703
"11583";16493;73;11583;6;15;21;6;0,216216216216216;0,297297297297297
"11584";16493;73;11584;6;17;23;6;0,243243243243243;0,324324324324324
"11585";16493;73;11585;6;49;57;8;0,675675675675676;0,783783783783784
"11586";16493;73;11586;6;53;59;6;0,72972972972973;0,810810810810811
"11587";16493;73;11587;6;53;61;8;0,72972972972973;0,837837837837838
"11588";16493;73;11588;6;55;67;12;0,756756756756757;0,918918918918919
"11589";16493;73;11589;6;21;29;8;0,297297297297297;0,405405405405405
"11590";16493;73;11590;6;47;59;12;0,648648648648649;0,810810810810811
"11591";16493;73;11591;6;47;61;14;0,648648648648649;0,837837837837838
"11592";16493;73;11592;6;47;63;16;0,648648648648649;0,864864864864865
"11593";16493;73;11593;6;47;65;18;0,648648648648649;0,891891891891892
"11594";16493;73;11594;6;45;55;10;0,621621621621622;0,756756756756757
"11595";16493;73;11595;6;53;63;10;0,72972972972973;0,864864864864865
"11596";16493;73;11596;6;53;65;12;0,72972972972973;0,891891891891892
"11597";16493;73;11597;6;53;67;14;0,72972972972973;0,918918918918919
"11598";16493;73;11598;6;13;19;6;0,189189189189189;0,27027027027027
"11599";16493;73;11599;6;23;33;10;0,324324324324324;0,459459459459459
"11600";16493;73;11600;6;21;31;10;0,297297297297297;0,432432432432432
"11601";16493;73;11601;6;35;41;6;0,486486486486487;0,567567567567568
"11602";16493;73;11602;6;57;69;12;0,783783783783784;0,945945945945946
"11603";16493;73;11603;6;17;25;8;0,243243243243243;0,351351351351351
"11604";16493;73;11604;6;21;33;12;0,297297297297297;0,459459459459459
"11605";16493;73;11605;6;21;35;14;0,297297297297297;0,486486486486487
"11606";16493;73;11606;6;21;37;16;0,297297297297297;0,513513513513513
"11607";16493;73;11607;6;41;53;12;0,567567567567568;0,72972972972973
"11608";16493;73;11608;6;49;59;10;0,675675675675676;0,810810810810811
"11609";16493;73;11609;6;49;61;12;0,675675675675676;0,837837837837838
"11610";16493;73;11610;6;65;73;8;0,891891891891892;1
"11611";16493;73;11611;6;23;35;12;0,324324324324324;0,486486486486487
"11612";16493;73;11612;6;23;37;14;0,324324324324324;0,513513513513513
"11613";16493;73;11613;6;23;39;16;0,324324324324324;0,540540540540541
"11614";16493;73;11614;6;45;57;12;0,621621621621622;0,783783783783784
"11615";16493;73;11615;6;19;27;8;0,27027027027027;0,378378378378378
"11616";16493;73;11616;6;45;59;14;0,621621621621622;0,810810810810811
"11617";16493;73;11617;6;45;61;16;0,621621621621622;0,837837837837838
"11618";16493;73;11618;6;49;63;14;0,675675675675676;0,864864864864865
"11619";16527;71;11619;4;31;55;24;0,444444444444444;0,777777777777778
"11620";16527;71;11620;4;23;47;24;0,333333333333333;0,666666666666667
"11621";16527;71;11621;4;39;63;24;0,555555555555556;0,888888888888889
"11622";16527;71;11622;4;39;71;32;0,555555555555556;1
"11623";16527;71;11623;5;55;67;12;0,777777777777778;0,944444444444444
"11624";16527;71;11624;5;23;35;12;0,333333333333333;0,5
"11625";16527;71;11625;5;39;51;12;0,555555555555556;0,722222222222222
"11626";16527;71;11626;5;43;55;12;0,611111111111111;0,777777777777778
"11627";16527;71;11627;5;35;47;12;0,5;0,666666666666667
"11628";16527;71;11628;5;39;55;16;0,555555555555556;0,777777777777778
"11629";16527;71;11629;5;59;71;12;0,833333333333333;1
"11630";16527;71;11630;5;31;43;12;0,444444444444444;0,611111111111111
"11631";16527;71;11631;5;55;71;16;0,777777777777778;1
"11632";16527;71;11632;5;27;39;12;0,388888888888889;0,555555555555556
"11633";16527;71;11633;5;35;51;16;0,5;0,722222222222222
"11634";16527;71;11634;5;27;43;16;0,388888888888889;0,611111111111111
"11635";16527;71;11635;5;35;55;20;0,5;0,777777777777778
"11636";16527;71;11636;6;23;29;6;0,333333333333333;0,416666666666667
"11637";16527;71;11637;6;27;33;6;0,388888888888889;0,472222222222222
"11638";16527;71;11638;6;29;35;6;0,416666666666667;0,5
"11639";16527;71;11639;6;39;45;6;0,555555555555556;0,638888888888889
"11640";16527;71;11640;6;39;47;8;0,555555555555556;0,666666666666667
"11641";16527;71;11641;6;41;47;6;0,583333333333333;0,666666666666667
"11642";16527;71;11642;6;41;49;8;0,583333333333333;0,694444444444444
"11643";16527;71;11643;6;57;63;6;0,805555555555556;0,888888888888889
"11644";16527;71;11644;6;57;65;8;0,805555555555556;0,916666666666667
"11645";16527;71;11645;6;61;67;6;0,861111111111111;0,944444444444444
"11646";16527;71;11646;6;61;69;8;0,861111111111111;0,972222222222222
"11647";16527;71;11647;6;39;49;10;0,555555555555556;0,694444444444444
"11648";16527;71;11648;6;39;51;12;0,555555555555556;0,722222222222222
"11649";16527;71;11649;6;39;53;14;0,555555555555556;0,75
"11650";16527;71;11650;6;41;51;10;0,583333333333333;0,722222222222222
"11651";16527;71;11651;6;41;53;12;0,583333333333333;0,75
"11652";16527;71;11652;6;41;55;14;0,583333333333333;0,777777777777778
"11653";16527;71;11653;6;57;67;10;0,805555555555556;0,944444444444444
"11654";16527;71;11654;6;15;21;6;0,222222222222222;0,305555555555556
"11655";16527;71;11655;6;25;31;6;0,361111111111111;0,444444444444444
"11656";16527;71;11656;6;61;71;10;0,861111111111111;1
"11657";16527;71;11657;6;17;23;6;0,25;0,333333333333333
"11658";16527;71;11658;6;39;55;16;0,555555555555556;0,777777777777778
"11659";16527;71;11659;6;27;35;8;0,388888888888889;0,5
"11660";16527;71;11660;6;35;41;6;0,5;0,583333333333333
"11661";16527;71;11661;6;21;27;6;0,305555555555556;0,388888888888889
"11662";16527;71;11662;6;41;57;16;0,583333333333333;0,805555555555556
"11663";16527;71;11663;6;57;69;12;0,805555555555556;0,972222222222222
"11664";16527;71;11664;6;57;71;14;0,805555555555556;1
"11665";16527;71;11665;6;33;39;6;0,472222222222222;0,555555555555556
"11666";16527;71;11666;6;35;43;8;0,5;0,611111111111111
"11667";16527;71;11667;6;35;45;10;0,5;0,638888888888889
"11668";16527;71;11668;6;25;33;8;0,361111111111111;0,472222222222222
"11669";16527;71;11669;6;39;57;18;0,555555555555556;0,805555555555556
"11670";16527;71;11670;6;23;31;8;0,333333333333333;0,444444444444444
"11671";16527;71;11671;6;23;33;10;0,333333333333333;0,472222222222222
"11672";16527;71;11672;6;25;35;10;0,361111111111111;0,5
"11673";16527;71;11673;6;27;37;10;0,388888888888889;0,527777777777778
"11674";16527;71;11674;6;29;37;8;0,416666666666667;0,527777777777778
"11675";16527;71;11675;6;29;39;10;0,416666666666667;0,555555555555556
"11676";16527;71;11676;6;37;43;6;0,527777777777778;0,611111111111111
"11677";16527;71;11677;6;37;45;8;0,527777777777778;0,638888888888889
"11678";16527;71;11678;6;37;47;10;0,527777777777778;0,666666666666667
"11679";16527;71;11679;6;33;41;8;0,472222222222222;0,583333333333333
"11680";17088;155;11680;5;24;48;24;0,157894736842105;0,315789473684211
"11681";17088;155;11681;5;15;40;25;0,105263157894737;0,263157894736842
"11682";17088;155;11682;5;32;56;24;0,210526315789474;0,368421052631579
"11683";17088;155;11683;5;65;89;24;0,421052631578947;0,578947368421053
"11684";17088;155;11684;5;89;114;25;0,578947368421053;0,736842105263158
"11685";17088;155;11685;5;40;65;25;0,263157894736842;0,421052631578947
"11686";17088;155;11686;5;7;32;25;0,0526315789473684;0,210526315789474
"11687";17088;155;11687;5;130;155;25;0,842105263157895;1
"11688";17088;155;11688;5;106;130;24;0,684210526315789;0,842105263157895
"11689";17088;155;11689;6;139;151;12;0,897435897435897;0,974358974358974
"11690";17088;155;11690;6;11;23;12;0,0769230769230769;0,153846153846154
"11691";17088;155;11691;6;39;51;12;0,256410256410256;0,333333333333333
"11692";17088;155;11692;6;27;39;12;0,179487179487179;0,256410256410256
"11693";17088;155;11693;6;67;79;12;0,435897435897436;0,512820512820513
"11694";17088;155;11694;6;47;59;12;0,307692307692308;0,384615384615385
"11695";17088;155;11695;6;71;83;12;0,461538461538462;0,538461538461538
"11696";17088;155;11696;6;71;87;16;0,461538461538462;0,564102564102564
"11697";17088;155;11697;6;75;87;12;0,487179487179487;0,564102564102564
"11698";17088;155;11698;6;79;91;12;0,512820512820513;0,58974358974359
"11699";17088;155;11699;6;111;123;12;0,717948717948718;0,794871794871795
"11700";17088;155;11700;6;43;55;12;0,282051282051282;0,358974358974359
"11701";17088;155;11701;6;43;59;16;0,282051282051282;0,384615384615385
"11702";17088;155;11702;6;115;127;12;0,743589743589744;0,82051282051282
"11703";17088;155;11703;6;119;131;12;0,769230769230769;0,846153846153846
"11704";17088;155;11704;6;51;63;12;0,333333333333333;0,41025641025641
"11705";17088;155;11705;6;95;107;12;0,615384615384615;0,692307692307692
"11706";17088;155;11706;6;135;147;12;0,871794871794872;0,948717948717949
"11707";17088;155;11707;6;23;35;12;0,153846153846154;0,230769230769231
"11708";17088;155;11708;6;31;43;12;0,205128205128205;0,282051282051282
"11709";17088;155;11709;6;39;55;16;0,256410256410256;0,358974358974359
"11710";17088;155;11710;6;107;119;12;0,692307692307692;0,769230769230769
"11711";17088;155;11711;6;87;99;12;0,564102564102564;0,641025641025641
"11712";17088;155;11712;6;35;47;12;0,230769230769231;0,307692307692308
"11713";17088;155;11713;6;59;71;12;0,384615384615385;0,461538461538462
"11714";17088;155;11714;6;115;131;16;0,743589743589744;0,846153846153846
"11715";17088;155;11715;6;19;31;12;0,128205128205128;0,205128205128205
"11716";17088;155;11716;6;47;63;16;0,307692307692308;0,41025641025641
"11717";17088;155;11717;6;55;67;12;0,358974358974359;0,435897435897436
"11718";17088;155;11718;6;131;143;12;0,846153846153846;0,923076923076923
"11719";17088;155;11719;6;143;155;12;0,923076923076923;1
"11720";17088;155;11720;6;63;75;12;0,41025641025641;0,487179487179487
"11721";17088;155;11721;6;7;19;12;0,0512820512820513;0,128205128205128
"11722";17088;155;11722;6;91;103;12;0,58974358974359;0,666666666666667
"11723";17088;155;11723;6;39;59;20;0,256410256410256;0,384615384615385
"11724";17088;155;11724;6;103;115;12;0,666666666666667;0,743589743589744
"11725";17088;155;11725;6;111;127;16;0,717948717948718;0,82051282051282
"11726";17088;155;11726;6;111;131;20;0,717948717948718;0,846153846153846
"11727";17088;155;11727;6;15;27;12;0,102564102564103;0,179487179487179
"11728";18515;57;11728;3;32;57;25;0,571428571428571;1
"11729";18515;57;11729;4;16;28;12;0,285714285714286;0,5
"11730";18515;57;11730;4;40;53;13;0,714285714285714;0,928571428571429
"11731";18515;57;11731;4;36;49;13;0,642857142857143;0,857142857142857
"11732";18515;57;11732;4;32;45;13;0,571428571428571;0,785714285714286
"11733";18515;57;11733;5;37;43;6;0,655172413793103;0,758620689655172
"11734";18515;57;11734;5;45;51;6;0,793103448275862;0,896551724137931
"11735";18515;57;11735;5;43;49;6;0,758620689655172;0,862068965517241
"11736";18515;57;11736;5;43;51;8;0,758620689655172;0,896551724137931
"11737";18515;57;11737;5;43;53;10;0,758620689655172;0,931034482758621
"11738";18515;57;11738;5;45;53;8;0,793103448275862;0,931034482758621
"11739";18515;57;11739;5;47;53;6;0,827586206896552;0,931034482758621
"11740";18515;57;11740;5;39;45;6;0,689655172413793;0,793103448275862
"11741";18515;57;11741;5;39;47;8;0,689655172413793;0,827586206896552
"11742";18515;57;11742;5;33;39;6;0,586206896551724;0,689655172413793
"11743";18515;57;11743;5;35;41;6;0,620689655172414;0,724137931034483
"11744";18515;57;11744;5;35;43;8;0,620689655172414;0,758620689655172
"11745";18515;57;11745;5;21;27;6;0,379310344827586;0,482758620689655
"11746";18515;57;11746;5;7;13;6;0,137931034482759;0,241379310344828
"11747";18515;57;11747;5;17;23;6;0,310344827586207;0,413793103448276
"11748";19012;60;11748;4;15;27;12;0,266666666666667;0,466666666666667
"11749";19012;60;11749;4;44;56;12;0,733333333333333;0,933333333333333
"11750";19012;60;11750;4;44;60;16;0,733333333333333;1
"11751";19012;60;11751;4;48;60;12;0,8;1
"11752";19012;60;11752;4;23;36;13;0,4;0,6
"11753";19012;60;11753;4;7;19;12;0,133333333333333;0,333333333333333
"11754";19012;60;11754;5;50;56;6;0,833333333333333;0,933333333333333
"11755";19012;60;11755;5;23;30;7;0,4;0,5
"11756";19012;60;11756;5;50;58;8;0,833333333333333;0,966666666666667
"11757";19012;60;11757;5;54;60;6;0,9;1
"11758";19012;60;11758;5;21;27;6;0,366666666666667;0,466666666666667
"11759";19012;60;11759;5;50;60;10;0,833333333333333;1
"11760";19012;60;11760;5;25;32;7;0,433333333333333;0,533333333333333
"11761";19012;60;11761;5;15;21;6;0,266666666666667;0,366666666666667
"11762";19012;60;11762;5;46;52;6;0,766666666666667;0,866666666666667
"11763";19012;60;11763;5;46;54;8;0,766666666666667;0,9
"11764";19012;60;11764;5;44;50;6;0,733333333333333;0,833333333333333
"11765";19012;60;11765;5;19;25;6;0,333333333333333;0,433333333333333
"11766";19012;60;11766;5;17;23;6;0,3;0,4
"11767";19012;60;11767;5;9;15;6;0,166666666666667;0,266666666666667
"11768";19596;62;11768;3;35;62;27;0,571428571428571;1
"11769";19596;62;11769;4;41;54;13;0,666666666666667;0,866666666666667
"11770";19596;62;11770;4;41;58;17;0,666666666666667;0,933333333333333
"11771";19596;62;11771;4;41;62;21;0,666666666666667;1
"11772";19596;62;11772;4;37;49;12;0,6;0,8
"11773";19596;62;11773;4;37;54;17;0,6;0,866666666666667
"11774";19596;62;11774;4;37;58;21;0,6;0,933333333333333
"11775";19596;62;11775;4;24;37;13;0,4;0,6
"11776";19596;62;11776;5;40;46;6;0,645161290322581;0,741935483870968
"11777";19596;62;11777;5;40;48;8;0,645161290322581;0,774193548387097
"11778";19596;62;11778;5;40;50;10;0,645161290322581;0,806451612903226
"11779";19596;62;11779;5;3;9;6;0,0645161290322581;0,161290322580645
"11780";19596;62;11780;5;5;11;6;0,0967741935483871;0,193548387096774
"11781";19596;62;11781;5;32;38;6;0,516129032258065;0,612903225806452
"11782";19596;62;11782;5;29;36;7;0,483870967741935;0,580645161290323
"11783";19596;62;11783;5;40;52;12;0,645161290322581;0,838709677419355
"11784";19596;62;11784;5;40;54;14;0,645161290322581;0,870967741935484
"11785";19596;62;11785;5;40;56;16;0,645161290322581;0,903225806451613
"11786";19596;62;11786;5;40;58;18;0,645161290322581;0,935483870967742
"11787";19596;62;11787;5;40;60;20;0,645161290322581;0,967741935483871
"11788";19596;62;11788;5;40;62;22;0,645161290322581;1
"11789";19596;62;11789;5;42;48;6;0,67741935483871;0,774193548387097
"11790";19596;62;11790;5;42;50;8;0,67741935483871;0,806451612903226
"11791";19596;62;11791;5;42;52;10;0,67741935483871;0,838709677419355
"11792";19596;62;11792;5;42;54;12;0,67741935483871;0,870967741935484
"11793";19596;62;11793;5;42;56;14;0,67741935483871;0,903225806451613
"11794";19596;62;11794;5;42;58;16;0,67741935483871;0,935483870967742
"11795";19596;62;11795;5;7;13;6;0,129032258064516;0,225806451612903
"11796";19596;62;11796;5;11;17;6;0,193548387096774;0,290322580645161
"11797";19596;62;11797;5;3;11;8;0,0645161290322581;0,193548387096774
"11798";19596;62;11798;5;9;15;6;0,161290322580645;0,258064516129032
"11799";19596;62;11799;5;27;34;7;0,451612903225806;0,548387096774194
"11800";19596;62;11800;5;1;7;6;0,032258064516129;0,129032258064516
"11801";19596;62;11801;5;42;60;18;0,67741935483871;0,967741935483871
"11802";19596;62;11802;5;42;62;20;0,67741935483871;1
"11803";19596;62;11803;5;17;23;6;0,290322580645161;0,387096774193548
"11804";19596;62;11804;5;19;25;6;0,32258064516129;0,419354838709677
"11805";19893;57;11805;3;32;57;25;0,571428571428571;1
"11806";19893;57;11806;3;7;32;25;0,142857142857143;0,571428571428571
"11807";19893;57;11807;4;40;53;13;0,714285714285714;0,928571428571429
"11808";19893;57;11808;4;11;24;13;0,214285714285714;0,428571428571429
"11809";19893;57;11809;4;20;32;12;0,357142857142857;0,571428571428571
"11810";19893;57;11810;4;36;49;13;0,642857142857143;0,857142857142857
"11811";19893;57;11811;4;36;53;17;0,642857142857143;0,928571428571429
"11812";19893;57;11812;4;36;57;21;0,642857142857143;1
"11813";19893;57;11813;4;40;57;17;0,714285714285714;1
"11814";19893;57;11814;4;45;57;12;0,785714285714286;1
"11815";19893;57;11815;4;11;28;17;0,214285714285714;0,5
"11816";19893;57;11816;4;7;20;13;0,142857142857143;0,357142857142857
"11817";19893;57;11817;4;7;24;17;0,142857142857143;0,428571428571429
"11818";19893;57;11818;4;16;28;12;0,285714285714286;0,5
"11819";19893;57;11819;4;24;36;12;0,428571428571429;0,642857142857143
"11820";19893;57;11820;5;21;27;6;0,379310344827586;0,482758620689655
"11821";19893;57;11821;5;25;31;6;0,448275862068966;0,551724137931034
"11822";19893;57;11822;5;37;43;6;0,655172413793103;0,758620689655172
"11823";19893;57;11823;5;37;45;8;0,655172413793103;0,793103448275862
"11824";19893;57;11824;5;37;47;10;0,655172413793103;0,827586206896552
"11825";19893;57;11825;5;39;45;6;0,689655172413793;0,793103448275862
"11826";19893;57;11826;5;39;47;8;0,689655172413793;0,827586206896552
"11827";19893;57;11827;5;43;49;6;0,758620689655172;0,862068965517241
"11828";19893;57;11828;5;43;51;8;0,758620689655172;0,896551724137931
"11829";19893;57;11829;5;51;57;6;0,896551724137931;1
"11830";19893;57;11830;5;11;17;6;0,206896551724138;0,310344827586207
"11831";19893;57;11831;5;11;19;8;0,206896551724138;0,344827586206897
"11832";19893;57;11832;5;11;21;10;0,206896551724138;0,379310344827586
"11833";19893;57;11833;5;11;23;12;0,206896551724138;0,413793103448276
"11834";19893;57;11834;5;19;25;6;0,344827586206897;0,448275862068966
"11835";19893;57;11835;5;39;49;10;0,689655172413793;0,862068965517241
"11836";19893;57;11836;5;39;51;12;0,689655172413793;0,896551724137931
"11837";19893;57;11837;5;39;53;14;0,689655172413793;0,931034482758621
"11838";19893;57;11838;5;21;29;8;0,379310344827586;0,517241379310345
"11839";19893;57;11839;5;21;31;10;0,379310344827586;0,551724137931034
"11840";19893;57;11840;5;19;27;8;0,344827586206897;0,482758620689655
"11841";19893;57;11841;5;23;29;6;0,413793103448276;0,517241379310345
"11842";19893;57;11842;5;23;31;8;0,413793103448276;0,551724137931034
"11843";19893;57;11843;5;25;33;8;0,448275862068966;0,586206896551724
"11844";19893;57;11844;5;39;55;16;0,689655172413793;0,96551724137931
"11845";19893;57;11845;5;43;53;10;0,758620689655172;0,931034482758621
"11846";19893;57;11846;5;43;55;12;0,758620689655172;0,96551724137931
"11847";19893;57;11847;5;43;57;14;0,758620689655172;1
"11848";19893;57;11848;5;35;41;6;0,620689655172414;0,724137931034483
"11849";19893;57;11849;5;7;13;6;0,137931034482759;0,241379310344828
"11850";19893;57;11850;5;7;15;8;0,137931034482759;0,275862068965517
"11851";19893;57;11851;5;7;17;10;0,137931034482759;0,310344827586207
"11852";19893;57;11852;5;11;25;14;0,206896551724138;0,448275862068966
"11853";19893;57;11853;5;37;49;12;0,655172413793103;0,862068965517241
"11854";19893;57;11854;5;27;33;6;0,482758620689655;0,586206896551724
"11855";19893;57;11855;5;27;35;8;0,482758620689655;0,620689655172414
"11856";19893;57;11856;5;39;57;18;0,689655172413793;1
"11857";19893;57;11857;5;29;35;6;0,517241379310345;0,620689655172414
"11858";19893;57;11858;5;19;29;10;0,344827586206897;0,517241379310345
"11859";19893;57;11859;5;37;51;14;0,655172413793103;0,896551724137931
"11860";19893;57;11860;5;37;53;16;0,655172413793103;0,931034482758621
"11861";19893;57;11861;5;19;31;12;0,344827586206897;0,551724137931034
"11862";19893;57;11862;5;35;43;8;0,620689655172414;0,758620689655172
"11863";19893;57;11863;5;37;55;18;0,655172413793103;0,96551724137931
"11864";19893;57;11864;5;37;57;20;0,655172413793103;1
"11865";19893;57;11865;5;5;11;6;0,103448275862069;0,206896551724138
"11866";19893;57;11866;5;23;33;10;0,413793103448276;0,586206896551724
"11867";19983;65;11867;4;32;57;25;0,5;0,875
"11868";19983;65;11868;4;40;65;25;0,625;1
"11869";19983;65;11869;4;32;65;33;0,5;1
"11870";19983;65;11870;4;24;48;24;0,375;0,75
"11871";19983;65;11871;5;53;65;12;0,8125;1
"11872";19983;65;11872;5;44;57;13;0,6875;0,875
"11873";19983;65;11873;5;44;61;17;0,6875;0,9375
"11874";19983;65;11874;5;36;48;12;0,5625;0,75
"11875";19983;65;11875;5;36;53;17;0,5625;0,8125
"11876";19983;65;11876;5;36;57;21;0,5625;0,875
"11877";19983;65;11877;5;36;61;25;0,5625;0,9375
"11878";19983;65;11878;5;36;65;29;0,5625;1
"11879";19983;65;11879;5;40;53;13;0,625;0,8125
"11880";19983;65;11880;5;44;65;21;0,6875;1
"11881";19983;65;11881;5;48;61;13;0,75;0,9375
"11882";19983;65;11882;5;48;65;17;0,75;1
"11883";19983;65;11883;5;28;40;12;0,4375;0,625
"11884";19983;65;11884;5;28;44;16;0,4375;0,6875
"11885";19983;65;11885;5;24;36;12;0,375;0,5625
"11886";19983;65;11886;5;24;40;16;0,375;0,625
"11887";19983;65;11887;5;32;44;12;0,5;0,6875
"11888";19983;65;11888;5;40;57;17;0,625;0,875
"11889";19983;65;11889;5;28;48;20;0,4375;0,75
"11890";19983;65;11890;5;40;61;21;0,625;0,9375
"11891";19983;65;11891;5;40;65;25;0,625;1
"11892";19983;65;11892;6;33;39;6;0,515151515151515;0,606060606060606
"11893";19983;65;11893;6;33;41;8;0,515151515151515;0,636363636363636
"11894";19983;65;11894;6;37;43;6;0,575757575757576;0,666666666666667
"11895";19983;65;11895;6;39;45;6;0,606060606060606;0,696969696969697
"11896";19983;65;11896;6;41;47;6;0,636363636363636;0,727272727272727
"11897";19983;65;11897;6;41;49;8;0,636363636363636;0,757575757575758
"11898";19983;65;11898;6;41;51;10;0,636363636363636;0,787878787878788
"11899";19983;65;11899;6;41;53;12;0,636363636363636;0,818181818181818
"11900";19983;65;11900;6;41;55;14;0,636363636363636;0,848484848484849
"11901";19983;65;11901;6;45;51;6;0,696969696969697;0,787878787878788
"11902";19983;65;11902;6;45;53;8;0,696969696969697;0,818181818181818
"11903";19983;65;11903;6;49;55;6;0,757575757575758;0,848484848484849
"11904";19983;65;11904;6;49;57;8;0,757575757575758;0,878787878787879
"11905";19983;65;11905;6;49;59;10;0,757575757575758;0,909090909090909
"11906";19983;65;11906;6;51;57;6;0,787878787878788;0,878787878787879
"11907";19983;65;11907;6;53;59;6;0,818181818181818;0,909090909090909
"11908";19983;65;11908;6;55;61;6;0,848484848484849;0,939393939393939
"11909";19983;65;11909;6;57;63;6;0,878787878787879;0,96969696969697
"11910";19983;65;11910;6;57;65;8;0,878787878787879;1
"11911";19983;65;11911;6;59;65;6;0,909090909090909;1
"11912";19983;65;11912;6;33;43;10;0,515151515151515;0,666666666666667
"11913";19983;65;11913;6;33;45;12;0,515151515151515;0,696969696969697
"11914";19983;65;11914;6;35;41;6;0,545454545454545;0,636363636363636
"11915";19983;65;11915;6;35;43;8;0,545454545454545;0,666666666666667
"11916";19983;65;11916;6;37;45;8;0,575757575757576;0,696969696969697
"11917";19983;65;11917;6;43;49;6;0,666666666666667;0,757575757575758
"11918";19983;65;11918;6;43;51;8;0,666666666666667;0,787878787878788
"11919";19983;65;11919;6;43;53;10;0,666666666666667;0,818181818181818
"11920";19983;65;11920;6;45;55;10;0,696969696969697;0,848484848484849
"11921";19983;65;11921;6;45;57;12;0,696969696969697;0,878787878787879
"11922";19983;65;11922;6;45;59;14;0,696969696969697;0,909090909090909
"11923";19983;65;11923;6;47;53;6;0,727272727272727;0,818181818181818
"11924";19983;65;11924;6;47;55;8;0,727272727272727;0,848484848484849
"11925";19983;65;11925;6;47;57;10;0,727272727272727;0,878787878787879
"11926";19983;65;11926;6;47;59;12;0,727272727272727;0,909090909090909
"11927";19983;65;11927;6;47;61;14;0,727272727272727;0,939393939393939
"11928";19983;65;11928;6;51;59;8;0,787878787878788;0,909090909090909
"11929";19983;65;11929;6;51;61;10;0,787878787878788;0,939393939393939
"11930";19983;65;11930;6;53;61;8;0,818181818181818;0,939393939393939
"11931";19983;65;11931;6;53;63;10;0,818181818181818;0,96969696969697
"11932";19983;65;11932;6;55;63;8;0,848484848484849;0,96969696969697
"11933";19983;65;11933;6;13;19;6;0,212121212121212;0,303030303030303
"11934";19983;65;11934;6;53;65;12;0,818181818181818;1
"11935";19983;65;11935;6;55;65;10;0,848484848484849;1
"11936";19983;65;11936;6;35;45;10;0,545454545454545;0,696969696969697
"11937";19983;65;11937;6;31;37;6;0,484848484848485;0,575757575757576
"11938";19983;65;11938;6;31;39;8;0,484848484848485;0,606060606060606
"11939";19983;65;11939;6;49;61;12;0,757575757575758;0,939393939393939
"11940";19983;65;11940;6;51;63;12;0,787878787878788;0,96969696969697
"11941";19983;65;11941;6;39;47;8;0,606060606060606;0,727272727272727
"11942";19983;65;11942;6;39;49;10;0,606060606060606;0,757575757575758
"11943";19983;65;11943;6;49;63;14;0,757575757575758;0,96969696969697
"11944";19983;65;11944;6;49;65;16;0,757575757575758;1
"11945";19983;65;11945;6;51;65;14;0,787878787878788;1
"11946";19983;65;11946;6;31;41;10;0,484848484848485;0,636363636363636
"11947";19983;65;11947;6;47;63;16;0,727272727272727;0,96969696969697
"11948";19983;65;11948;6;47;65;18;0,727272727272727;1
"11949";20605;58;11949;4;7;20;13;0,142857142857143;0,357142857142857
"11950";20605;58;11950;4;12;24;12;0,214285714285714;0,428571428571429
"11951";20605;58;11951;4;3;16;13;0,0714285714285714;0,285714285714286
"11952";20605;58;11952;5;7;13;6;0,137931034482759;0,241379310344828
"11953";20605;58;11953;5;9;15;6;0,172413793103448;0,275862068965517
"11954";20605;58;11954;5;17;23;6;0,310344827586207;0,413793103448276
"11955";20605;58;11955;5;23;30;7;0,413793103448276;0,517241379310345
"11956";20605;58;11956;5;15;21;6;0,275862068965517;0,379310344827586
"11957";20605;58;11957;5;9;17;8;0,172413793103448;0,310344827586207
"11958";20605;58;11958;5;11;17;6;0,206896551724138;0,310344827586207
"11959";20605;58;11959;5;7;15;8;0,137931034482759;0,275862068965517
"11960";20605;58;11960;5;13;19;6;0,241379310344828;0,344827586206897
"11961";20605;58;11961;5;13;21;8;0,241379310344828;0,379310344827586
"11962";20605;58;11962;5;15;23;8;0,275862068965517;0,413793103448276
"11963";20605;58;11963;5;5;11;6;0,103448275862069;0,206896551724138
"11964";21585;79;11964;4;55;79;24;0,7;1
"11965";21585;79;11965;4;47;71;24;0,6;0,9
"11966";21585;79;11966;4;47;79;32;0,6;1
"11967";21585;79;11967;5;55;67;12;0,7;0,85
"11968";21585;79;11968;5;3;15;12;0,05;0,2
"11969";21585;79;11969;5;3;19;16;0,05;0,25
"11970";21585;79;11970;5;3;23;20;0,05;0,3
"11971";21585;79;11971;5;59;71;12;0,75;0,9
"11972";21585;79;11972;5;59;75;16;0,75;0,95
"11973";21585;79;11973;5;63;75;12;0,8;0,95
"11974";21585;79;11974;5;63;79;16;0,8;1
"11975";21585;79;11975;5;43;55;12;0,55;0,7
"11976";21585;79;11976;5;59;79;20;0,75;1
"11977";21585;79;11977;5;55;71;16;0,7;0,9
"11978";21585;79;11978;5;55;75;20;0,7;0,95
"11979";21585;79;11979;5;55;79;24;0,7;1
"11980";21585;79;11980;5;47;59;12;0,6;0,75
"11981";21585;79;11981;6;1;7;6;0,025;0,1
"11982";21585;79;11982;6;1;9;8;0,025;0,125
"11983";21585;79;11983;6;1;11;10;0,025;0,15
"11984";21585;79;11984;6;47;53;6;0,6;0,675
"11985";21585;79;11985;6;47;55;8;0,6;0,7
"11986";21585;79;11986;6;49;55;6;0,625;0,7
"11987";21585;79;11987;6;55;61;6;0,7;0,775
"11988";21585;79;11988;6;61;67;6;0,775;0,85
"11989";21585;79;11989;6;61;69;8;0,775;0,875
"11990";21585;79;11990;6;61;71;10;0,775;0,9
"11991";21585;79;11991;6;1;13;12;0,025;0,175
"11992";21585;79;11992;6;1;15;14;0,025;0,2
"11993";21585;79;11993;6;1;17;16;0,025;0,225
"11994";21585;79;11994;6;1;19;18;0,025;0,25
"11995";21585;79;11995;6;33;39;6;0,425;0,5
"11996";21585;79;11996;6;33;41;8;0,425;0,525
"11997";21585;79;11997;6;33;43;10;0,425;0,55
"11998";21585;79;11998;6;61;73;12;0,775;0,925
"11999";21585;79;11999;6;35;41;6;0,45;0,525
"12000";21585;79;12000;6;35;43;8;0,45;0,55
"12001";21585;79;12001;6;35;45;10;0,45;0,575
"12002";21585;79;12002;6;45;51;6;0,575;0,65
"12003";21585;79;12003;6;61;75;14;0,775;0,95
"12004";21585;79;12004;6;61;77;16;0,775;0,975
"12005";21585;79;12005;6;61;79;18;0,775;1
"12006";21585;79;12006;6;55;63;8;0,7;0,8
"12007";21585;79;12007;6;1;21;20;0,025;0,275
"12008";21585;79;12008;6;1;23;22;0,025;0,3
"12009";21585;79;12009;6;45;53;8;0,575;0,675
"12010";21585;79;12010;6;57;63;6;0,725;0,8
"12011";21585;79;12011;6;57;65;8;0,725;0,825
"12012";21585;79;12012;6;57;67;10;0,725;0,85
"12013";21585;79;12013;6;57;69;12;0,725;0,875
"12014";21585;79;12014;6;57;71;14;0,725;0,9
"12015";21585;79;12015;6;33;45;12;0,425;0,575
"12016";22716;64;12016;4;40;64;24;0,625;1
"12017";22716;64;12017;5;11;23;12;0,1875;0,375
"12018";22716;64;12018;5;15;27;12;0,25;0,4375
"12019";22716;64;12019;5;36;48;12;0,5625;0,75
"12020";22716;64;12020;5;32;44;12;0,5;0,6875
"12021";22716;64;12021;5;52;64;12;0,8125;1
"12022";22716;64;12022;5;32;48;16;0,5;0,75
"12023";22716;64;12023;5;48;60;12;0,75;0,9375
"12024";22716;64;12024;5;48;64;16;0,75;1
"12025";22716;64;12025;5;11;27;16;0,1875;0,4375
"12026";22716;64;12026;6;17;23;6;0,28125;0,375
"12027";22716;64;12027;6;19;25;6;0,3125;0,40625
"12028";22716;64;12028;6;36;42;6;0,5625;0,65625
"12029";22716;64;12029;6;38;44;6;0,59375;0,6875
"12030";22716;64;12030;6;50;56;6;0,78125;0,875
"12031";22716;64;12031;6;17;25;8;0,28125;0,40625
"12032";22716;64;12032;6;17;27;10;0,28125;0,4375
"12033";22716;64;12033;6;17;29;12;0,28125;0,46875
"12034";22716;64;12034;6;19;27;8;0,3125;0,4375
"12035";22716;64;12035;6;19;29;10;0,3125;0,46875
"12036";22716;64;12036;6;36;44;8;0,5625;0,6875
"12037";22716;64;12037;6;52;58;6;0,8125;0,90625
"12038";22716;64;12038;6;56;62;6;0,875;0,96875
"12039";22716;64;12039;6;34;40;6;0,53125;0,625
"12040";22716;64;12040;6;38;46;8;0,59375;0,71875
"12041";22716;64;12041;6;38;48;10;0,59375;0,75
"12042";22716;64;12042;6;58;64;6;0,90625;1
"12043";22716;64;12043;6;36;46;10;0,5625;0,71875
"12044";22716;64;12044;6;52;60;8;0,8125;0,9375
"12045";22716;64;12045;6;52;62;10;0,8125;0,96875
"12046";22716;64;12046;6;56;64;8;0,875;1
"12047";22716;64;12047;6;13;19;6;0,21875;0,3125
"12048";22716;64;12048;6;13;21;8;0,21875;0,34375
"12049";22716;64;12049;6;13;23;10;0,21875;0,375
"12050";22716;64;12050;6;36;48;12;0,5625;0,75
"12051";22716;64;12051;6;36;50;14;0,5625;0,78125
"12052";22716;64;12052;6;32;38;6;0,5;0,59375
"12053";22716;64;12053;6;11;17;6;0,1875;0,28125
"12054";22716;64;12054;6;34;42;8;0,53125;0,65625
"12055";22716;64;12055;6;50;58;8;0,78125;0,90625
"12056";22716;64;12056;6;13;25;12;0,21875;0,40625
"12057";22716;64;12057;6;38;50;12;0,59375;0,78125
"12058";22716;64;12058;6;1;7;6;0,03125;0,125
"12059";22716;64;12059;6;34;44;10;0,53125;0,6875
"12060";22716;64;12060;6;34;46;12;0,53125;0,71875
"12061";22716;64;12061;6;50;60;10;0,78125;0,9375
"12062";22716;64;12062;6;52;64;12;0,8125;1
"12063";22716;64;12063;6;15;21;6;0,25;0,34375
"12064";22716;64;12064;6;15;23;8;0,25;0,375
"12065";22716;64;12065;6;34;48;14;0,53125;0,75
"12066";22716;64;12066;6;29;36;7;0,46875;0,5625
"12067";23964;73;12067;5;57;69;12;0,777777777777778;0,944444444444444
"12068";23964;73;12068;5;57;73;16;0,777777777777778;1
"12069";23964;73;12069;5;61;73;12;0,833333333333333;1
"12070";23964;73;12070;6;57;63;6;0,783783783783784;0,864864864864865
"12071";23964;73;12071;6;57;65;8;0,783783783783784;0,891891891891892
"12072";23964;73;12072;6;59;65;6;0,810810810810811;0,891891891891892
"12073";23964;73;12073;6;63;69;6;0,864864864864865;0,945945945945946
"12074";23964;73;12074;6;67;73;6;0,918918918918919;1
"12075";23964;73;12075;6;39;45;6;0,540540540540541;0,621621621621622
"12076";23964;73;12076;6;45;51;6;0,621621621621622;0,702702702702703
"12077";23964;73;12077;6;59;67;8;0,810810810810811;0,918918918918919
"12078";23964;73;12078;6;59;69;10;0,810810810810811;0,945945945945946
"12079";23964;73;12079;6;25;31;6;0,351351351351351;0,432432432432432
"12080";23964;73;12080;6;63;71;8;0,864864864864865;0,972972972972973
"12081";23964;73;12081;6;63;73;10;0,864864864864865;1
"12082";23964;73;12082;6;57;67;10;0,783783783783784;0,918918918918919
"12083";23964;73;12083;6;57;69;12;0,783783783783784;0,945945945945946
"12084";23964;73;12084;6;57;71;14;0,783783783783784;0,972972972972973
"12085";23964;73;12085;6;59;71;12;0,810810810810811;0,972972972972973
"12086";23964;73;12086;6;59;73;14;0,810810810810811;1
"12087";23964;73;12087;6;55;61;6;0,756756756756757;0,837837837837838
"12088";23964;73;12088;6;55;63;8;0,756756756756757;0,864864864864865
"12089";23964;73;12089;6;55;65;10;0,756756756756757;0,891891891891892
"12090";23964;73;12090;6;23;29;6;0,324324324324324;0,405405405405405
"12091";23964;73;12091;6;37;43;6;0,513513513513513;0,594594594594595
"12092";23964;73;12092;6;37;45;8;0,513513513513513;0,621621621621622
"12093";23964;73;12093;6;23;31;8;0,324324324324324;0,432432432432432
"12094";23964;73;12094;6;57;73;16;0,783783783783784;1
"12095";25037;59;12095;3;33;59;26;0,571428571428571;1
"12096";25037;59;12096;4;27;39;12;0,466666666666667;0,666666666666667
"12097";25037;59;12097;4;43;55;12;0,733333333333333;0,933333333333333
"12098";25037;59;12098;4;43;59;16;0,733333333333333;1
"12099";25037;59;12099;4;39;51;12;0,666666666666667;0,866666666666667
"12100";25037;59;12100;4;11;23;12;0,2;0,4
"12101";25037;59;12101;4;23;35;12;0,4;0,6
"12102";25037;59;12102;4;7;19;12;0,133333333333333;0,333333333333333
"12103";25037;59;12103;4;15;27;12;0,266666666666667;0,466666666666667
"12104";25037;59;12104;4;39;55;16;0,666666666666667;0,933333333333333
"12105";25037;59;12105;4;39;59;20;0,666666666666667;1
"12106";25037;59;12106;5;39;45;6;0,666666666666667;0,766666666666667
"12107";25037;59;12107;5;13;19;6;0,233333333333333;0,333333333333333
"12108";25037;59;12108;5;21;27;6;0,366666666666667;0,466666666666667
"12109";25037;59;12109;5;41;47;6;0,7;0,8
"12110";25037;59;12110;5;41;49;8;0,7;0,833333333333333
"12111";25037;59;12111;5;23;29;6;0,4;0,5
"12112";25037;59;12112;5;11;17;6;0,2;0,3
"12113";25037;59;12113;5;25;31;6;0,433333333333333;0,533333333333333
"12114";25037;59;12114;5;27;33;6;0,466666666666667;0,566666666666667
"12115";25037;59;12115;5;25;33;8;0,433333333333333;0,566666666666667
"12116";25037;59;12116;5;27;35;8;0,466666666666667;0,6
"12117";25037;59;12117;5;29;35;6;0,5;0,6
"12118";25037;59;12118;5;41;51;10;0,7;0,866666666666667
"12119";25037;59;12119;5;11;19;8;0,2;0,333333333333333
"12120";25037;59;12120;5;41;53;12;0,7;0,9
"12121";25037;59;12121;5;41;55;14;0,7;0,933333333333333
"12122";25037;59;12122;5;5;11;6;0,1;0,2
"12123";25037;59;12123;5;9;15;6;0,166666666666667;0,266666666666667
"12124";25037;59;12124;5;33;39;6;0,566666666666667;0,666666666666667
"12125";25037;59;12125;5;41;57;16;0,7;0,966666666666667
"12126";25037;59;12126;5;31;37;6;0,533333333333333;0,633333333333333
"12127";25037;59;12127;5;39;47;8;0,666666666666667;0,8
"12128";25037;59;12128;5;39;49;10;0,666666666666667;0,833333333333333
"12129";25037;59;12129;5;41;59;18;0,7;1
"12130";25037;59;12130;5;23;31;8;0,4;0,533333333333333
"12131";25528;130;12131;4;64;114;50;0,5;0,875
"12132";25528;130;12132;4;81;130;49;0,625;1
"12133";25528;130;12133;4;64;130;66;0,5;1
"12134";25528;130;12134;5;56;81;25;0,4375;0,625
"12135";25528;130;12135;5;81;105;24;0,625;0,8125
"12136";25528;130;12136;5;97;122;25;0,75;0,9375
"12137";25528;130;12137;5;97;130;33;0,75;1
"12138";25528;130;12138;5;105;130;25;0,8125;1
"12139";25528;130;12139;5;64;89;25;0,5;0,6875
"12140";25528;130;12140;5;81;114;33;0,625;0,875
"12141";25528;130;12141;5;89;114;25;0,6875;0,875
"12142";25528;130;12142;5;56;89;33;0,4375;0,6875
"12143";25528;130;12143;5;89;122;33;0,6875;0,9375
"12144";25528;130;12144;5;89;130;41;0,6875;1
"12145";25528;130;12145;6;101;114;13;0,78125;0,875
"12146";25528;130;12146;6;101;118;17;0,78125;0,90625
"12147";25528;130;12147;6;105;118;13;0,8125;0,90625
"12148";25528;130;12148;6;105;122;17;0,8125;0,9375
"12149";25528;130;12149;6;110;122;12;0,84375;0,9375
"12150";25528;130;12150;6;114;126;12;0,875;0,96875
"12151";25528;130;12151;6;56;69;13;0,4375;0,53125
"12152";25528;130;12152;6;73;85;12;0,5625;0,65625
"12153";25528;130;12153;6;77;89;12;0,59375;0,6875
"12154";25528;130;12154;6;77;93;16;0,59375;0,71875
"12155";25528;130;12155;6;81;93;12;0,625;0,71875
"12156";25528;130;12156;6;81;97;16;0,625;0,75
"12157";25528;130;12157;6;85;97;12;0,65625;0,75
"12158";25528;130;12158;6;89;101;12;0,6875;0,78125
"12159";25528;130;12159;6;97;110;13;0,75;0,84375
"12160";25528;130;12160;6;101;122;21;0,78125;0,9375
"12161";25528;130;12161;6;101;126;25;0,78125;0,96875
"12162";25528;130;12162;6;105;126;21;0,8125;0,96875
"12163";25528;130;12163;6;110;126;16;0,84375;0,96875
"12164";25528;130;12164;6;118;130;12;0,90625;1
"12165";25528;130;12165;6;69;81;12;0,53125;0,625
"12166";25528;130;12166;6;85;101;16;0,65625;0,78125
"12167";25528;130;12167;6;101;130;29;0,78125;1
"12168";25528;130;12168;6;114;130;16;0,875;1
"12169";25528;130;12169;6;60;73;13;0,46875;0,5625
"12170";25528;130;12170;6;105;130;25;0,8125;1
"12171";25528;130;12171;6;110;130;20;0,84375;1
"12172";25528;130;12172;6;3;15;12;0,03125;0,125
"12173";25528;130;12173;6;77;97;20;0,59375;0,75
"12174";25528;130;12174;6;97;114;17;0,75;0,875
"12175";25528;130;12175;6;7;19;12;0,0625;0,15625
"12176";25528;130;12176;6;73;89;16;0,5625;0,6875
"12177";25528;130;12177;6;89;105;16;0,6875;0,8125
"12178";25528;130;12178;6;93;105;12;0,71875;0,8125
"12179";25528;130;12179;6;93;110;17;0,71875;0,84375
"12180";25528;130;12180;6;97;118;21;0,75;0,90625
"12181";25528;130;12181;6;97;122;25;0,75;0,9375
"12182";25528;130;12182;6;97;126;29;0,75;0,96875
"12183";25528;130;12183;6;97;130;33;0,75;1
"12184";25528;130;12184;6;73;93;20;0,5625;0,71875
"12185";25676;64;12185;4;15;40;25;0,25;0,625
"12186";25676;64;12186;4;23;48;25;0,375;0,75
"12187";25676;64;12187;5;27;40;13;0,4375;0,625
"12188";25676;64;12188;5;27;44;17;0,4375;0,6875
"12189";25676;64;12189;5;32;44;12;0,5;0,6875
"12190";25676;64;12190;5;32;48;16;0,5;0,75
"12191";25676;64;12191;5;32;52;20;0,5;0,8125
"12192";25676;64;12192;5;36;48;12;0,5625;0,75
"12193";25676;64;12193;5;36;52;16;0,5625;0,8125
"12194";25676;64;12194;5;40;52;12;0,625;0,8125
"12195";25676;64;12195;5;52;64;12;0,8125;1
"12196";25676;64;12196;5;3;15;12;0,0625;0,25
"12197";25676;64;12197;5;23;36;13;0,375;0,5625
"12198";25676;64;12198;5;7;19;12;0,125;0,3125
"12199";25676;64;12199;5;3;19;16;0,0625;0,3125
"12200";25676;64;12200;5;27;48;21;0,4375;0,75
"12201";25676;64;12201;5;27;52;25;0,4375;0,8125
"12202";25676;64;12202;6;5;11;6;0,09375;0,1875
"12203";25676;64;12203;6;5;13;8;0,09375;0,21875
"12204";25676;64;12204;6;9;15;6;0,15625;0,25
"12205";25676;64;12205;6;11;17;6;0,1875;0,28125
"12206";25676;64;12206;6;25;32;7;0,40625;0,5
"12207";25676;64;12207;6;25;34;9;0,40625;0,53125
"12208";25676;64;12208;6;32;38;6;0,5;0,59375
"12209";25676;64;12209;6;34;40;6;0,53125;0,625
"12210";25676;64;12210;6;34;42;8;0,53125;0,65625
"12211";25676;64;12211;6;34;44;10;0,53125;0,6875
"12212";25676;64;12212;6;36;42;6;0,5625;0,65625
"12213";25676;64;12213;6;36;44;8;0,5625;0,6875
"12214";25676;64;12214;6;40;46;6;0,625;0,71875
"12215";25676;64;12215;6;42;48;6;0,65625;0,75
"12216";25676;64;12216;6;42;50;8;0,65625;0,78125
"12217";25676;64;12217;6;5;15;10;0,09375;0,25
"12218";25676;64;12218;6;5;17;12;0,09375;0,28125
"12219";25676;64;12219;6;25;36;11;0,40625;0,5625
"12220";25676;64;12220;6;27;34;7;0,4375;0,53125
"12221";25676;64;12221;6;27;36;9;0,4375;0,5625
"12222";25676;64;12222;6;29;36;7;0,46875;0,5625
"12223";25676;64;12223;6;29;38;9;0,46875;0,59375
"12224";25676;64;12224;6;29;40;11;0,46875;0,625
"12225";25676;64;12225;6;32;40;8;0,5;0,625
"12226";25676;64;12226;6;40;48;8;0,625;0,75
"12227";25676;64;12227;6;40;50;10;0,625;0,78125
"12228";25676;64;12228;6;44;50;6;0,6875;0,78125
"12229";25676;64;12229;6;9;17;8;0,15625;0,28125
"12230";25676;64;12230;6;21;27;6;0,34375;0,4375
"12231";25676;64;12231;6;21;29;8;0,34375;0,46875
"12232";25676;64;12232;6;36;46;10;0,5625;0,71875
"12233";25676;64;12233;6;36;48;12;0,5625;0,75
"12234";25676;64;12234;6;42;52;10;0,65625;0,8125
"12235";25676;64;12235;6;44;52;8;0,6875;0,8125
"12236";25676;64;12236;6;46;52;6;0,71875;0,8125
"12237";25676;64;12237;6;54;60;6;0,84375;0,9375
"12238";25676;64;12238;6;54;62;8;0,84375;0,96875
"12239";25676;64;12239;6;54;64;10;0,84375;1
"12240";25676;64;12240;6;3;9;6;0,0625;0,15625
"12241";25676;64;12241;6;3;11;8;0,0625;0,1875
"12242";25676;64;12242;6;36;50;14;0,5625;0,78125
"12243";25676;64;12243;6;36;52;16;0,5625;0,8125
"12244";25676;64;12244;6;7;13;6;0,125;0,21875
"12245";25676;64;12245;6;7;15;8;0,125;0,25
"12246";25676;64;12246;6;23;29;6;0,375;0,46875
"12247";25676;64;12247;6;23;32;9;0,375;0,5
"12248";25676;64;12248;6;23;34;11;0,375;0,53125
"12249";25676;64;12249;6;40;52;12;0,625;0,8125
"12250";25676;64;12250;6;23;36;13;0,375;0,5625
"12251";25676;64;12251;6;3;13;10;0,0625;0,21875
"12252";25676;64;12252;6;3;15;12;0,0625;0,25
"12253";25676;64;12253;6;21;32;11;0,34375;0,5
"12254";25676;64;12254;6;3;17;14;0,0625;0,28125
"12255";25676;64;12255;6;34;46;12;0,53125;0,71875
"12256";25676;64;12256;6;52;58;6;0,8125;0,90625
"12257";25676;64;12257;6;32;42;10;0,5;0,65625
"12258";25676;64;12258;6;32;44;12;0,5;0,6875
"12259";25676;64;12259;6;21;34;13;0,34375;0,53125
"12260";25676;64;12260;6;21;36;15;0,34375;0,5625
"12261";25676;64;12261;6;27;38;11;0,4375;0,59375
"12262";25676;64;12262;6;27;40;13;0,4375;0,625
"12263";25676;64;12263;6;27;42;15;0,4375;0,65625
"12264";25676;64;12264;6;27;44;17;0,4375;0,6875
"12265";25676;64;12265;6;27;46;19;0,4375;0,71875
"12266";25676;64;12266;6;34;48;14;0,53125;0,75
"12267";25676;64;12267;6;52;60;8;0,8125;0,9375
"12268";25972;157;12268;4;52;104;52;0,333333333333333;0,666666666666667
"12269";25972;157;12269;5;66;90;24;0,421052631578947;0,578947368421053
"12270";25972;157;12270;5;66;99;33;0,421052631578947;0,631578947368421
"12271";25972;157;12271;5;90;115;25;0,578947368421053;0,736842105263158
"12272";25972;157;12272;5;74;99;25;0,473684210526316;0,631578947368421
"12273";25972;157;12273;5;57;82;25;0,368421052631579;0,526315789473684
"12274";25972;157;12274;5;99;124;25;0,631578947368421;0,789473684210526
"12275";25972;157;12275;6;44;56;12;0,282051282051282;0,358974358974359
"12276";25972;157;12276;6;64;76;12;0,41025641025641;0,487179487179487
"12277";25972;157;12277;6;72;84;12;0,461538461538462;0,538461538461538
"12278";25972;157;12278;6;76;88;12;0,487179487179487;0,564102564102564
"12279";25972;157;12279;6;64;80;16;0,41025641025641;0,512820512820513
"12280";25972;157;12280;6;72;88;16;0,461538461538462;0,564102564102564
"12281";25972;157;12281;6;76;92;16;0,487179487179487;0,58974358974359
"12282";25972;157;12282;6;80;92;12;0,512820512820513;0,58974358974359
"12283";25972;157;12283;6;80;96;16;0,512820512820513;0,615384615384615
"12284";25972;157;12284;6;133;145;12;0,846153846153846;0,923076923076923
"12285";25972;157;12285;6;100;112;12;0,641025641025641;0,717948717948718
"12286";25972;157;12286;6;64;84;20;0,41025641025641;0,538461538461538
"12287";25972;157;12287;6;64;88;24;0,41025641025641;0,564102564102564
"12288";25972;157;12288;6;64;92;28;0,41025641025641;0,58974358974359
"12289";25972;157;12289;6;64;96;32;0,41025641025641;0,615384615384615
"12290";25972;157;12290;6;72;92;20;0,461538461538462;0,58974358974359
"12291";25972;157;12291;6;72;96;24;0,461538461538462;0,615384615384615
"12292";25972;157;12292;6;68;80;12;0,435897435897436;0,512820512820513
"12293";25972;157;12293;6;68;84;16;0,435897435897436;0,538461538461538
"12294";25972;157;12294;6;68;88;20;0,435897435897436;0,564102564102564
"12295";25972;157;12295;6;68;92;24;0,435897435897436;0,58974358974359
"12296";25972;157;12296;6;68;96;28;0,435897435897436;0,615384615384615
"12297";25972;157;12297;6;76;96;20;0,487179487179487;0,615384615384615
"12298";25972;157;12298;6;129;141;12;0,82051282051282;0,897435897435897
"12299";25972;157;12299;6;129;145;16;0,82051282051282;0,923076923076923
"12300";25972;157;12300;6;133;149;16;0,846153846153846;0,948717948717949
"12301";25972;157;12301;6;137;149;12;0,871794871794872;0,948717948717949
"12302";25972;157;12302;6;48;60;12;0,307692307692308;0,384615384615385
"12303";25972;157;12303;6;96;108;12;0,615384615384615;0,692307692307692
"12304";25972;157;12304;6;60;72;12;0,384615384615385;0,461538461538462
"12305";25972;157;12305;6;129;149;20;0,82051282051282;0,948717948717949
"12306";25972;157;12306;6;112;125;13;0,717948717948718;0,794871794871795
"12307";25972;157;12307;6;125;137;12;0,794871794871795;0,871794871794872
"12308";25972;157;12308;6;125;141;16;0,794871794871795;0,897435897435897
"12309";25972;157;12309;6;125;145;20;0,794871794871795;0,923076923076923
"12310";584;79;12310;4;31;55;24;0,4;0,7
"12311";584;79;12311;5;39;51;12;0,5;0,65
"12312";584;79;12312;5;19;31;12;0,25;0,4
"12313";584;79;12313;5;43;55;12;0,55;0,7
"12314";584;79;12314;5;35;47;12;0,45;0,6
"12315";584;79;12315;5;27;39;12;0,35;0,5
"12316";584;79;12316;5;31;43;12;0,4;0,55
"12317";584;79;12317;5;31;47;16;0,4;0,6
"12318";584;79;12318;5;23;35;12;0,3;0,45
"12319";584;79;12319;6;5;11;6;0,075;0,15
"12320";584;79;12320;6;69;75;6;0,875;0,95
"12321";584;79;12321;6;13;19;6;0,175;0,25
"12322";584;79;12322;6;21;27;6;0,275;0,35
"12323";584;79;12323;6;31;37;6;0,4;0,475
"12324";584;79;12324;6;45;51;6;0,575;0,65
"12325";584;79;12325;6;73;79;6;0,925;1
"12326";584;79;12326;6;39;45;6;0,5;0,575
"12327";584;79;12327;6;71;77;6;0,9;0,975
"12328";584;79;12328;6;71;79;8;0,9;1
"12329";584;79;12329;6;43;49;6;0,55;0,625
"12330";584;79;12330;6;43;51;8;0,55;0,65
"12331";584;79;12331;6;67;73;6;0,85;0,925
"12332";584;79;12332;6;27;33;6;0,35;0,425
"12333";584;79;12333;6;69;77;8;0,875;0,975
"12334";584;79;12334;6;15;21;6;0,2;0,275
"12335";584;79;12335;6;11;17;6;0,15;0,225
"12336";584;79;12336;6;29;35;6;0,375;0,45
"12337";584;79;12337;6;69;79;10;0,875;1
"12338";584;79;12338;6;23;29;6;0,3;0,375
"12339";584;79;12339;6;47;53;6;0,6;0,675
"12340";584;79;12340;6;25;31;6;0,325;0,4
"12341";584;79;12341;6;17;23;6;0,225;0,3
"12342";584;79;12342;6;19;25;6;0,25;0,325
"12343";584;79;12343;6;53;59;6;0,675;0,75
"12344";584;79;12344;6;3;9;6;0,05;0,125
"12345";584;79;12345;6;51;57;6;0,65;0,725
"12346";584;79;12346;6;45;53;8;0,575;0,675
"12347";26779;58;12347;3;24;50;26;0,428571428571429;0,857142857142857
"12348";26779;58;12348;3;24;58;34;0,428571428571429;1
"12349";26779;58;12349;3;33;58;25;0,571428571428571;1
"12350";26779;58;12350;3;16;41;25;0,285714285714286;0,714285714285714
"12351";26779;58;12351;3;16;50;34;0,285714285714286;0,857142857142857
"12352";26779;58;12352;4;24;37;13;0,428571428571429;0,642857142857143
"12353";26779;58;12353;4;24;41;17;0,428571428571429;0,714285714285714
"12354";26779;58;12354;4;33;45;12;0,571428571428571;0,785714285714286
"12355";26779;58;12355;4;37;50;13;0,642857142857143;0,857142857142857
"12356";26779;58;12356;4;20;33;13;0,357142857142857;0,571428571428571
"12357";26779;58;12357;4;20;37;17;0,357142857142857;0,642857142857143
"12358";26779;58;12358;4;24;45;21;0,428571428571429;0,785714285714286
"12359";26779;58;12359;4;24;50;26;0,428571428571429;0,857142857142857
"12360";26779;58;12360;4;33;50;17;0,571428571428571;0,857142857142857
"12361";26779;58;12361;4;33;54;21;0,571428571428571;0,928571428571429
"12362";26779;58;12362;4;24;54;30;0,428571428571429;0,928571428571429
"12363";26779;58;12363;4;24;58;34;0,428571428571429;1
"12364";26779;58;12364;4;28;41;13;0,5;0,714285714285714
"12365";26779;58;12365;4;28;45;17;0,5;0,785714285714286
"12366";26779;58;12366;4;28;50;22;0,5;0,857142857142857
"12367";26779;58;12367;4;28;54;26;0,5;0,928571428571429
"12368";26779;58;12368;4;28;58;30;0,5;1
"12369";26779;58;12369;4;33;58;25;0,571428571428571;1
"12370";26779;58;12370;4;37;54;17;0,642857142857143;0,928571428571429
"12371";26779;58;12371;4;37;58;21;0,642857142857143;1
"12372";26779;58;12372;4;41;54;13;0,714285714285714;0,928571428571429
"12373";26779;58;12373;4;41;58;17;0,714285714285714;1
"12374";26779;58;12374;4;16;28;12;0,285714285714286;0,5
"12375";26779;58;12375;4;20;41;21;0,357142857142857;0,714285714285714
"12376";26779;58;12376;4;20;45;25;0,357142857142857;0,785714285714286
"12377";26779;58;12377;5;23;30;7;0,413793103448276;0,517241379310345
"12378";26779;58;12378;5;23;32;9;0,413793103448276;0,551724137931034
"12379";26779;58;12379;5;25;32;7;0,448275862068966;0,551724137931034
"12380";26779;58;12380;5;36;42;6;0,620689655172414;0,724137931034483
"12381";26779;58;12381;5;36;44;8;0,620689655172414;0,758620689655172
"12382";26779;58;12382;5;23;34;11;0,413793103448276;0,586206896551724
"12383";26779;58;12383;5;23;36;13;0,413793103448276;0,620689655172414
"12384";26779;58;12384;5;23;38;15;0,413793103448276;0,655172413793103
"12385";26779;58;12385;5;23;40;17;0,413793103448276;0,689655172413793
"12386";26779;58;12386;5;25;34;9;0,448275862068966;0,586206896551724
"12387";26779;58;12387;5;25;36;11;0,448275862068966;0,620689655172414
"12388";26779;58;12388;5;25;38;13;0,448275862068966;0,655172413793103
"12389";26779;58;12389;5;27;34;7;0,482758620689655;0,586206896551724
"12390";26779;58;12390;5;27;36;9;0,482758620689655;0,620689655172414
"12391";26779;58;12391;5;27;38;11;0,482758620689655;0,655172413793103
"12392";26779;58;12392;5;27;40;13;0,482758620689655;0,689655172413793
"12393";26779;58;12393;5;27;42;15;0,482758620689655;0,724137931034483
"12394";26779;58;12394;5;32;38;6;0,551724137931034;0,655172413793103
"12395";26779;58;12395;5;32;40;8;0,551724137931034;0,689655172413793
"12396";26779;58;12396;5;32;42;10;0,551724137931034;0,724137931034483
"12397";26779;58;12397;5;34;40;6;0,586206896551724;0,689655172413793
"12398";26779;58;12398;5;34;42;8;0,586206896551724;0,724137931034483
"12399";26779;58;12399;5;34;44;10;0,586206896551724;0,758620689655172
"12400";26779;58;12400;5;34;46;12;0,586206896551724;0,793103448275862
"12401";26779;58;12401;5;36;46;10;0,620689655172414;0,793103448275862
"12402";26779;58;12402;5;36;48;12;0,620689655172414;0,827586206896552
"12403";26779;58;12403;5;36;50;14;0,620689655172414;0,862068965517241
"12404";26779;58;12404;5;38;44;6;0,655172413793103;0,758620689655172
"12405";26779;58;12405;5;38;46;8;0,655172413793103;0,793103448275862
"12406";26779;58;12406;5;38;48;10;0,655172413793103;0,827586206896552
"12407";26779;58;12407;5;40;46;6;0,689655172413793;0,793103448275862
"12408";26779;58;12408;5;40;48;8;0,689655172413793;0,827586206896552
"12409";26779;58;12409;5;40;50;10;0,689655172413793;0,862068965517241
"12410";26779;58;12410;5;42;48;6;0,724137931034483;0,827586206896552
"12411";26779;58;12411;5;42;50;8;0,724137931034483;0,862068965517241
"12412";26779;58;12412;5;50;56;6;0,862068965517241;0,96551724137931
"12413";26779;58;12413;5;50;58;8;0,862068965517241;1
"12414";26779;58;12414;5;25;40;15;0,448275862068966;0,689655172413793
"12415";26779;58;12415;5;25;42;17;0,448275862068966;0,724137931034483
"12416";26779;58;12416;5;25;44;19;0,448275862068966;0,758620689655172
"12417";26779;58;12417;5;25;46;21;0,448275862068966;0,793103448275862
"12418";26779;58;12418;5;25;48;23;0,448275862068966;0,827586206896552
"12419";26779;58;12419;5;30;36;6;0,517241379310345;0,620689655172414
"12420";26779;58;12420;5;30;38;8;0,517241379310345;0,655172413793103
"12421";26779;58;12421;5;32;44;12;0,551724137931034;0,758620689655172
"12422";26779;58;12422;5;32;46;14;0,551724137931034;0,793103448275862
"12423";26779;58;12423;5;32;48;16;0,551724137931034;0,827586206896552
"12424";26779;58;12424;5;32;50;18;0,551724137931034;0,862068965517241
"12425";26779;58;12425;5;32;52;20;0,551724137931034;0,896551724137931
"12426";26779;58;12426;5;32;54;22;0,551724137931034;0,931034482758621
"12427";26779;58;12427;5;32;56;24;0,551724137931034;0,96551724137931
"12428";26779;58;12428;5;34;48;14;0,586206896551724;0,827586206896552
"12429";26779;58;12429;5;34;50;16;0,586206896551724;0,862068965517241
"12430";26779;58;12430;5;34;52;18;0,586206896551724;0,896551724137931
"12431";26779;58;12431;5;34;54;20;0,586206896551724;0,931034482758621
"12432";26779;58;12432;5;34;56;22;0,586206896551724;0,96551724137931
"12433";26779;58;12433;5;40;52;12;0,689655172413793;0,896551724137931
"12434";26779;58;12434;5;40;54;14;0,689655172413793;0,931034482758621
"12435";26779;58;12435;5;40;56;16;0,689655172413793;0,96551724137931
"12436";26779;58;12436;5;19;25;6;0,344827586206897;0,448275862068966
"12437";26779;58;12437;5;21;27;6;0,379310344827586;0,482758620689655
"12438";26779;58;12438;5;21;30;9;0,379310344827586;0,517241379310345
"12439";26779;58;12439;5;21;32;11;0,379310344827586;0,551724137931034
"12440";26779;58;12440;5;38;50;12;0,655172413793103;0,862068965517241
"12441";26779;58;12441;5;25;50;25;0,448275862068966;0,862068965517241
"12442";26779;58;12442;5;34;58;24;0,586206896551724;1
"12443";26779;58;12443;5;36;52;16;0,620689655172414;0,896551724137931
"12444";26779;58;12444;5;36;54;18;0,620689655172414;0,931034482758621
"12445";26779;58;12445;5;36;56;20;0,620689655172414;0,96551724137931
"12446";26779;58;12446;5;36;58;22;0,620689655172414;1
"12447";26779;58;12447;5;38;52;14;0,655172413793103;0,896551724137931
"12448";26779;58;12448;5;38;54;16;0,655172413793103;0,931034482758621
"12449";26779;58;12449;5;38;56;18;0,655172413793103;0,96551724137931
"12450";26779;58;12450;5;38;58;20;0,655172413793103;1
"12451";26779;58;12451;5;30;40;10;0,517241379310345;0,689655172413793
"12452";26779;58;12452;5;23;42;19;0,413793103448276;0,724137931034483
"12453";26779;58;12453;5;23;44;21;0,413793103448276;0,758620689655172
"12454";26779;58;12454;5;30;42;12;0,517241379310345;0,724137931034483
"12455";26779;58;12455;5;30;44;14;0,517241379310345;0,758620689655172
"12456";26779;58;12456;5;21;34;13;0,379310344827586;0,586206896551724
"12457";26779;58;12457;5;23;46;23;0,413793103448276;0,793103448275862
"12458";26779;58;12458;5;23;48;25;0,413793103448276;0,827586206896552
"12459";26779;58;12459;5;23;50;27;0,413793103448276;0,862068965517241
"12460";26779;58;12460;5;23;52;29;0,413793103448276;0,896551724137931
"12461";26779;58;12461;5;25;52;27;0,448275862068966;0,896551724137931
"12462";26779;58;12462;5;25;54;29;0,448275862068966;0,931034482758621
"12463";26779;58;12463;5;25;56;31;0,448275862068966;0,96551724137931
"12464";26779;58;12464;5;25;58;33;0,448275862068966;1
"12465";26779;58;12465;5;30;46;16;0,517241379310345;0,793103448275862
"12466";26779;58;12466;5;30;48;18;0,517241379310345;0,827586206896552
"12467";26779;58;12467;5;30;50;20;0,517241379310345;0,862068965517241
"12468";26779;58;12468;5;32;58;26;0,551724137931034;1
"12469";26779;58;12469;5;19;27;8;0,344827586206897;0,482758620689655
"12470";26779;58;12470;5;9;15;6;0,172413793103448;0,275862068965517
"12471";26779;58;12471;5;42;52;10;0,724137931034483;0,896551724137931
"12472";26779;58;12472;5;42;54;12;0,724137931034483;0,931034482758621
"12473";26779;58;12473;5;42;56;14;0,724137931034483;0,96551724137931
"12474";26779;58;12474;5;42;58;16;0,724137931034483;1
"12475";27049;145;12475;5;113;137;24;0,777777777777778;0,944444444444444
"12476";27049;145;12476;5;48;72;24;0,333333333333333;0,5
"12477";27049;145;12477;5;104;129;25;0,722222222222222;0,888888888888889
"12478";27049;145;12478;5;96;121;25;0,666666666666667;0,833333333333333
"12479";27049;145;12479;5;40;64;24;0,277777777777778;0,444444444444444
"12480";27049;145;12480;5;64;88;24;0,444444444444444;0,611111111111111
"12481";27049;145;12481;5;96;129;33;0,666666666666667;0,888888888888889
"12482";27049;145;12482;6;15;27;12;0,111111111111111;0,194444444444444
"12483";27049;145;12483;6;36;48;12;0,25;0,333333333333333
"12484";27049;145;12484;6;68;80;12;0,472222222222222;0,555555555555556
"12485";27049;145;12485;6;113;125;12;0,777777777777778;0,861111111111111
"12486";27049;145;12486;6;117;129;12;0,805555555555556;0,888888888888889
"12487";27049;145;12487;6;52;64;12;0,361111111111111;0,444444444444444
"12488";27049;145;12488;6;88;100;12;0,611111111111111;0,694444444444444
"12489";27049;145;12489;6;64;76;12;0,444444444444444;0,527777777777778
"12490";27049;145;12490;6;64;80;16;0,444444444444444;0,555555555555556
"12491";27049;145;12491;6;121;133;12;0,833333333333333;0,916666666666667
"12492";27049;145;12492;6;15;31;16;0,111111111111111;0,222222222222222
"12493";27049;145;12493;6;48;60;12;0,333333333333333;0,416666666666667
"12494";27049;145;12494;6;48;64;16;0,333333333333333;0,444444444444444
"12495";27049;145;12495;6;92;104;12;0,638888888888889;0,722222222222222
"12496";27049;145;12496;6;96;108;12;0,666666666666667;0,75
"12497";27049;145;12497;6;100;113;13;0,694444444444444;0,777777777777778
"12498";27049;145;12498;6;104;117;13;0,722222222222222;0,805555555555556
"12499";27049;145;12499;6;117;133;16;0,805555555555556;0,916666666666667
"12500";27049;145;12500;6;44;56;12;0,305555555555556;0,388888888888889
"12501";27049;145;12501;6;108;121;13;0,75;0,833333333333333
"12502";27049;145;12502;6;113;129;16;0,777777777777778;0,888888888888889
"12503";27049;145;12503;6;125;137;12;0,861111111111111;0,944444444444444
"12504";27049;145;12504;6;11;23;12;0,0833333333333333;0,166666666666667
"12505";27049;145;12505;6;11;27;16;0,0833333333333333;0,194444444444444
"12506";27049;145;12506;6;11;31;20;0,0833333333333333;0,222222222222222
"12507";27049;145;12507;6;68;84;16;0,472222222222222;0,583333333333333
"12508";27049;145;12508;6;108;125;17;0,75;0,861111111111111
"12509";27049;145;12509;6;113;133;20;0,777777777777778;0,916666666666667
"12510";27049;145;12510;6;40;52;12;0,277777777777778;0,361111111111111
"12511";27049;145;12511;6;72;84;12;0,5;0,583333333333333
"12512";27049;145;12512;6;104;121;17;0,722222222222222;0,833333333333333
"12513";27332;79;12513;5;51;63;12;0,65;0,8
"12514";27332;79;12514;5;55;67;12;0,7;0,85
"12515";27332;79;12515;5;63;75;12;0,8;0,95
"12516";27332;79;12516;5;59;71;12;0,75;0,9
"12517";27332;79;12517;5;47;59;12;0,6;0,75
"12518";27332;79;12518;5;67;79;12;0,85;1
"12519";27332;79;12519;6;15;21;6;0,2;0,275
"12520";27332;79;12520;6;61;67;6;0,775;0,85
"12521";27332;79;12521;6;17;23;6;0,225;0,3
"12522";27332;79;12522;6;39;45;6;0,5;0,575
"12523";27332;79;12523;6;59;65;6;0,75;0,825
"12524";27332;79;12524;6;63;69;6;0,8;0,875
"12525";27332;79;12525;6;3;9;6;0,05;0,125
"12526";27332;79;12526;6;13;19;6;0,175;0,25
"12527";27332;79;12527;6;55;61;6;0,7;0,775
"12528";27332;79;12528;6;45;51;6;0,575;0,65
"12529";27332;79;12529;6;49;55;6;0,625;0,7
"12530";27332;79;12530;6;63;71;8;0,8;0,9
"12531";27332;79;12531;6;73;79;6;0,925;1
"12532";27332;79;12532;6;39;47;8;0,5;0,6
"12533";27332;79;12533;6;65;71;6;0,825;0,9
"12534";27332;79;12534;6;71;77;6;0,9;0,975
"12535";27332;79;12535;6;11;17;6;0,15;0,225
"12536";27332;79;12536;6;47;53;6;0,6;0,675
"12537";27332;79;12537;6;67;73;6;0,85;0,925
"12538";27332;79;12538;6;65;73;8;0,825;0,925
"12539";27332;79;12539;6;37;43;6;0,475;0,55
"12540";27332;79;12540;6;37;45;8;0,475;0,575
"12541";27332;79;12541;6;51;57;6;0,65;0,725
"12542";27332;79;12542;6;53;59;6;0,675;0,75
"12543";27332;79;12543;6;35;41;6;0,45;0,525
"12544";27332;79;12544;6;57;63;6;0,725;0,8
"12545";27332;79;12545;6;41;47;6;0,525;0,6
"12546";27332;79;12546;6;31;37;6;0,4;0,475
"12547";27332;79;12547;6;61;69;8;0,775;0,875
"12548";27656;186;12548;4;67;118;51;0,363636363636364;0,636363636363636
"12549";27656;186;12549;4;50;101;51;0,272727272727273;0,545454545454545
"12550";27656;186;12550;5;72;97;25;0,391304347826087;0,521739130434783
"12551";27656;186;12551;5;80;105;25;0,434782608695652;0,565217391304348
"12552";27656;186;12552;5;153;178;25;0,826086956521739;0,956521739130435
"12553";27656;186;12553;5;162;186;24;0,869565217391304;1
"12554";27656;186;12554;5;72;105;33;0,391304347826087;0,565217391304348
"12555";27656;186;12555;5;80;113;33;0,434782608695652;0,608695652173913
"12556";27656;186;12556;5;145;170;25;0,782608695652174;0,91304347826087
"12557";27656;186;12557;5;88;113;25;0,478260869565217;0,608695652173913
"12558";27656;186;12558;5;129;153;24;0,695652173913043;0,826086956521739
"12559";27656;186;12559;5;137;162;25;0,739130434782609;0,869565217391304
"12560";27656;186;12560;6;80;92;12;0,434782608695652;0,5
"12561";27656;186;12561;6;84;97;13;0,456521739130435;0,521739130434783
"12562";27656;186;12562;6;92;105;13;0,5;0,565217391304348
"12563";27656;186;12563;6;137;149;12;0,739130434782609;0,804347826086957
"12564";27656;186;12564;6;149;162;13;0,804347826086957;0,869565217391304
"12565";27656;186;12565;6;153;166;13;0,826086956521739;0,891304347826087
"12566";27656;186;12566;6;158;170;12;0,847826086956522;0,91304347826087
"12567";27656;186;12567;6;174;186;12;0,934782608695652;1
"12568";27656;186;12568;6;80;97;17;0,434782608695652;0,521739130434783
"12569";27656;186;12569;6;80;101;21;0,434782608695652;0,543478260869565
"12570";27656;186;12570;6;80;105;25;0,434782608695652;0,565217391304348
"12571";27656;186;12571;6;84;101;17;0,456521739130435;0,543478260869565
"12572";27656;186;12572;6;121;133;12;0,652173913043478;0,717391304347826
"12573";27656;186;12573;6;170;182;12;0,91304347826087;0,978260869565217
"12574";27656;186;12574;6;11;23;12;0,0652173913043478;0,130434782608696
"12575";27656;186;12575;6;72;84;12;0,391304347826087;0,456521739130435
"12576";27656;186;12576;6;76;88;12;0,41304347826087;0,478260869565217
"12577";27656;186;12577;6;84;105;21;0,456521739130435;0,565217391304348
"12578";27656;186;12578;6;141;153;12;0,760869565217391;0,826086956521739
"12579";27656;186;12579;6;166;178;12;0,891304347826087;0,956521739130435
"12580";27656;186;12580;6;72;88;16;0,391304347826087;0,478260869565217
"12581";27656;186;12581;6;72;92;20;0,391304347826087;0,5
"12582";27656;186;12582;6;72;97;25;0,391304347826087;0,521739130434783
"12583";27656;186;12583;6;72;101;29;0,391304347826087;0,543478260869565
"12584";27656;186;12584;6;76;92;16;0,41304347826087;0,5
"12585";27656;186;12585;6;84;109;25;0,456521739130435;0,58695652173913
"12586";27656;186;12586;6;92;109;17;0,5;0,58695652173913
"12587";27656;186;12587;6;97;109;12;0,521739130434783;0,58695652173913
"12588";27656;186;12588;6;149;166;17;0,804347826086957;0,891304347826087
"12589";27656;186;12589;6;158;174;16;0,847826086956522;0,934782608695652
"12590";27656;186;12590;6;162;174;12;0,869565217391304;0,934782608695652
"12591";27656;186;12591;6;162;178;16;0,869565217391304;0,956521739130435
"12592";27656;186;12592;6;170;186;16;0,91304347826087;1
"12593";27656;186;12593;6;72;105;33;0,391304347826087;0,565217391304348
"12594";27656;186;12594;6;80;109;29;0,434782608695652;0,58695652173913
"12595";27656;186;12595;6;88;101;13;0,478260869565217;0,543478260869565
"12596";27656;186;12596;6;19;32;13;0,108695652173913;0,173913043478261
"12597";27656;186;12597;6;76;97;21;0,41304347826087;0,521739130434783
"12598";27656;186;12598;6;88;105;17;0,478260869565217;0,565217391304348
"12599";27656;186;12599;6;153;170;17;0,826086956521739;0,91304347826087
"12600";27656;186;12600;6;145;158;13;0,782608695652174;0,847826086956522
"12601";27656;186;12601;6;23;36;13;0,130434782608696;0,195652173913043
"12602";27656;186;12602;6;15;27;12;0,0869565217391304;0,152173913043478
"12603";27656;186;12603;6;137;153;16;0,739130434782609;0,826086956521739
"12604";27656;186;12604;6;117;129;12;0,630434782608696;0,695652173913043
"12605";27656;186;12605;6;133;145;12;0,717391304347826;0,782608695652174
"12606";27656;186;12606;6;166;182;16;0,891304347826087;0,978260869565217
"12607";27656;186;12607;6;166;186;20;0,891304347826087;1
"12608";28127;112;12608;3;15;64;49;0,142857142857143;0,571428571428571
"12609";28127;112;12609;3;64;112;48;0,571428571428571;1
"12610";28127;112;12610;4;15;39;24;0,142857142857143;0,357142857142857
"12611";28127;112;12611;4;39;64;25;0,357142857142857;0,571428571428571
"12612";28127;112;12612;4;64;88;24;0,571428571428571;0,785714285714286
"12613";28127;112;12613;4;88;112;24;0,785714285714286;1
"12614";28127;112;12614;4;72;96;24;0,642857142857143;0,857142857142857
"12615";28127;112;12615;4;7;31;24;0,0714285714285714;0,285714285714286
"12616";28127;112;12616;4;31;56;25;0,285714285714286;0,5
"12617";28127;112;12617;4;80;104;24;0,714285714285714;0,928571428571429
"12618";28127;112;12618;5;43;56;13;0,392857142857143;0,5
"12619";28127;112;12619;5;11;23;12;0,107142857142857;0,214285714285714
"12620";28127;112;12620;5;23;35;12;0,214285714285714;0,321428571428571
"12621";28127;112;12621;5;47;60;13;0,428571428571429;0,535714285714286
"12622";28127;112;12622;5;64;76;12;0,571428571428571;0,678571428571429
"12623";28127;112;12623;5;68;80;12;0,607142857142857;0,714285714285714
"12624";28127;112;12624;5;72;84;12;0,642857142857143;0,75
"12625";28127;112;12625;5;80;92;12;0,714285714285714;0,821428571428571
"12626";28127;112;12626;5;88;100;12;0,785714285714286;0,892857142857143
"12627";28127;112;12627;5;96;108;12;0,857142857142857;0,964285714285714
"12628";28127;112;12628;5;43;60;17;0,392857142857143;0,535714285714286
"12629";28127;112;12629;5;47;64;17;0,428571428571429;0,571428571428571
"12630";28127;112;12630;5;84;96;12;0,75;0,857142857142857
"12631";28127;112;12631;5;80;96;16;0,714285714285714;0,857142857142857
"12632";28127;112;12632;5;76;88;12;0,678571428571429;0,785714285714286
"12633";28127;112;12633;5;11;27;16;0,107142857142857;0,25
"12634";28127;112;12634;5;35;47;12;0,321428571428571;0,428571428571429
"12635";28127;112;12635;5;43;64;21;0,392857142857143;0,571428571428571
"12636";28127;112;12636;5;72;88;16;0,642857142857143;0,785714285714286
"12637";28127;112;12637;5;39;51;12;0,357142857142857;0,464285714285714
"12638";28127;112;12638;5;7;19;12;0,0714285714285714;0,178571428571429
"12639";28127;112;12639;5;27;39;12;0,25;0,357142857142857
"12640";28127;112;12640;5;7;23;16;0,0714285714285714;0,214285714285714
"12641";28127;112;12641;5;56;68;12;0,5;0,607142857142857
"12642";28127;112;12642;5;92;104;12;0,821428571428571;0,928571428571429
"12643";28127;112;12643;5;68;84;16;0,607142857142857;0,75
"12644";28127;112;12644;5;51;64;13;0,464285714285714;0,571428571428571
"12645";28127;112;12645;6;23;29;6;0,214285714285714;0,267857142857143
"12646";28127;112;12646;6;53;60;7;0,482142857142857;0,535714285714286
"12647";28127;112;12647;6;90;96;6;0,803571428571429;0,857142857142857
"12648";28127;112;12648;6;9;15;6;0,0892857142857143;0,142857142857143
"12649";28127;112;12649;6;11;17;6;0,107142857142857;0,160714285714286
"12650";28127;112;12650;6;29;35;6;0,267857142857143;0,321428571428571
"12651";28127;112;12651;6;37;43;6;0,339285714285714;0,392857142857143
"12652";28127;112;12652;6;43;49;6;0,392857142857143;0,446428571428571
"12653";28127;112;12653;6;45;51;6;0,410714285714286;0,464285714285714
"12654";28127;112;12654;6;66;72;6;0,589285714285714;0,642857142857143
"12655";28127;112;12655;6;72;78;6;0,642857142857143;0,696428571428571
"12656";28127;112;12656;6;74;80;6;0,660714285714286;0,714285714285714
"12657";28127;112;12657;6;84;90;6;0,75;0,803571428571429
"12658";28127;112;12658;6;88;94;6;0,785714285714286;0,839285714285714
"12659";28127;112;12659;6;88;96;8;0,785714285714286;0,857142857142857
"12660";28127;112;12660;6;96;102;6;0,857142857142857;0,910714285714286
"12661";28127;112;12661;6;98;104;6;0,875;0,928571428571429
"12662";28127;112;12662;6;9;17;8;0,0892857142857143;0,160714285714286
"12663";28127;112;12663;6;9;19;10;0,0892857142857143;0,178571428571429
"12664";28127;112;12664;6;9;21;12;0,0892857142857143;0,196428571428571
"12665";28127;112;12665;6;11;19;8;0,107142857142857;0,178571428571429
"12666";28127;112;12666;6;11;21;10;0,107142857142857;0,196428571428571
"12667";28127;112;12667;6;11;23;12;0,107142857142857;0,214285714285714
"12668";28127;112;12668;6;23;31;8;0,214285714285714;0,285714285714286
"12669";28127;112;12669;6;25;31;6;0,232142857142857;0,285714285714286
"12670";28127;112;12670;6;25;33;8;0,232142857142857;0,303571428571429
"12671";28127;112;12671;6;27;33;6;0,25;0,303571428571429
"12672";28127;112;12672;6;27;35;8;0,25;0,321428571428571
"12673";28127;112;12673;6;35;41;6;0,321428571428571;0,375
"12674";28127;112;12674;6;43;51;8;0,392857142857143;0,464285714285714
"12675";28127;112;12675;6;47;53;6;0,428571428571429;0,482142857142857
"12676";28127;112;12676;6;58;64;6;0,517857142857143;0,571428571428571
"12677";28127;112;12677;6;64;70;6;0,571428571428571;0,625
"12678";28127;112;12678;6;64;72;8;0,571428571428571;0,642857142857143
"12679";28127;112;12679;6;66;74;8;0,589285714285714;0,660714285714286
"12680";28127;112;12680;6;68;74;6;0,607142857142857;0,660714285714286
"12681";28127;112;12681;6;78;84;6;0,696428571428571;0,75
"12682";28127;112;12682;6;80;86;6;0,714285714285714;0,767857142857143
"12683";28127;112;12683;6;80;88;8;0,714285714285714;0,785714285714286
"12684";28127;112;12684;6;82;88;6;0,732142857142857;0,785714285714286
"12685";28127;112;12685;6;35;43;8;0,321428571428571;0,392857142857143
"12686";28127;112;12686;6;45;53;8;0,410714285714286;0,482142857142857
"12687";28127;112;12687;6;45;56;11;0,410714285714286;0,5
"12688";28127;112;12688;6;45;58;13;0,410714285714286;0,517857142857143
"12689";28127;112;12689;6;47;56;9;0,428571428571429;0,5
"12690";28127;112;12690;6;98;106;8;0,875;0,946428571428571
"12691";28127;112;12691;6;100;106;6;0,892857142857143;0,946428571428571
"12692";28127;112;12692;6;9;23;14;0,0892857142857143;0,214285714285714
"12693";28127;112;12693;6;23;33;10;0,214285714285714;0,303571428571429
"12694";28127;112;12694;6;23;35;12;0,214285714285714;0,321428571428571
"12695";28127;112;12695;6;25;35;10;0,232142857142857;0,321428571428571
"12696";28127;112;12696;6;47;58;11;0,428571428571429;0,517857142857143
"12697";28127;112;12697;6;47;60;13;0,428571428571429;0,535714285714286
"12698";28127;112;12698;6;47;62;15;0,428571428571429;0,553571428571429
"12699";28127;112;12699;6;56;62;6;0,5;0,553571428571429
"12700";28127;112;12700;6;78;86;8;0,696428571428571;0,767857142857143
"12701";28127;112;12701;6;96;104;8;0,857142857142857;0,928571428571429
"12702";28127;112;12702;6;96;106;10;0,857142857142857;0,946428571428571
"12703";28127;112;12703;6;86;92;6;0,767857142857143;0,821428571428571
"12704";28127;112;12704;6;51;58;7;0,464285714285714;0,517857142857143
"12705";28127;112;12705;6;45;60;15;0,410714285714286;0,535714285714286
"12706";28127;112;12706;6;51;60;9;0,464285714285714;0,535714285714286
"12707";28127;112;12707;6;51;62;11;0,464285714285714;0,553571428571429
"12708";28127;112;12708;6;53;62;9;0,482142857142857;0,553571428571429
"12709";28127;112;12709;6;56;64;8;0,5;0,571428571428571
"12710";28127;112;12710;6;43;53;10;0,392857142857143;0,482142857142857
"12711";28127;112;12711;6;43;56;13;0,392857142857143;0,5
"12712";28127;112;12712;6;43;58;15;0,392857142857143;0,517857142857143
"12713";28127;112;12713;6;49;56;7;0,446428571428571;0,5
"12714";28127;112;12714;6;49;58;9;0,446428571428571;0,517857142857143
"12715";28127;112;12715;6;78;88;10;0,696428571428571;0,785714285714286
"12716";28127;112;12716;6;72;80;8;0,642857142857143;0,714285714285714
"12717";28127;112;12717;6;7;13;6;0,0714285714285714;0,125
"12718";28127;112;12718;6;70;76;6;0,625;0,678571428571429
"12719";28127;112;12719;6;70;78;8;0,625;0,696428571428571
"12720";28127;112;12720;6;92;98;6;0,821428571428571;0,875
"12721";28127;112;12721;6;62;68;6;0,553571428571429;0,607142857142857
"12722";28127;112;12722;6;68;76;8;0,607142857142857;0,678571428571429
"12723";28127;112;12723;6;49;60;11;0,446428571428571;0,535714285714286
"12724";28127;112;12724;6;7;15;8;0,0714285714285714;0,142857142857143
"12725";28127;112;12725;6;76;82;6;0,678571428571429;0,732142857142857
"12726";28127;112;12726;6;84;92;8;0,75;0,821428571428571
"12727";28127;112;12727;6;86;94;8;0,767857142857143;0,839285714285714
"12728";28127;112;12728;6;39;45;6;0,357142857142857;0,410714285714286
"12729";28127;112;12729;6;53;64;11;0,482142857142857;0,571428571428571
"12730";28127;112;12730;6;84;94;10;0,75;0,839285714285714
"12731";28161;92;12731;4;67;92;25;0,727272727272727;1
"12732";28161;92;12732;4;33;58;25;0,363636363636364;0,636363636363636
"12733";28161;92;12733;4;58;84;26;0,636363636363636;0,909090909090909
"12734";28161;92;12734;5;43;56;13;0,478260869565217;0,608695652173913
"12735";28161;92;12735;5;48;60;12;0,521739130434783;0,652173913043478
"12736";28161;92;12736;5;64;76;12;0,695652173913043;0,826086956521739
"12737";28161;92;12737;5;72;84;12;0,782608695652174;0,91304347826087
"12738";28161;92;12738;5;43;60;17;0,478260869565217;0,652173913043478
"12739";28161;92;12739;5;43;64;21;0,478260869565217;0,695652173913043
"12740";28161;92;12740;5;48;64;16;0,521739130434783;0,695652173913043
"12741";28161;92;12741;5;68;80;12;0,739130434782609;0,869565217391304
"12742";28161;92;12742;5;15;27;12;0,173913043478261;0,304347826086957
"12743";28161;92;12743;5;64;80;16;0,695652173913043;0,869565217391304
"12744";28161;92;12744;5;64;84;20;0,695652173913043;0,91304347826087
"12745";28161;92;12745;5;64;88;24;0,695652173913043;0,956521739130435
"12746";28161;92;12746;5;64;92;28;0,695652173913043;1
"12747";28161;92;12747;5;68;84;16;0,739130434782609;0,91304347826087
"12748";28161;92;12748;5;68;88;20;0,739130434782609;0,956521739130435
"12749";28161;92;12749;5;68;92;24;0,739130434782609;1
"12750";28161;92;12750;5;72;88;16;0,782608695652174;0,956521739130435
"12751";28161;92;12751;5;72;92;20;0,782608695652174;1
"12752";28161;92;12752;5;76;88;12;0,826086956521739;0,956521739130435
"12753";28161;92;12753;5;19;31;12;0,217391304347826;0,347826086956522
"12754";28161;92;12754;5;39;52;13;0,434782608695652;0,565217391304348
"12755";28161;92;12755;5;76;92;16;0,826086956521739;1
"12756";28161;92;12756;6;43;50;7;0,478260869565217;0,543478260869565
"12757";28161;92;12757;6;46;52;6;0,5;0,565217391304348
"12758";28161;92;12758;6;64;70;6;0,695652173913043;0,760869565217391
"12759";28161;92;12759;6;70;76;6;0,760869565217391;0,826086956521739
"12760";28161;92;12760;6;74;80;6;0,804347826086957;0,869565217391304
"12761";28161;92;12761;6;86;92;6;0,934782608695652;1
"12762";28161;92;12762;6;43;52;9;0,478260869565217;0,565217391304348
"12763";28161;92;12763;6;43;54;11;0,478260869565217;0,58695652173913
"12764";28161;92;12764;6;43;56;13;0,478260869565217;0,608695652173913
"12765";28161;92;12765;6;46;54;8;0,5;0,58695652173913
"12766";28161;92;12766;6;46;56;10;0,5;0,608695652173913
"12767";28161;92;12767;6;46;58;12;0,5;0,630434782608696
"12768";28161;92;12768;6;64;72;8;0,695652173913043;0,782608695652174
"12769";28161;92;12769;6;64;74;10;0,695652173913043;0,804347826086957
"12770";28161;92;12770;6;64;76;12;0,695652173913043;0,826086956521739
"12771";28161;92;12771;6;64;78;14;0,695652173913043;0,847826086956522
"12772";28161;92;12772;6;66;72;6;0,717391304347826;0,782608695652174
"12773";28161;92;12773;6;66;74;8;0,717391304347826;0,804347826086957
"12774";28161;92;12774;6;66;76;10;0,717391304347826;0,826086956521739
"12775";28161;92;12775;6;66;78;12;0,717391304347826;0,847826086956522
"12776";28161;92;12776;6;68;74;6;0,739130434782609;0,804347826086957
"12777";28161;92;12777;6;68;76;8;0,739130434782609;0,826086956521739
"12778";28161;92;12778;6;68;78;10;0,739130434782609;0,847826086956522
"12779";28161;92;12779;6;68;80;12;0,739130434782609;0,869565217391304
"12780";28161;92;12780;6;70;78;8;0,760869565217391;0,847826086956522
"12781";28161;92;12781;6;70;80;10;0,760869565217391;0,869565217391304
"12782";28161;92;12782;6;70;82;12;0,760869565217391;0,891304347826087
"12783";28161;92;12783;6;70;84;14;0,760869565217391;0,91304347826087
"12784";28161;92;12784;6;72;78;6;0,782608695652174;0,847826086956522
"12785";28161;92;12785;6;72;80;8;0,782608695652174;0,869565217391304
"12786";28161;92;12786;6;72;82;10;0,782608695652174;0,891304347826087
"12787";28161;92;12787;6;72;84;12;0,782608695652174;0,91304347826087
"12788";28161;92;12788;6;74;82;8;0,804347826086957;0,891304347826087
"12789";28161;92;12789;6;74;84;10;0,804347826086957;0,91304347826087
"12790";28161;92;12790;6;74;86;12;0,804347826086957;0,934782608695652
"12791";28161;92;12791;6;23;29;6;0,260869565217391;0,326086956521739
"12792";28161;92;12792;6;43;58;15;0,478260869565217;0,630434782608696
"12793";28161;92;12793;6;43;60;17;0,478260869565217;0,652173913043478
"12794";28161;92;12794;6;43;62;19;0,478260869565217;0,673913043478261
"12795";28161;92;12795;6;46;60;14;0,5;0,652173913043478
"12796";28161;92;12796;6;46;62;16;0,5;0,673913043478261
"12797";28161;92;12797;6;46;64;18;0,5;0,695652173913043
"12798";28161;92;12798;6;64;80;16;0,695652173913043;0,869565217391304
"12799";28161;92;12799;6;66;80;14;0,717391304347826;0,869565217391304
"12800";28161;92;12800;6;66;82;16;0,717391304347826;0,891304347826087
"12801";28161;92;12801;6;66;84;18;0,717391304347826;0,91304347826087
"12802";28161;92;12802;6;68;82;14;0,739130434782609;0,891304347826087
"12803";28161;92;12803;6;68;84;16;0,739130434782609;0,91304347826087
"12804";28161;92;12804;6;68;86;18;0,739130434782609;0,934782608695652
"12805";28161;92;12805;6;68;88;20;0,739130434782609;0,956521739130435
"12806";28161;92;12806;6;68;90;22;0,739130434782609;0,978260869565217
"12807";28161;92;12807;6;72;86;14;0,782608695652174;0,934782608695652
"12808";28161;92;12808;6;72;88;16;0,782608695652174;0,956521739130435
"12809";28161;92;12809;6;72;90;18;0,782608695652174;0,978260869565217
"12810";28161;92;12810;6;17;23;6;0,195652173913043;0,260869565217391
"12811";28161;92;12811;6;19;25;6;0,217391304347826;0,282608695652174
"12812";28161;92;12812;6;21;27;6;0,239130434782609;0,304347826086957
"12813";28161;92;12813;6;37;43;6;0,41304347826087;0,478260869565217
"12814";28161;92;12814;6;70;86;16;0,760869565217391;0,934782608695652
"12815";28161;92;12815;6;70;88;18;0,760869565217391;0,956521739130435
"12816";28161;92;12816;6;23;31;8;0,260869565217391;0,347826086956522
"12817";28161;92;12817;6;35;41;6;0,391304347826087;0,456521739130435
"12818";28161;92;12818;6;41;48;7;0,456521739130435;0,521739130434783
"12819";28161;92;12819;6;66;86;20;0,717391304347826;0,934782608695652
"12820";28161;92;12820;6;68;92;24;0,739130434782609;1
"12821";28161;92;12821;6;70;90;20;0,760869565217391;0,978260869565217
"12822";28161;92;12822;6;70;92;22;0,760869565217391;1
"12823";28161;92;12823;6;15;21;6;0,173913043478261;0,239130434782609
"12824";28161;92;12824;6;21;29;8;0,239130434782609;0,326086956521739
"12825";28161;92;12825;6;66;88;22;0,717391304347826;0,956521739130435
"12826";28161;92;12826;6;66;90;24;0,717391304347826;0,978260869565217
"12827";28161;92;12827;6;66;92;26;0,717391304347826;1
"12828";28161;92;12828;6;31;37;6;0,347826086956522;0,41304347826087
"12829";28161;92;12829;6;74;88;14;0,804347826086957;0,956521739130435
"12830";28161;92;12830;6;25;31;6;0,282608695652174;0,347826086956522
"12831";28161;92;12831;6;43;64;21;0,478260869565217;0,695652173913043
"12832";28161;92;12832;6;74;90;16;0,804347826086957;0,978260869565217
"12833";28161;92;12833;6;19;27;8;0,217391304347826;0,304347826086957
"12834";28161;92;12834;6;13;19;6;0,152173913043478;0,217391304347826
"12835";28868;67;12835;4;42;67;25;0,625;1
"12836";28868;67;12836;5;11;23;12;0,176470588235294;0,352941176470588
"12837";28868;67;12837;5;55;67;12;0,823529411764706;1
"12838";28868;67;12838;5;51;63;12;0,764705882352941;0,941176470588235
"12839";28868;67;12839;5;7;19;12;0,117647058823529;0,294117647058824
"12840";28868;67;12840;5;7;23;16;0,117647058823529;0,352941176470588
"12841";28868;67;12841;5;47;59;12;0,705882352941177;0,882352941176471
"12842";28868;67;12842;6;11;17;6;0,176470588235294;0,264705882352941
"12843";28868;67;12843;6;45;51;6;0,676470588235294;0,764705882352941
"12844";28868;67;12844;6;13;19;6;0,205882352941176;0,294117647058824
"12845";28868;67;12845;6;13;21;8;0,205882352941176;0,323529411764706
"12846";28868;67;12846;6;13;23;10;0,205882352941176;0,352941176470588
"12847";28868;67;12847;6;37;43;6;0,558823529411765;0,647058823529412
"12848";28868;67;12848;6;49;55;6;0,735294117647059;0,823529411764706
"12849";28868;67;12849;6;53;59;6;0,794117647058823;0,882352941176471
"12850";28868;67;12850;6;11;19;8;0,176470588235294;0,294117647058824
"12851";28868;67;12851;6;11;21;10;0,176470588235294;0,323529411764706
"12852";28868;67;12852;6;11;23;12;0,176470588235294;0,352941176470588
"12853";28868;67;12853;6;59;65;6;0,882352941176471;0,970588235294118
"12854";28868;67;12854;6;9;15;6;0,147058823529412;0,235294117647059
"12855";28868;67;12855;6;45;53;8;0,676470588235294;0,794117647058823
"12856";28868;67;12856;6;47;53;6;0,705882352941177;0,794117647058823
"12857";28868;67;12857;6;39;45;6;0,588235294117647;0,676470588235294
"12858";28868;67;12858;6;31;37;6;0,470588235294118;0,558823529411765
"12859";28868;67;12859;6;51;57;6;0,764705882352941;0,852941176470588
"12860";28868;67;12860;6;9;17;8;0,147058823529412;0,264705882352941
"12861";28868;67;12861;6;35;41;6;0,529411764705882;0,617647058823529
"12862";28868;67;12862;6;33;39;6;0,5;0,588235294117647
"12863";29402;91;12863;3;36;91;55;0,4;1
"12864";29402;91;12864;4;49;74;25;0,545454545454545;0,818181818181818
"12865";29402;91;12865;4;49;83;34;0,545454545454545;0,909090909090909
"12866";29402;91;12866;4;49;91;42;0,545454545454545;1
"12867";29402;91;12867;4;58;83;25;0,636363636363636;0,909090909090909
"12868";29402;91;12868;4;58;91;33;0,636363636363636;1
"12869";29402;91;12869;4;41;66;25;0,454545454545455;0,727272727272727
"12870";29402;91;12870;4;66;91;25;0,727272727272727;1
"12871";29402;91;12871;4;41;74;33;0,454545454545455;0,818181818181818
"12872";29402;91;12872;4;41;83;42;0,454545454545455;0,909090909090909
"12873";29402;91;12873;5;23;35;12;0,260869565217391;0,391304347826087
"12874";29402;91;12874;5;51;63;12;0,565217391304348;0,695652173913043
"12875";29402;91;12875;5;51;67;16;0,565217391304348;0,739130434782609
"12876";29402;91;12876;5;51;71;20;0,565217391304348;0,782608695652174
"12877";29402;91;12877;5;55;67;12;0,608695652173913;0,739130434782609
"12878";29402;91;12878;5;55;71;16;0,608695652173913;0,782608695652174
"12879";29402;91;12879;5;59;71;12;0,652173913043478;0,782608695652174
"12880";29402;91;12880;5;59;75;16;0,652173913043478;0,826086956521739
"12881";29402;91;12881;5;75;87;12;0,826086956521739;0,956521739130435
"12882";29402;91;12882;5;3;15;12;0,0434782608695652;0,173913043478261
"12883";29402;91;12883;5;19;31;12;0,217391304347826;0,347826086956522
"12884";29402;91;12884;5;55;75;20;0,608695652173913;0,826086956521739
"12885";29402;91;12885;5;55;79;24;0,608695652173913;0,869565217391304
"12886";29402;91;12886;5;55;83;28;0,608695652173913;0,91304347826087
"12887";29402;91;12887;5;55;87;32;0,608695652173913;0,956521739130435
"12888";29402;91;12888;5;67;79;12;0,739130434782609;0,869565217391304
"12889";29402;91;12889;5;67;83;16;0,739130434782609;0,91304347826087
"12890";29402;91;12890;5;71;83;12;0,782608695652174;0,91304347826087
"12891";29402;91;12891;5;19;35;16;0,217391304347826;0,391304347826087
"12892";29402;91;12892;5;43;55;12;0,478260869565217;0,608695652173913
"12893";29402;91;12893;5;51;75;24;0,565217391304348;0,826086956521739
"12894";29402;91;12894;5;55;91;36;0,608695652173913;1
"12895";29402;91;12895;5;59;79;20;0,652173913043478;0,869565217391304
"12896";29402;91;12896;5;59;83;24;0,652173913043478;0,91304347826087
"12897";29402;91;12897;5;59;87;28;0,652173913043478;0,956521739130435
"12898";29402;91;12898;5;59;91;32;0,652173913043478;1
"12899";29402;91;12899;5;63;75;12;0,695652173913043;0,826086956521739
"12900";29402;91;12900;5;63;79;16;0,695652173913043;0,869565217391304
"12901";29402;91;12901;5;63;83;20;0,695652173913043;0,91304347826087
"12902";29402;91;12902;5;63;87;24;0,695652173913043;0,956521739130435
"12903";29402;91;12903;5;67;87;20;0,739130434782609;0,956521739130435
"12904";29402;91;12904;5;67;91;24;0,739130434782609;1
"12905";29402;91;12905;5;71;87;16;0,782608695652174;0,956521739130435
"12906";29402;91;12906;5;75;91;16;0,826086956521739;1
"12907";29402;91;12907;5;79;91;12;0,869565217391304;1
"12908";29402;91;12908;5;47;59;12;0,521739130434783;0,652173913043478
"12909";29402;91;12909;5;47;63;16;0,521739130434783;0,695652173913043
"12910";29402;91;12910;5;47;67;20;0,521739130434783;0,739130434782609
"12911";29402;91;12911;5;51;79;28;0,565217391304348;0,869565217391304
"12912";29402;91;12912;5;51;83;32;0,565217391304348;0,91304347826087
"12913";29402;91;12913;5;51;87;36;0,565217391304348;0,956521739130435
"12914";29402;91;12914;5;51;91;40;0,565217391304348;1
"12915";29402;91;12915;5;39;51;12;0,434782608695652;0,565217391304348
"12916";29402;91;12916;5;71;91;20;0,782608695652174;1
"12917";29402;91;12917;6;1;7;6;0,0217391304347826;0,0869565217391304
"12918";29402;91;12918;6;3;9;6;0,0434782608695652;0,108695652173913
"12919";29402;91;12919;6;3;11;8;0,0434782608695652;0,130434782608696
"12920";29402;91;12920;6;3;13;10;0,0434782608695652;0,152173913043478
"12921";29402;91;12921;6;5;11;6;0,0652173913043478;0,130434782608696
"12922";29402;91;12922;6;5;13;8;0,0652173913043478;0,152173913043478
"12923";29402;91;12923;6;21;27;6;0,239130434782609;0,304347826086957
"12924";29402;91;12924;6;21;29;8;0,239130434782609;0,326086956521739
"12925";29402;91;12925;6;43;49;6;0,478260869565217;0,543478260869565
"12926";29402;91;12926;6;51;57;6;0,565217391304348;0,630434782608696
"12927";29402;91;12927;6;51;59;8;0,565217391304348;0,652173913043478
"12928";29402;91;12928;6;51;61;10;0,565217391304348;0,673913043478261
"12929";29402;91;12929;6;53;59;6;0,58695652173913;0,652173913043478
"12930";29402;91;12930;6;53;61;8;0,58695652173913;0,673913043478261
"12931";29402;91;12931;6;55;61;6;0,608695652173913;0,673913043478261
"12932";29402;91;12932;6;55;63;8;0,608695652173913;0,695652173913043
"12933";29402;91;12933;6;59;65;6;0,652173913043478;0,717391304347826
"12934";29402;91;12934;6;67;73;6;0,739130434782609;0,804347826086957
"12935";29402;91;12935;6;67;75;8;0,739130434782609;0,826086956521739
"12936";29402;91;12936;6;77;83;6;0,847826086956522;0,91304347826087
"12937";29402;91;12937;6;77;85;8;0,847826086956522;0,934782608695652
"12938";29402;91;12938;6;77;87;10;0,847826086956522;0,956521739130435
"12939";29402;91;12939;6;79;85;6;0,869565217391304;0,934782608695652
"12940";29402;91;12940;6;3;15;12;0,0434782608695652;0,173913043478261
"12941";29402;91;12941;6;5;15;10;0,0652173913043478;0,173913043478261
"12942";29402;91;12942;6;19;25;6;0,217391304347826;0,282608695652174
"12943";29402;91;12943;6;19;27;8;0,217391304347826;0,304347826086957
"12944";29402;91;12944;6;21;31;10;0,239130434782609;0,347826086956522
"12945";29402;91;12945;6;21;33;12;0,239130434782609;0,369565217391304
"12946";29402;91;12946;6;21;35;14;0,239130434782609;0,391304347826087
"12947";29402;91;12947;6;55;65;10;0,608695652173913;0,717391304347826
"12948";29402;91;12948;6;55;67;12;0,608695652173913;0,739130434782609
"12949";29402;91;12949;6;55;69;14;0,608695652173913;0,760869565217391
"12950";29402;91;12950;6;55;71;16;0,608695652173913;0,782608695652174
"12951";29402;91;12951;6;55;73;18;0,608695652173913;0,804347826086957
"12952";29402;91;12952;6;57;63;6;0,630434782608696;0,695652173913043
"12953";29402;91;12953;6;57;65;8;0,630434782608696;0,717391304347826
"12954";29402;91;12954;6;57;67;10;0,630434782608696;0,739130434782609
"12955";29402;91;12955;6;59;67;8;0,652173913043478;0,739130434782609
"12956";29402;91;12956;6;59;69;10;0,652173913043478;0,760869565217391
"12957";29402;91;12957;6;59;71;12;0,652173913043478;0,782608695652174
"12958";29402;91;12958;6;59;73;14;0,652173913043478;0,804347826086957
"12959";29402;91;12959;6;59;75;16;0,652173913043478;0,826086956521739
"12960";29402;91;12960;6;61;67;6;0,673913043478261;0,739130434782609
"12961";29402;91;12961;6;61;69;8;0,673913043478261;0,760869565217391
"12962";29402;91;12962;6;61;71;10;0,673913043478261;0,782608695652174
"12963";29402;91;12963;6;61;73;12;0,673913043478261;0,804347826086957
"12964";29402;91;12964;6;61;75;14;0,673913043478261;0,826086956521739
"12965";29402;91;12965;6;63;69;6;0,695652173913043;0,760869565217391
"12966";29402;91;12966;6;63;71;8;0,695652173913043;0,782608695652174
"12967";29402;91;12967;6;63;73;10;0,695652173913043;0,804347826086957
"12968";29402;91;12968;6;63;75;12;0,695652173913043;0,826086956521739
"12969";29402;91;12969;6;65;71;6;0,717391304347826;0,782608695652174
"12970";29402;91;12970;6;65;73;8;0,717391304347826;0,804347826086957
"12971";29402;91;12971;6;65;75;10;0,717391304347826;0,826086956521739
"12972";29402;91;12972;6;65;77;12;0,717391304347826;0,847826086956522
"12973";29402;91;12973;6;67;77;10;0,739130434782609;0,847826086956522
"12974";29402;91;12974;6;67;79;12;0,739130434782609;0,869565217391304
"12975";29402;91;12975;6;67;81;14;0,739130434782609;0,891304347826087
"12976";29402;91;12976;6;67;83;16;0,739130434782609;0,91304347826087
"12977";29402;91;12977;6;67;85;18;0,739130434782609;0,934782608695652
"12978";29402;91;12978;6;73;79;6;0,804347826086957;0,869565217391304
"12979";29402;91;12979;6;73;81;8;0,804347826086957;0,891304347826087
"12980";29402;91;12980;6;73;83;10;0,804347826086957;0,91304347826087
"12981";29402;91;12981;6;73;85;12;0,804347826086957;0,934782608695652
"12982";29402;91;12982;6;75;81;6;0,826086956521739;0,891304347826087
"12983";29402;91;12983;6;75;83;8;0,826086956521739;0,91304347826087
"12984";29402;91;12984;6;75;85;10;0,826086956521739;0,934782608695652
"12985";29402;91;12985;6;83;89;6;0,91304347826087;0,978260869565217
"12986";29402;91;12986;6;83;91;8;0,91304347826087;1
"12987";29402;91;12987;6;1;9;8;0,0217391304347826;0,108695652173913
"12988";29402;91;12988;6;19;29;10;0,217391304347826;0,326086956521739
"12989";29402;91;12989;6;19;31;12;0,217391304347826;0,347826086956522
"12990";29402;91;12990;6;19;33;14;0,217391304347826;0,369565217391304
"12991";29402;91;12991;6;49;55;6;0,543478260869565;0,608695652173913
"12992";29402;91;12992;6;53;63;10;0,58695652173913;0,695652173913043
"12993";29402;91;12993;6;53;65;12;0,58695652173913;0,717391304347826
"12994";29402;91;12994;6;53;67;14;0,58695652173913;0,739130434782609
"12995";29402;91;12995;6;53;69;16;0,58695652173913;0,760869565217391
"12996";29402;91;12996;6;53;71;18;0,58695652173913;0,782608695652174
"12997";29402;91;12997;6;53;73;20;0,58695652173913;0,804347826086957
"12998";29402;91;12998;6;53;75;22;0,58695652173913;0,826086956521739
"12999";29402;91;12999;6;53;77;24;0,58695652173913;0,847826086956522
"13000";29402;91;13000;6;53;79;26;0,58695652173913;0,869565217391304
"13001";29402;91;13001;6;53;81;28;0,58695652173913;0,891304347826087
"13002";29402;91;13002;6;53;83;30;0,58695652173913;0,91304347826087
"13003";29402;91;13003;6;53;85;32;0,58695652173913;0,934782608695652
"13004";29402;91;13004;6;53;87;34;0,58695652173913;0,956521739130435
"13005";29402;91;13005;6;55;75;20;0,608695652173913;0,826086956521739
"13006";29402;91;13006;6;55;77;22;0,608695652173913;0,847826086956522
"13007";29402;91;13007;6;55;79;24;0,608695652173913;0,869565217391304
"13008";29402;91;13008;6;55;81;26;0,608695652173913;0,891304347826087
"13009";29402;91;13009;6;55;83;28;0,608695652173913;0,91304347826087
"13010";29402;91;13010;6;55;85;30;0,608695652173913;0,934782608695652
"13011";29402;91;13011;6;57;69;12;0,630434782608696;0,760869565217391
"13012";29402;91;13012;6;57;71;14;0,630434782608696;0,782608695652174
"13013";29402;91;13013;6;57;73;16;0,630434782608696;0,804347826086957
"13014";29402;91;13014;6;57;75;18;0,630434782608696;0,826086956521739
"13015";29402;91;13015;6;57;77;20;0,630434782608696;0,847826086956522
"13016";29402;91;13016;6;57;79;22;0,630434782608696;0,869565217391304
"13017";29402;91;13017;6;57;81;24;0,630434782608696;0,891304347826087
"13018";29402;91;13018;6;57;83;26;0,630434782608696;0,91304347826087
"13019";29402;91;13019;6;57;85;28;0,630434782608696;0,934782608695652
"13020";29402;91;13020;6;57;87;30;0,630434782608696;0,956521739130435
"13021";29402;91;13021;6;59;77;18;0,652173913043478;0,847826086956522
"13022";29402;91;13022;6;59;79;20;0,652173913043478;0,869565217391304
"13023";29402;91;13023;6;59;81;22;0,652173913043478;0,891304347826087
"13024";29402;91;13024;6;59;83;24;0,652173913043478;0,91304347826087
"13025";29402;91;13025;6;59;85;26;0,652173913043478;0,934782608695652
"13026";29402;91;13026;6;59;87;28;0,652173913043478;0,956521739130435
"13027";29402;91;13027;6;61;77;16;0,673913043478261;0,847826086956522
"13028";29402;91;13028;6;61;79;18;0,673913043478261;0,869565217391304
"13029";29402;91;13029;6;61;81;20;0,673913043478261;0,891304347826087
"13030";29402;91;13030;6;63;77;14;0,695652173913043;0,847826086956522
"13031";29402;91;13031;6;63;79;16;0,695652173913043;0,869565217391304
"13032";29402;91;13032;6;63;81;18;0,695652173913043;0,891304347826087
"13033";29402;91;13033;6;63;83;20;0,695652173913043;0,91304347826087
"13034";29402;91;13034;6;73;87;14;0,804347826086957;0,956521739130435
"13035";29402;91;13035;6;73;89;16;0,804347826086957;0,978260869565217
"13036";29402;91;13036;6;75;87;12;0,826086956521739;0,956521739130435
"13037";29402;91;13037;6;51;63;12;0,565217391304348;0,695652173913043
"13038";29402;91;13038;6;51;65;14;0,565217391304348;0,717391304347826
"13039";29402;91;13039;6;51;67;16;0,565217391304348;0,739130434782609
"13040";29402;91;13040;6;51;69;18;0,565217391304348;0,760869565217391
"13041";29402;91;13041;6;75;89;14;0,826086956521739;0,978260869565217
"13042";29402;91;13042;6;77;89;12;0,847826086956522;0,978260869565217
"13043";29402;91;13043;6;77;91;14;0,847826086956522;1
"13044";29402;91;13044;6;17;23;6;0,195652173913043;0,260869565217391
"13045";29402;91;13045;6;17;25;8;0,195652173913043;0,282608695652174
"13046";29402;91;13046;6;17;27;10;0,195652173913043;0,304347826086957
"13047";29402;91;13047;6;17;29;12;0,195652173913043;0,326086956521739
"13048";29402;91;13048;6;45;51;6;0,5;0,565217391304348
"13049";29402;91;13049;6;47;53;6;0,521739130434783;0,58695652173913
"13050";29402;91;13050;6;49;57;8;0,543478260869565;0,630434782608696
"13051";29402;91;13051;6;49;59;10;0,543478260869565;0,652173913043478
"13052";29402;91;13052;6;51;71;20;0,565217391304348;0,782608695652174
"13053";29402;91;13053;6;51;73;22;0,565217391304348;0,804347826086957
"13054";29402;91;13054;6;51;75;24;0,565217391304348;0,826086956521739
"13055";29402;91;13055;6;51;77;26;0,565217391304348;0,847826086956522
"13056";29402;91;13056;6;61;83;22;0,673913043478261;0,91304347826087
"13057";29402;91;13057;6;61;85;24;0,673913043478261;0,934782608695652
"13058";29402;91;13058;6;61;87;26;0,673913043478261;0,956521739130435
"13059";29402;91;13059;6;61;89;28;0,673913043478261;0,978260869565217
"13060";29402;91;13060;6;67;87;20;0,739130434782609;0,956521739130435
"13061";29402;91;13061;6;67;89;22;0,739130434782609;0,978260869565217
"13062";29402;91;13062;6;75;91;16;0,826086956521739;1
"13063";29402;91;13063;6;39;45;6;0,434782608695652;0,5
"13064";29402;91;13064;6;73;91;18;0,804347826086957;1
"13065";29402;91;13065;6;19;35;16;0,217391304347826;0,391304347826087
"13066";29402;91;13066;6;17;31;14;0,195652173913043;0,347826086956522
"13067";29402;91;13067;6;17;33;16;0,195652173913043;0,369565217391304
"13068";29402;91;13068;6;17;35;18;0,195652173913043;0,391304347826087
"13069";29402;91;13069;6;37;43;6;0,41304347826087;0,478260869565217
"13070";29402;91;13070;6;65;79;14;0,717391304347826;0,869565217391304
"13071";29402;91;13071;6;65;81;16;0,717391304347826;0,891304347826087
"13072";29402;91;13072;6;79;87;8;0,869565217391304;0,956521739130435
"13073";29402;91;13073;6;43;51;8;0,478260869565217;0,565217391304348
"13074";29402;91;13074;6;49;61;12;0,543478260869565;0,673913043478261
"13075";29402;91;13075;6;65;83;18;0,717391304347826;0,91304347826087
"13076";29402;91;13076;6;65;85;20;0,717391304347826;0,934782608695652
"13077";29531;91;13077;3;36;91;55;0,4;1
"13078";29531;91;13078;3;17;73;56;0,2;0,8
"13079";29531;91;13079;4;41;66;25;0,454545454545455;0,727272727272727
"13080";29531;91;13080;4;41;74;33;0,454545454545455;0,818181818181818
"13081";29531;91;13081;4;41;83;42;0,454545454545455;0,909090909090909
"13082";29531;91;13082;4;49;74;25;0,545454545454545;0,818181818181818
"13083";29531;91;13083;4;49;83;34;0,545454545454545;0,909090909090909
"13084";29531;91;13084;4;58;83;25;0,636363636363636;0,909090909090909
"13085";29531;91;13085;4;58;91;33;0,636363636363636;1
"13086";29531;91;13086;4;66;91;25;0,727272727272727;1
"13087";29531;91;13087;4;49;91;42;0,545454545454545;1
"13088";29531;91;13088;4;32;58;26;0,363636363636364;0,636363636363636
"13089";29531;91;13089;4;7;32;25;0,0909090909090909;0,363636363636364
"13090";29531;91;13090;4;24;49;25;0,272727272727273;0,545454545454545
"13091";29531;91;13091;4;41;91;50;0,454545454545455;1
"13092";29531;91;13092;5;51;63;12;0,565217391304348;0,695652173913043
"13093";29531;91;13093;5;55;67;12;0,608695652173913;0,739130434782609
"13094";29531;91;13094;5;55;71;16;0,608695652173913;0,782608695652174
"13095";29531;91;13095;5;59;71;12;0,652173913043478;0,782608695652174
"13096";29531;91;13096;5;63;75;12;0,695652173913043;0,826086956521739
"13097";29531;91;13097;5;71;83;12;0,782608695652174;0,91304347826087
"13098";29531;91;13098;5;75;87;12;0,826086956521739;0,956521739130435
"13099";29531;91;13099;5;75;91;16;0,826086956521739;1
"13100";29531;91;13100;5;79;91;12;0,869565217391304;1
"13101";29531;91;13101;5;11;23;12;0,130434782608696;0,260869565217391
"13102";29531;91;13102;5;39;51;12;0,434782608695652;0,565217391304348
"13103";29531;91;13103;5;43;55;12;0,478260869565217;0,608695652173913
"13104";29531;91;13104;5;47;59;12;0,521739130434783;0,652173913043478
"13105";29531;91;13105;5;59;75;16;0,652173913043478;0,826086956521739
"13106";29531;91;13106;5;59;79;20;0,652173913043478;0,869565217391304
"13107";29531;91;13107;5;59;83;24;0,652173913043478;0,91304347826087
"13108";29531;91;13108;5;59;87;28;0,652173913043478;0,956521739130435
"13109";29531;91;13109;5;63;79;16;0,695652173913043;0,869565217391304
"13110";29531;91;13110;5;63;83;20;0,695652173913043;0,91304347826087
"13111";29531;91;13111;5;71;87;16;0,782608695652174;0,956521739130435
"13112";29531;91;13112;5;39;55;16;0,434782608695652;0,608695652173913
"13113";29531;91;13113;5;47;63;16;0,521739130434783;0,695652173913043
"13114";29531;91;13114;5;47;67;20;0,521739130434783;0,739130434782609
"13115";29531;91;13115;5;47;71;24;0,521739130434783;0,782608695652174
"13116";29531;91;13116;5;47;75;28;0,521739130434783;0,826086956521739
"13117";29531;91;13117;5;51;67;16;0,565217391304348;0,739130434782609
"13118";29531;91;13118;5;55;75;20;0,608695652173913;0,826086956521739
"13119";29531;91;13119;5;55;79;24;0,608695652173913;0,869565217391304
"13120";29531;91;13120;5;55;83;28;0,608695652173913;0,91304347826087
"13121";29531;91;13121;5;55;87;32;0,608695652173913;0,956521739130435
"13122";29531;91;13122;5;55;91;36;0,608695652173913;1
"13123";29531;91;13123;5;59;91;32;0,652173913043478;1
"13124";29531;91;13124;5;63;87;24;0,695652173913043;0,956521739130435
"13125";29531;91;13125;5;63;91;28;0,695652173913043;1
"13126";29531;91;13126;5;71;91;20;0,782608695652174;1
"13127";29531;91;13127;5;23;35;12;0,260869565217391;0,391304347826087
"13128";29531;91;13128;5;7;19;12;0,0869565217391304;0,217391304347826
"13129";29531;91;13129;5;15;27;12;0,173913043478261;0,304347826086957
"13130";29531;91;13130;5;43;59;16;0,478260869565217;0,652173913043478
"13131";29531;91;13131;5;51;71;20;0,565217391304348;0,782608695652174
"13132";29531;91;13132;5;51;75;24;0,565217391304348;0,826086956521739
"13133";29531;91;13133;5;51;79;28;0,565217391304348;0,869565217391304
"13134";29531;91;13134;5;51;83;32;0,565217391304348;0,91304347826087
"13135";29531;91;13135;5;19;31;12;0,217391304347826;0,347826086956522
"13136";29531;91;13136;5;35;47;12;0,391304347826087;0,521739130434783
"13137";29531;91;13137;5;31;43;12;0,347826086956522;0,478260869565217
"13138";29531;91;13138;5;27;39;12;0,304347826086957;0,434782608695652
"13139";29531;91;13139;6;13;19;6;0,152173913043478;0,217391304347826
"13140";29531;91;13140;6;23;29;6;0,260869565217391;0,326086956521739
"13141";29531;91;13141;6;31;37;6;0,347826086956522;0,41304347826087
"13142";29531;91;13142;6;39;45;6;0,434782608695652;0,5
"13143";29531;91;13143;6;39;47;8;0,434782608695652;0,521739130434783
"13144";29531;91;13144;6;41;47;6;0,456521739130435;0,521739130434783
"13145";29531;91;13145;6;43;49;6;0,478260869565217;0,543478260869565
"13146";29531;91;13146;6;47;53;6;0,521739130434783;0,58695652173913
"13147";29531;91;13147;6;55;61;6;0,608695652173913;0,673913043478261
"13148";29531;91;13148;6;55;63;8;0,608695652173913;0,695652173913043
"13149";29531;91;13149;6;57;63;6;0,630434782608696;0,695652173913043
"13150";29531;91;13150;6;57;65;8;0,630434782608696;0,717391304347826
"13151";29531;91;13151;6;61;67;6;0,673913043478261;0,739130434782609
"13152";29531;91;13152;6;63;69;6;0,695652173913043;0,760869565217391
"13153";29531;91;13153;6;63;71;8;0,695652173913043;0,782608695652174
"13154";29531;91;13154;6;73;79;6;0,804347826086957;0,869565217391304
"13155";29531;91;13155;6;73;81;8;0,804347826086957;0,891304347826087
"13156";29531;91;13156;6;73;83;10;0,804347826086957;0,91304347826087
"13157";29531;91;13157;6;75;81;6;0,826086956521739;0,891304347826087
"13158";29531;91;13158;6;77;83;6;0,847826086956522;0,91304347826087
"13159";29531;91;13159;6;77;85;8;0,847826086956522;0,934782608695652
"13160";29531;91;13160;6;77;87;10;0,847826086956522;0,956521739130435
"13161";29531;91;13161;6;79;85;6;0,869565217391304;0,934782608695652
"13162";29531;91;13162;6;81;87;6;0,891304347826087;0,956521739130435
"13163";29531;91;13163;6;81;89;8;0,891304347826087;0,978260869565217
"13164";29531;91;13164;6;83;89;6;0,91304347826087;0,978260869565217
"13165";29531;91;13165;6;13;21;8;0,152173913043478;0,239130434782609
"13166";29531;91;13166;6;41;49;8;0,456521739130435;0,543478260869565
"13167";29531;91;13167;6;43;51;8;0,478260869565217;0,565217391304348
"13168";29531;91;13168;6;47;55;8;0,521739130434783;0,608695652173913
"13169";29531;91;13169;6;47;57;10;0,521739130434783;0,630434782608696
"13170";29531;91;13170;6;47;59;12;0,521739130434783;0,652173913043478
"13171";29531;91;13171;6;47;61;14;0,521739130434783;0,673913043478261
"13172";29531;91;13172;6;49;55;6;0,543478260869565;0,608695652173913
"13173";29531;91;13173;6;53;59;6;0,58695652173913;0,652173913043478
"13174";29531;91;13174;6;53;61;8;0,58695652173913;0,673913043478261
"13175";29531;91;13175;6;53;63;10;0,58695652173913;0,695652173913043
"13176";29531;91;13176;6;55;65;10;0,608695652173913;0,717391304347826
"13177";29531;91;13177;6;55;67;12;0,608695652173913;0,739130434782609
"13178";29531;91;13178;6;55;69;14;0,608695652173913;0,760869565217391
"13179";29531;91;13179;6;55;71;16;0,608695652173913;0,782608695652174
"13180";29531;91;13180;6;55;73;18;0,608695652173913;0,804347826086957
"13181";29531;91;13181;6;57;67;10;0,630434782608696;0,739130434782609
"13182";29531;91;13182;6;57;69;12;0,630434782608696;0,760869565217391
"13183";29531;91;13183;6;57;71;14;0,630434782608696;0,782608695652174
"13184";29531;91;13184;6;57;73;16;0,630434782608696;0,804347826086957
"13185";29531;91;13185;6;61;69;8;0,673913043478261;0,760869565217391
"13186";29531;91;13186;6;61;71;10;0,673913043478261;0,782608695652174
"13187";29531;91;13187;6;61;73;12;0,673913043478261;0,804347826086957
"13188";29531;91;13188;6;61;75;14;0,673913043478261;0,826086956521739
"13189";29531;91;13189;6;61;77;16;0,673913043478261;0,847826086956522
"13190";29531;91;13190;6;63;73;10;0,695652173913043;0,804347826086957
"13191";29531;91;13191;6;63;75;12;0,695652173913043;0,826086956521739
"13192";29531;91;13192;6;63;77;14;0,695652173913043;0,847826086956522
"13193";29531;91;13193;6;63;79;16;0,695652173913043;0,869565217391304
"13194";29531;91;13194;6;73;85;12;0,804347826086957;0,934782608695652
"13195";29531;91;13195;6;73;87;14;0,804347826086957;0,956521739130435
"13196";29531;91;13196;6;73;89;16;0,804347826086957;0,978260869565217
"13197";29531;91;13197;6;73;91;18;0,804347826086957;1
"13198";29531;91;13198;6;75;83;8;0,826086956521739;0,91304347826087
"13199";29531;91;13199;6;75;85;10;0,826086956521739;0,934782608695652
"13200";29531;91;13200;6;75;87;12;0,826086956521739;0,956521739130435
"13201";29531;91;13201;6;75;89;14;0,826086956521739;0,978260869565217
"13202";29531;91;13202;6;75;91;16;0,826086956521739;1
"13203";29531;91;13203;6;77;89;12;0,847826086956522;0,978260869565217
"13204";29531;91;13204;6;77;91;14;0,847826086956522;1
"13205";29531;91;13205;6;79;87;8;0,869565217391304;0,956521739130435
"13206";29531;91;13206;6;79;89;10;0,869565217391304;0,978260869565217
"13207";29531;91;13207;6;79;91;12;0,869565217391304;1
"13208";29531;91;13208;6;81;91;10;0,891304347826087;1
"13209";29531;91;13209;6;83;91;8;0,91304347826087;1
"13210";29531;91;13210;6;9;15;6;0,108695652173913;0,173913043478261
"13211";29531;91;13211;6;13;23;10;0,152173913043478;0,260869565217391
"13212";29531;91;13212;6;29;35;6;0,326086956521739;0,391304347826087
"13213";29531;91;13213;6;39;49;10;0,434782608695652;0,543478260869565
"13214";29531;91;13214;6;53;65;12;0,58695652173913;0,717391304347826
"13215";29531;91;13215;6;53;67;14;0,58695652173913;0,739130434782609
"13216";29531;91;13216;6;53;69;16;0,58695652173913;0,760869565217391
"13217";29531;91;13217;6;57;75;18;0,630434782608696;0,826086956521739
"13218";29531;91;13218;6;61;79;18;0,673913043478261;0,869565217391304
"13219";29531;91;13219;6;61;81;20;0,673913043478261;0,891304347826087
"13220";29531;91;13220;6;61;83;22;0,673913043478261;0,91304347826087
"13221";29531;91;13221;6;61;85;24;0,673913043478261;0,934782608695652
"13222";29531;91;13222;6;61;87;26;0,673913043478261;0,956521739130435
"13223";29531;91;13223;6;61;89;28;0,673913043478261;0,978260869565217
"13224";29531;91;13224;6;9;17;8;0,108695652173913;0,195652173913043
"13225";29531;91;13225;6;9;19;10;0,108695652173913;0,217391304347826
"13226";29531;91;13226;6;43;53;10;0,478260869565217;0,58695652173913
"13227";29531;91;13227;6;43;55;12;0,478260869565217;0,608695652173913
"13228";29531;91;13228;6;49;57;8;0,543478260869565;0,630434782608696
"13229";29531;91;13229;6;57;77;20;0,630434782608696;0,847826086956522
"13230";29531;91;13230;6;57;79;22;0,630434782608696;0,869565217391304
"13231";29531;91;13231;6;45;51;6;0,5;0,565217391304348
"13232";29531;91;13232;6;45;53;8;0,5;0,58695652173913
"13233";29531;91;13233;6;49;59;10;0,543478260869565;0,652173913043478
"13234";29531;91;13234;6;55;75;20;0,608695652173913;0,826086956521739
"13235";29531;91;13235;6;63;81;18;0,695652173913043;0,891304347826087
"13236";29531;91;13236;6;5;11;6;0,0652173913043478;0,130434782608696
"13237";29531;91;13237;6;5;13;8;0,0652173913043478;0,152173913043478
"13238";29531;91;13238;6;23;31;8;0,260869565217391;0,347826086956522
"13239";29531;91;13239;6;25;31;6;0,282608695652174;0,347826086956522
"13240";29531;91;13240;6;53;71;18;0,58695652173913;0,782608695652174
"13241";29531;91;13241;6;53;73;20;0,58695652173913;0,804347826086957
"13242";29531;91;13242;6;53;75;22;0,58695652173913;0,826086956521739
"13243";29531;91;13243;6;55;77;22;0,608695652173913;0,847826086956522
"13244";29531;91;13244;6;55;79;24;0,608695652173913;0,869565217391304
"13245";29531;91;13245;6;55;81;26;0,608695652173913;0,891304347826087
"13246";29531;91;13246;6;55;83;28;0,608695652173913;0,91304347826087
"13247";29531;91;13247;6;57;81;24;0,630434782608696;0,891304347826087
"13248";29531;91;13248;6;57;83;26;0,630434782608696;0,91304347826087
"13249";29531;91;13249;6;57;85;28;0,630434782608696;0,934782608695652
"13250";29531;91;13250;6;57;87;30;0,630434782608696;0,956521739130435
"13251";29531;91;13251;6;61;91;30;0,673913043478261;1
"13252";29531;91;13252;6;63;83;20;0,695652173913043;0,91304347826087
"13253";29531;91;13253;6;63;85;22;0,695652173913043;0,934782608695652
"13254";29531;91;13254;6;63;87;24;0,695652173913043;0,956521739130435
"13255";29531;91;13255;6;63;89;26;0,695652173913043;0,978260869565217
"13256";29531;91;13256;6;63;91;28;0,695652173913043;1
"13257";29531;91;13257;6;53;77;24;0,58695652173913;0,847826086956522
"13258";29531;91;13258;6;53;79;26;0,58695652173913;0,869565217391304
"13259";29531;91;13259;6;53;81;28;0,58695652173913;0,891304347826087
"13260";29531;91;13260;6;53;83;30;0,58695652173913;0,91304347826087
"13261";29531;91;13261;6;19;25;6;0,217391304347826;0,282608695652174
"13262";29531;91;13262;6;29;37;8;0,326086956521739;0,41304347826087
"13263";29531;91;13263;6;31;39;8;0,347826086956522;0,434782608695652
"13264";29531;91;13264;6;55;85;30;0,608695652173913;0,934782608695652
"13265";29531;91;13265;6;19;27;8;0,217391304347826;0,304347826086957
"13266";29531;91;13266;6;49;61;12;0,543478260869565;0,673913043478261
"13267";29531;91;13267;6;49;63;14;0,543478260869565;0,695652173913043
"13268";29531;91;13268;6;49;65;16;0,543478260869565;0,717391304347826
"13269";29531;91;13269;6;41;51;10;0,456521739130435;0,565217391304348
"13270";29531;91;13270;6;41;53;12;0,456521739130435;0,58695652173913
"13271";29531;91;13271;6;37;43;6;0,41304347826087;0,478260869565217
"13272";29531;91;13272;6;35;41;6;0,391304347826087;0,456521739130435
"13273";30763;96;13273;3;31;80;49;0,333333333333333;0,833333333333333
"13274";30763;96;13274;3;48;96;48;0,5;1
"13275";30763;96;13275;3;31;96;65;0,333333333333333;1
"13276";30763;96;13276;4;31;56;25;0,333333333333333;0,583333333333333
"13277";30763;96;13277;4;64;88;24;0,666666666666667;0,916666666666667
"13278";30763;96;13278;4;23;48;25;0,25;0,5
"13279";30763;96;13279;4;23;56;33;0,25;0,583333333333333
"13280";30763;96;13280;4;39;64;25;0,416666666666667;0,666666666666667
"13281";30763;96;13281;4;56;80;24;0,583333333333333;0,833333333333333
"13282";30763;96;13282;4;72;96;24;0,75;1
"13283";30763;96;13283;4;31;64;33;0,333333333333333;0,666666666666667
"13284";30763;96;13284;4;64;96;32;0,666666666666667;1
"13285";30763;96;13285;4;56;88;32;0,583333333333333;0,916666666666667
"13286";30763;96;13286;4;56;96;40;0,583333333333333;1
"13287";30763;96;13287;5;23;35;12;0,25;0,375
"13288";30763;96;13288;5;23;39;16;0,25;0,416666666666667
"13289";30763;96;13289;5;35;48;13;0,375;0,5
"13290";30763;96;13290;5;56;68;12;0,583333333333333;0,708333333333333
"13291";30763;96;13291;5;60;72;12;0,625;0,75
"13292";30763;96;13292;5;64;76;12;0,666666666666667;0,791666666666667
"13293";30763;96;13293;5;76;88;12;0,791666666666667;0,916666666666667
"13294";30763;96;13294;5;80;92;12;0,833333333333333;0,958333333333333
"13295";30763;96;13295;5;84;96;12;0,875;1
"13296";30763;96;13296;5;31;43;12;0,333333333333333;0,458333333333333
"13297";30763;96;13297;5;31;48;17;0,333333333333333;0,5
"13298";30763;96;13298;5;56;72;16;0,583333333333333;0,75
"13299";30763;96;13299;5;60;76;16;0,625;0,791666666666667
"13300";30763;96;13300;5;60;80;20;0,625;0,833333333333333
"13301";30763;96;13301;5;64;80;16;0,666666666666667;0,833333333333333
"13302";30763;96;13302;5;68;80;12;0,708333333333333;0,833333333333333
"13303";30763;96;13303;5;68;84;16;0,708333333333333;0,875
"13304";30763;96;13304;5;68;88;20;0,708333333333333;0,916666666666667
"13305";30763;96;13305;5;23;43;20;0,25;0,458333333333333
"13306";30763;96;13306;5;27;39;12;0,291666666666667;0,416666666666667
"13307";30763;96;13307;5;27;43;16;0,291666666666667;0,458333333333333
"13308";30763;96;13308;5;31;52;21;0,333333333333333;0,541666666666667
"13309";30763;96;13309;5;31;56;25;0,333333333333333;0,583333333333333
"13310";30763;96;13310;5;35;52;17;0,375;0,541666666666667
"13311";30763;96;13311;5;35;56;21;0,375;0,583333333333333
"13312";30763;96;13312;5;43;56;13;0,458333333333333;0,583333333333333
"13313";30763;96;13313;5;43;60;17;0,458333333333333;0,625
"13314";30763;96;13314;5;56;76;20;0,583333333333333;0,791666666666667
"13315";30763;96;13315;5;72;84;12;0,75;0,875
"13316";30763;96;13316;5;72;88;16;0,75;0,916666666666667
"13317";30763;96;13317;5;72;92;20;0,75;0,958333333333333
"13318";30763;96;13318;5;72;96;24;0,75;1
"13319";30763;96;13319;5;76;92;16;0,791666666666667;0,958333333333333
"13320";30763;96;13320;5;76;96;20;0,791666666666667;1
"13321";30763;96;13321;5;80;96;16;0,833333333333333;1
"13322";30763;96;13322;5;19;31;12;0,208333333333333;0,333333333333333
"13323";30763;96;13323;5;19;35;16;0,208333333333333;0,375
"13324";30763;96;13324;5;19;39;20;0,208333333333333;0,416666666666667
"13325";30763;96;13325;5;19;43;24;0,208333333333333;0,458333333333333
"13326";30763;96;13326;5;64;84;20;0,666666666666667;0,875
"13327";30763;96;13327;5;23;48;25;0,25;0,5
"13328";30763;96;13328;5;68;92;24;0,708333333333333;0,958333333333333
"13329";30763;96;13329;5;68;96;28;0,708333333333333;1
"13330";30763;96;13330;6;31;37;6;0,333333333333333;0,395833333333333
"13331";30763;96;13331;6;56;62;6;0,583333333333333;0,645833333333333
"13332";30763;96;13332;6;56;64;8;0,583333333333333;0,666666666666667
"13333";30763;96;13333;6;60;66;6;0,625;0,6875
"13334";30763;96;13334;6;60;68;8;0,625;0,708333333333333
"13335";30763;96;13335;6;60;70;10;0,625;0,729166666666667
"13336";30763;96;13336;6;62;68;6;0,645833333333333;0,708333333333333
"13337";30763;96;13337;6;68;74;6;0,708333333333333;0,770833333333333
"13338";30763;96;13338;6;68;76;8;0,708333333333333;0,791666666666667
"13339";30763;96;13339;6;70;76;6;0,729166666666667;0,791666666666667
"13340";30763;96;13340;6;76;82;6;0,791666666666667;0,854166666666667
"13341";30763;96;13341;6;78;84;6;0,8125;0,875
"13342";30763;96;13342;6;82;88;6;0,854166666666667;0,916666666666667
"13343";30763;96;13343;6;82;90;8;0,854166666666667;0,9375
"13344";30763;96;13344;6;84;90;6;0,875;0,9375
"13345";30763;96;13345;6;84;92;8;0,875;0,958333333333333
"13346";30763;96;13346;6;86;92;6;0,895833333333333;0,958333333333333
"13347";30763;96;13347;6;86;94;8;0,895833333333333;0,979166666666667
"13348";30763;96;13348;6;17;23;6;0,1875;0,25
"13349";30763;96;13349;6;19;25;6;0,208333333333333;0,270833333333333
"13350";30763;96;13350;6;23;29;6;0,25;0,3125
"13351";30763;96;13351;6;23;31;8;0,25;0,333333333333333
"13352";30763;96;13352;6;23;33;10;0,25;0,354166666666667
"13353";30763;96;13353;6;29;35;6;0,3125;0,375
"13354";30763;96;13354;6;29;37;8;0,3125;0,395833333333333
"13355";30763;96;13355;6;31;39;8;0,333333333333333;0,416666666666667
"13356";30763;96;13356;6;31;41;10;0,333333333333333;0,4375
"13357";30763;96;13357;6;31;43;12;0,333333333333333;0,458333333333333
"13358";30763;96;13358;6;31;45;14;0,333333333333333;0,479166666666667
"13359";30763;96;13359;6;33;39;6;0,354166666666667;0,416666666666667
"13360";30763;96;13360;6;33;41;8;0,354166666666667;0,4375
"13361";30763;96;13361;6;33;43;10;0,354166666666667;0,458333333333333
"13362";30763;96;13362;6;43;50;7;0,458333333333333;0,520833333333333
"13363";30763;96;13363;6;56;66;10;0,583333333333333;0,6875
"13364";30763;96;13364;6;58;64;6;0,604166666666667;0,666666666666667
"13365";30763;96;13365;6;58;66;8;0,604166666666667;0,6875
"13366";30763;96;13366;6;58;68;10;0,604166666666667;0,708333333333333
"13367";30763;96;13367;6;62;70;8;0,645833333333333;0,729166666666667
"13368";30763;96;13368;6;62;72;10;0,645833333333333;0,75
"13369";30763;96;13369;6;66;72;6;0,6875;0,75
"13370";30763;96;13370;6;68;78;10;0,708333333333333;0,8125
"13371";30763;96;13371;6;70;78;8;0,729166666666667;0,8125
"13372";30763;96;13372;6;74;80;6;0,770833333333333;0,833333333333333
"13373";30763;96;13373;6;74;82;8;0,770833333333333;0,854166666666667
"13374";30763;96;13374;6;74;84;10;0,770833333333333;0,875
"13375";30763;96;13375;6;74;86;12;0,770833333333333;0,895833333333333
"13376";30763;96;13376;6;76;84;8;0,791666666666667;0,875
"13377";30763;96;13377;6;76;86;10;0,791666666666667;0,895833333333333
"13378";30763;96;13378;6;76;88;12;0,791666666666667;0,916666666666667
"13379";30763;96;13379;6;78;86;8;0,8125;0,895833333333333
"13380";30763;96;13380;6;82;92;10;0,854166666666667;0,958333333333333
"13381";30763;96;13381;6;84;94;10;0,875;0,979166666666667
"13382";30763;96;13382;6;88;94;6;0,916666666666667;0,979166666666667
"13383";30763;96;13383;6;88;96;8;0,916666666666667;1
"13384";30763;96;13384;6;31;48;17;0,333333333333333;0,5
"13385";30763;96;13385;6;31;50;19;0,333333333333333;0,520833333333333
"13386";30763;96;13386;6;31;52;21;0,333333333333333;0,541666666666667
"13387";30763;96;13387;6;31;54;23;0,333333333333333;0,5625
"13388";30763;96;13388;6;43;52;9;0,458333333333333;0,541666666666667
"13389";30763;96;13389;6;43;54;11;0,458333333333333;0,5625
"13390";30763;96;13390;6;43;56;13;0,458333333333333;0,583333333333333
"13391";30763;96;13391;6;43;58;15;0,458333333333333;0,604166666666667
"13392";30763;96;13392;6;66;74;8;0,6875;0,770833333333333
"13393";30763;96;13393;6;66;76;10;0,6875;0,791666666666667
"13394";30763;96;13394;6;66;78;12;0,6875;0,8125
"13395";30763;96;13395;6;68;80;12;0,708333333333333;0,833333333333333
"13396";30763;96;13396;6;68;82;14;0,708333333333333;0,854166666666667
"13397";30763;96;13397;6;68;84;16;0,708333333333333;0,875
"13398";30763;96;13398;6;68;86;18;0,708333333333333;0,895833333333333
"13399";30763;96;13399;6;68;88;20;0,708333333333333;0,916666666666667
"13400";30763;96;13400;6;70;80;10;0,729166666666667;0,833333333333333
"13401";30763;96;13401;6;70;82;12;0,729166666666667;0,854166666666667
"13402";30763;96;13402;6;90;96;6;0,9375;1
"13403";30763;96;13403;6;23;35;12;0,25;0,375
"13404";30763;96;13404;6;23;37;14;0,25;0,395833333333333
"13405";30763;96;13405;6;27;33;6;0,291666666666667;0,354166666666667
"13406";30763;96;13406;6;27;35;8;0,291666666666667;0,375
"13407";30763;96;13407;6;27;37;10;0,291666666666667;0,395833333333333
"13408";30763;96;13408;6;27;39;12;0,291666666666667;0,416666666666667
"13409";30763;96;13409;6;27;41;14;0,291666666666667;0,4375
"13410";30763;96;13410;6;27;43;16;0,291666666666667;0,458333333333333
"13411";30763;96;13411;6;29;39;10;0,3125;0,416666666666667
"13412";30763;96;13412;6;29;41;12;0,3125;0,4375
"13413";30763;96;13413;6;78;88;10;0,8125;0,916666666666667
"13414";30763;96;13414;6;78;90;12;0,8125;0,9375
"13415";30763;96;13415;6;78;92;14;0,8125;0,958333333333333
"13416";30763;96;13416;6;23;39;16;0,25;0,416666666666667
"13417";30763;96;13417;6;23;41;18;0,25;0,4375
"13418";30763;96;13418;6;23;43;20;0,25;0,458333333333333
"13419";30763;96;13419;6;29;43;14;0,3125;0,458333333333333
"13420";30763;96;13420;6;33;45;12;0,354166666666667;0,479166666666667
"13421";30763;96;13421;6;33;48;15;0,354166666666667;0,5
"13422";30763;96;13422;6;33;50;17;0,354166666666667;0,520833333333333
"13423";30763;96;13423;6;33;52;19;0,354166666666667;0,541666666666667
"13424";30763;96;13424;6;33;54;21;0,354166666666667;0,5625
"13425";30763;96;13425;6;33;56;23;0,354166666666667;0,583333333333333
"13426";30763;96;13426;6;78;94;16;0,8125;0,979166666666667
"13427";30763;96;13427;6;78;96;18;0,8125;1
"13428";30763;96;13428;6;86;96;10;0,895833333333333;1
"13429";30763;96;13429;6;15;21;6;0,166666666666667;0,229166666666667
"13430";30763;96;13430;6;21;27;6;0,229166666666667;0,291666666666667
"13431";30763;96;13431;6;21;29;8;0,229166666666667;0,3125
"13432";30763;96;13432;6;82;94;12;0,854166666666667;0,979166666666667
"13433";30763;96;13433;6;84;96;12;0,875;1
"13434";30763;96;13434;6;45;52;7;0,479166666666667;0,541666666666667
"13435";30763;96;13435;6;45;54;9;0,479166666666667;0,5625
"13436";30763;96;13436;6;45;56;11;0,479166666666667;0,583333333333333
"13437";30763;96;13437;6;76;90;14;0,791666666666667;0,9375
"13438";30763;96;13438;6;76;92;16;0,791666666666667;0,958333333333333
"13439";30763;96;13439;6;76;94;18;0,791666666666667;0,979166666666667
"13440";30763;96;13440;6;76;96;20;0,791666666666667;1
"13441";30763;96;13441;6;82;96;14;0,854166666666667;1
"13442";30763;96;13442;6;58;70;12;0,604166666666667;0,729166666666667
"13443";30763;96;13443;6;70;84;14;0,729166666666667;0,875
"13444";30763;96;13444;6;70;86;16;0,729166666666667;0,895833333333333
"13445";30763;96;13445;6;70;88;18;0,729166666666667;0,916666666666667
"13446";30763;96;13446;6;21;31;10;0,229166666666667;0,333333333333333
"13447";31794;75;13447;4;7;33;26;0,111111111111111;0,444444444444444
"13448";31794;75;13448;4;7;41;34;0,111111111111111;0,555555555555556
"13449";31794;75;13449;4;50;75;25;0,666666666666667;1
"13450";31794;75;13450;4;41;67;26;0,555555555555556;0,888888888888889
"13451";31794;75;13451;5;3;15;12;0,0526315789473684;0,210526315789474
"13452";31794;75;13452;5;7;19;12;0,105263157894737;0,263157894736842
"13453";31794;75;13453;5;11;23;12;0,157894736842105;0,315789473684211
"13454";31794;75;13454;5;11;27;16;0,157894736842105;0,368421052631579
"13455";31794;75;13455;5;3;19;16;0,0526315789473684;0,263157894736842
"13456";31794;75;13456;5;3;23;20;0,0526315789473684;0,315789473684211
"13457";31794;75;13457;5;3;27;24;0,0526315789473684;0,368421052631579
"13458";31794;75;13458;5;3;31;28;0,0526315789473684;0,421052631578947
"13459";31794;75;13459;5;7;23;16;0,105263157894737;0,315789473684211
"13460";31794;75;13460;5;7;27;20;0,105263157894737;0,368421052631579
"13461";31794;75;13461;5;7;31;24;0,105263157894737;0,421052631578947
"13462";31794;75;13462;5;3;35;32;0,0526315789473684;0,473684210526316
"13463";31794;75;13463;5;3;39;36;0,0526315789473684;0,526315789473684
"13464";31794;75;13464;5;3;43;40;0,0526315789473684;0,578947368421053
"13465";31794;75;13465;5;7;35;28;0,105263157894737;0,473684210526316
"13466";31794;75;13466;5;7;39;32;0,105263157894737;0,526315789473684
"13467";31794;75;13467;5;7;43;36;0,105263157894737;0,578947368421053
"13468";31794;75;13468;5;11;31;20;0,157894736842105;0,421052631578947
"13469";31794;75;13469;5;11;35;24;0,157894736842105;0,473684210526316
"13470";31794;75;13470;5;51;63;12;0,684210526315789;0,842105263157895
"13471";31794;75;13471;5;51;67;16;0,684210526315789;0,894736842105263
"13472";31794;75;13472;5;55;67;12;0,736842105263158;0,894736842105263
"13473";31794;75;13473;5;43;55;12;0,578947368421053;0,736842105263158
"13474";31794;75;13474;5;43;59;16;0,578947368421053;0,789473684210526
"13475";31794;75;13475;5;47;59;12;0,631578947368421;0,789473684210526
"13476";31794;75;13476;5;47;63;16;0,631578947368421;0,842105263157895
"13477";31794;75;13477;5;47;67;20;0,631578947368421;0,894736842105263
"13478";31794;75;13478;6;1;7;6;0,0263157894736842;0,105263157894737
"13479";31794;75;13479;6;3;9;6;0,0526315789473684;0,131578947368421
"13480";31794;75;13480;6;3;11;8;0,0526315789473684;0,157894736842105
"13481";31794;75;13481;6;5;11;6;0,0789473684210526;0,157894736842105
"13482";31794;75;13482;6;7;13;6;0,105263157894737;0,184210526315789
"13483";31794;75;13483;6;9;15;6;0,131578947368421;0,210526315789474
"13484";31794;75;13484;6;9;17;8;0,131578947368421;0,236842105263158
"13485";31794;75;13485;6;11;17;6;0,157894736842105;0,236842105263158
"13486";31794;75;13486;6;11;19;8;0,157894736842105;0,263157894736842
"13487";31794;75;13487;6;35;41;6;0,473684210526316;0,552631578947368
"13488";31794;75;13488;6;37;43;6;0,5;0,578947368421053
"13489";31794;75;13489;6;43;49;6;0,578947368421053;0,657894736842105
"13490";31794;75;13490;6;45;51;6;0,605263157894737;0,684210526315789
"13491";31794;75;13491;6;53;59;6;0,710526315789474;0,789473684210526
"13492";31794;75;13492;6;59;65;6;0,789473684210526;0,868421052631579
"13493";31794;75;13493;6;1;9;8;0,0263157894736842;0,131578947368421
"13494";31794;75;13494;6;1;11;10;0,0263157894736842;0,157894736842105
"13495";31794;75;13495;6;1;13;12;0,0263157894736842;0,184210526315789
"13496";31794;75;13496;6;1;15;14;0,0263157894736842;0,210526315789474
"13497";31794;75;13497;6;1;17;16;0,0263157894736842;0,236842105263158
"13498";31794;75;13498;6;3;13;10;0,0526315789473684;0,184210526315789
"13499";31794;75;13499;6;3;15;12;0,0526315789473684;0,210526315789474
"13500";31794;75;13500;6;5;13;8;0,0789473684210526;0,184210526315789
"13501";31794;75;13501;6;5;15;10;0,0789473684210526;0,210526315789474
"13502";31794;75;13502;6;5;17;12;0,0789473684210526;0,236842105263158
"13503";31794;75;13503;6;5;19;14;0,0789473684210526;0,263157894736842
"13504";31794;75;13504;6;5;21;16;0,0789473684210526;0,289473684210526
"13505";31794;75;13505;6;5;23;18;0,0789473684210526;0,315789473684211
"13506";31794;75;13506;6;7;15;8;0,105263157894737;0,210526315789474
"13507";31794;75;13507;6;7;17;10;0,105263157894737;0,236842105263158
"13508";31794;75;13508;6;7;19;12;0,105263157894737;0,263157894736842
"13509";31794;75;13509;6;7;21;14;0,105263157894737;0,289473684210526
"13510";31794;75;13510;6;7;23;16;0,105263157894737;0,315789473684211
"13511";31794;75;13511;6;7;25;18;0,105263157894737;0,342105263157895
"13512";31794;75;13512;6;7;27;20;0,105263157894737;0,368421052631579
"13513";31794;75;13513;6;9;19;10;0,131578947368421;0,263157894736842
"13514";31794;75;13514;6;9;21;12;0,131578947368421;0,289473684210526
"13515";31794;75;13515;6;9;23;14;0,131578947368421;0,315789473684211
"13516";31794;75;13516;6;9;25;16;0,131578947368421;0,342105263157895
"13517";31794;75;13517;6;9;27;18;0,131578947368421;0,368421052631579
"13518";31794;75;13518;6;11;21;10;0,157894736842105;0,289473684210526
"13519";31794;75;13519;6;11;23;12;0,157894736842105;0,315789473684211
"13520";31794;75;13520;6;11;25;14;0,157894736842105;0,342105263157895
"13521";31794;75;13521;6;11;27;16;0,157894736842105;0,368421052631579
"13522";31794;75;13522;6;11;29;18;0,157894736842105;0,394736842105263
"13523";31794;75;13523;6;35;43;8;0,473684210526316;0,578947368421053
"13524";31794;75;13524;6;43;51;8;0,578947368421053;0,684210526315789
"13525";31794;75;13525;6;43;53;10;0,578947368421053;0,710526315789474
"13526";31794;75;13526;6;45;53;8;0,605263157894737;0,710526315789474
"13527";31794;75;13527;6;47;53;6;0,631578947368421;0,710526315789474
"13528";31794;75;13528;6;53;61;8;0,710526315789474;0,815789473684211
"13529";31794;75;13529;6;53;63;10;0,710526315789474;0,842105263157895
"13530";31794;75;13530;6;53;65;12;0,710526315789474;0,868421052631579
"13531";31794;75;13531;6;67;73;6;0,894736842105263;0,973684210526316
"13532";31794;75;13532;6;1;19;18;0,0263157894736842;0,263157894736842
"13533";31794;75;13533;6;1;21;20;0,0263157894736842;0,289473684210526
"13534";31794;75;13534;6;1;23;22;0,0263157894736842;0,315789473684211
"13535";31794;75;13535;6;1;25;24;0,0263157894736842;0,342105263157895
"13536";31794;75;13536;6;1;27;26;0,0263157894736842;0,368421052631579
"13537";31794;75;13537;6;1;29;28;0,0263157894736842;0,394736842105263
"13538";31794;75;13538;6;3;17;14;0,0526315789473684;0,236842105263158
"13539";31794;75;13539;6;3;19;16;0,0526315789473684;0,263157894736842
"13540";31794;75;13540;6;3;21;18;0,0526315789473684;0,289473684210526
"13541";31794;75;13541;6;3;23;20;0,0526315789473684;0,315789473684211
"13542";31794;75;13542;6;3;25;22;0,0526315789473684;0,342105263157895
"13543";31794;75;13543;6;3;27;24;0,0526315789473684;0,368421052631579
"13544";31794;75;13544;6;5;25;20;0,0789473684210526;0,342105263157895
"13545";31794;75;13545;6;5;27;22;0,0789473684210526;0,368421052631579
"13546";31794;75;13546;6;5;29;24;0,0789473684210526;0,394736842105263
"13547";31794;75;13547;6;5;31;26;0,0789473684210526;0,421052631578947
"13548";31794;75;13548;6;5;33;28;0,0789473684210526;0,447368421052632
"13549";31794;75;13549;6;5;35;30;0,0789473684210526;0,473684210526316
"13550";31794;75;13550;6;7;29;22;0,105263157894737;0,394736842105263
"13551";31794;75;13551;6;7;31;24;0,105263157894737;0,421052631578947
"13552";31794;75;13552;6;7;33;26;0,105263157894737;0,447368421052632
"13553";31794;75;13553;6;9;29;20;0,131578947368421;0,394736842105263
"13554";31794;75;13554;6;9;31;22;0,131578947368421;0,421052631578947
"13555";31794;75;13555;6;9;33;24;0,131578947368421;0,447368421052632
"13556";31794;75;13556;6;9;35;26;0,131578947368421;0,473684210526316
"13557";31794;75;13557;6;7;35;28;0,105263157894737;0,473684210526316
"13558";31794;75;13558;6;11;31;20;0,157894736842105;0,421052631578947
"13559";31794;75;13559;6;11;33;22;0,157894736842105;0,447368421052632
"13560";31794;75;13560;6;11;35;24;0,157894736842105;0,473684210526316
"13561";31794;75;13561;6;65;71;6;0,868421052631579;0,947368421052632
"13562";31794;75;13562;6;67;75;8;0,894736842105263;1
"13563";31794;75;13563;6;49;55;6;0,657894736842105;0,736842105263158
"13564";31794;75;13564;6;69;75;6;0,921052631578947;1
"13565";31794;75;13565;6;59;67;8;0,789473684210526;0,894736842105263
"13566";31794;75;13566;6;53;67;14;0,710526315789474;0,894736842105263
"13567";31794;75;13567;6;1;31;30;0,0263157894736842;0,421052631578947
"13568";31794;75;13568;6;1;33;32;0,0263157894736842;0,447368421052632
"13569";31794;75;13569;6;1;35;34;0,0263157894736842;0,473684210526316
"13570";31794;75;13570;6;49;57;8;0,657894736842105;0,763157894736842
"13571";31992;46;13571;3;18;46;28;0,4;1
"13572";31992;46;13572;3;8;37;29;0,2;0,8
"13573";31992;46;13573;3;8;46;38;0,2;1
"13574";31992;46;13574;4;29;42;13;0,636363636363636;0,909090909090909
"13575";31992;46;13575;4;16;29;13;0,363636363636364;0,636363636363636
"13576";31992;46;13576;4;16;33;17;0,363636363636364;0,727272727272727
"13577";31992;46;13577;4;16;37;21;0,363636363636364;0,818181818181818
"13578";31992;46;13578;4;16;42;26;0,363636363636364;0,909090909090909
"13579";31992;46;13579;4;16;46;30;0,363636363636364;1
"13580";31992;46;13580;4;29;46;17;0,636363636363636;1
"13581";31992;46;13581;4;12;25;13;0,272727272727273;0,545454545454545
"13582";31992;46;13582;4;12;29;17;0,272727272727273;0,636363636363636
"13583";31992;46;13583;4;3;16;13;0,0909090909090909;0,363636363636364
"13584";31992;46;13584;5;30;36;6;0,652173913043478;0,782608695652174
"13585";31992;46;13585;5;17;24;7;0,391304347826087;0,521739130434783
"13586";31992;46;13586;5;17;26;9;0,391304347826087;0,565217391304348
"13587";31992;46;13587;5;17;28;11;0,391304347826087;0,608695652173913
"13588";31992;46;13588;5;17;30;13;0,391304347826087;0,652173913043478
"13589";31992;46;13589;5;17;32;15;0,391304347826087;0,695652173913043
"13590";31992;46;13590;5;30;38;8;0,652173913043478;0,826086956521739
"13591";31992;46;13591;5;30;40;10;0,652173913043478;0,869565217391304
"13592";31992;46;13592;5;30;42;12;0,652173913043478;0,91304347826087
"13593";31992;46;13593;5;30;44;14;0,652173913043478;0,956521739130435
"13594";31992;46;13594;5;17;34;17;0,391304347826087;0,739130434782609
"13595";31992;46;13595;5;13;19;6;0,304347826086957;0,434782608695652
"13596";31992;46;13596;5;3;9;6;0,0869565217391304;0,217391304347826
"13597";31992;46;13597;5;5;11;6;0,130434782608696;0,260869565217391
"13598";31992;46;13598;5;15;21;6;0,347826086956522;0,478260869565217
"13599";31992;46;13599;5;11;17;6;0,260869565217391;0,391304347826087
"13600";31992;46;13600;5;30;46;16;0,652173913043478;1
"13601";31992;46;13601;5;17;36;19;0,391304347826087;0,782608695652174
"13602";31992;46;13602;5;17;38;21;0,391304347826087;0,826086956521739
"13603";31992;46;13603;5;17;40;23;0,391304347826087;0,869565217391304
"13604";31992;46;13604;5;17;42;25;0,391304347826087;0,91304347826087
"13605";31992;46;13605;5;17;44;27;0,391304347826087;0,956521739130435
"13606";31992;46;13606;5;1;7;6;0,0434782608695652;0,173913043478261
"13607";31992;46;13607;5;17;46;29;0,391304347826087;1
"13608";31992;46;13608;5;15;24;9;0,347826086956522;0,521739130434783
"13609";34435;43;13609;4;27;39;12;0,636363636363636;0,909090909090909
"13610";34435;43;13610;4;31;43;12;0,727272727272727;1
"13611";34435;43;13611;5;29;35;6;0,681818181818182;0,818181818181818
"13612";34435;43;13612;5;33;39;6;0,772727272727273;0,909090909090909
"13613";34435;43;13613;5;35;41;6;0,818181818181818;0,954545454545455
"13614";34435;43;13614;5;31;37;6;0,727272727272727;0,863636363636364
"13615";34435;43;13615;5;25;31;6;0,590909090909091;0,727272727272727
"13616";34435;43;13616;5;27;33;6;0,636363636363636;0,772727272727273
"13617";34435;43;13617;5;29;37;8;0,681818181818182;0,863636363636364
"13618";34435;43;13618;5;33;41;8;0,772727272727273;0,954545454545455
"13619";34435;43;13619;5;37;43;6;0,863636363636364;1
"13620";34435;43;13620;5;25;33;8;0,590909090909091;0,772727272727273
"13621";34435;43;13621;5;35;43;8;0,818181818181818;1
"13622";34435;43;13622;5;31;39;8;0,727272727272727;0,909090909090909
"13623";34455;103;13623;3;51;103;52;0,5;1
"13624";34455;103;13624;4;47;71;24;0,461538461538462;0,692307692307692
"13625";34455;103;13625;4;79;103;24;0,769230769230769;1
"13626";34455;103;13626;4;55;79;24;0,538461538461538;0,769230769230769
"13627";34455;103;13627;4;71;95;24;0,692307692307692;0,923076923076923
"13628";34455;103;13628;4;63;87;24;0,615384615384615;0,846153846153846
"13629";34455;103;13629;4;39;63;24;0,384615384615385;0,615384615384615
"13630";34455;103;13630;5;31;43;12;0,307692307692308;0,423076923076923
"13631";34455;103;13631;5;23;35;12;0,230769230769231;0,346153846153846
"13632";34455;103;13632;5;63;75;12;0,615384615384615;0,730769230769231
"13633";34455;103;13633;5;63;79;16;0,615384615384615;0,769230769230769
"13634";34455;103;13634;5;71;83;12;0,692307692307692;0,807692307692308
"13635";34455;103;13635;5;43;55;12;0,423076923076923;0,538461538461538
"13636";34455;103;13636;5;47;59;12;0,461538461538462;0,576923076923077
"13637";34455;103;13637;5;59;71;12;0,576923076923077;0,692307692307692
"13638";34455;103;13638;5;71;87;16;0,692307692307692;0,846153846153846
"13639";34455;103;13639;5;71;91;20;0,692307692307692;0,884615384615385
"13640";34455;103;13640;5;91;103;12;0,884615384615385;1
"13641";34455;103;13641;5;39;51;12;0,384615384615385;0,5
"13642";34455;103;13642;5;55;67;12;0,538461538461538;0,653846153846154
"13643";34455;103;13643;5;83;95;12;0,807692307692308;0,923076923076923
"13644";34455;103;13644;5;75;87;12;0,730769230769231;0,846153846153846
"13645";34455;103;13645;5;51;63;12;0,5;0,615384615384615
"13646";34455;103;13646;5;35;47;12;0,346153846153846;0,461538461538462
"13647";34455;103;13647;5;87;99;12;0,846153846153846;0,961538461538462
"13648";34455;103;13648;5;87;103;16;0,846153846153846;1
"13649";34455;103;13649;5;75;91;16;0,730769230769231;0,884615384615385
"13650";34455;103;13650;5;27;39;12;0,269230769230769;0,384615384615385
"13651";34455;103;13651;5;51;67;16;0,5;0,653846153846154
"13652";34455;103;13652;6;33;39;6;0,326923076923077;0,384615384615385
"13653";34455;103;13653;6;43;49;6;0,423076923076923;0,480769230769231
"13654";34455;103;13654;6;47;53;6;0,461538461538462;0,519230769230769
"13655";34455;103;13655;6;51;57;6;0,5;0,557692307692308
"13656";34455;103;13656;6;51;59;8;0,5;0,576923076923077
"13657";34455;103;13657;6;53;59;6;0,519230769230769;0,576923076923077
"13658";34455;103;13658;6;61;67;6;0,596153846153846;0,653846153846154
"13659";34455;103;13659;6;63;69;6;0,615384615384615;0,673076923076923
"13660";34455;103;13660;6;85;91;6;0,826923076923077;0,884615384615385
"13661";34455;103;13661;6;91;97;6;0,884615384615385;0,942307692307692
"13662";34455;103;13662;6;93;99;6;0,903846153846154;0,961538461538462
"13663";34455;103;13663;6;37;43;6;0,365384615384615;0,423076923076923
"13664";34455;103;13664;6;39;45;6;0,384615384615385;0,442307692307692
"13665";34455;103;13665;6;53;61;8;0,519230769230769;0,596153846153846
"13666";34455;103;13666;6;53;63;10;0,519230769230769;0,615384615384615
"13667";34455;103;13667;6;55;61;6;0,538461538461538;0,596153846153846
"13668";34455;103;13668;6;59;65;6;0,576923076923077;0,634615384615385
"13669";34455;103;13669;6;63;71;8;0,615384615384615;0,692307692307692
"13670";34455;103;13670;6;67;73;6;0,653846153846154;0,711538461538462
"13671";34455;103;13671;6;81;87;6;0,788461538461538;0,846153846153846
"13672";34455;103;13672;6;97;103;6;0,942307692307692;1
"13673";34455;103;13673;6;31;37;6;0,307692307692308;0,365384615384615
"13674";34455;103;13674;6;83;89;6;0,807692307692308;0,865384615384615
"13675";34455;103;13675;6;25;31;6;0,25;0,307692307692308
"13676";34455;103;13676;6;43;51;8;0,423076923076923;0,5
"13677";34455;103;13677;6;45;51;6;0,442307692307692;0,5
"13678";34455;103;13678;6;57;63;6;0,557692307692308;0,615384615384615
"13679";34455;103;13679;6;65;71;6;0,634615384615385;0,692307692307692
"13680";34455;103;13680;6;69;75;6;0,673076923076923;0,730769230769231
"13681";34455;103;13681;6;91;99;8;0,884615384615385;0,961538461538462
"13682";34455;103;13682;6;91;101;10;0,884615384615385;0,980769230769231
"13683";34455;103;13683;6;93;101;8;0,903846153846154;0,980769230769231
"13684";34455;103;13684;6;29;35;6;0,288461538461538;0,346153846153846
"13685";34455;103;13685;6;23;29;6;0,230769230769231;0,288461538461538
"13686";34455;103;13686;6;55;63;8;0,538461538461538;0,615384615384615
"13687";34455;103;13687;6;83;91;8;0,807692307692308;0,884615384615385
"13688";34455;103;13688;6;93;103;10;0,903846153846154;1
"13689";34455;103;13689;6;95;101;6;0,923076923076923;0,980769230769231
"13690";34455;103;13690;6;95;103;8;0,923076923076923;1
"13691";34455;103;13691;6;91;103;12;0,884615384615385;1
"13692";34455;103;13692;6;63;73;10;0,615384615384615;0,711538461538462
"13693";34455;103;13693;6;61;69;8;0,596153846153846;0,673076923076923
"13694";34455;103;13694;6;61;71;10;0,596153846153846;0,692307692307692
"13695";34455;103;13695;6;71;77;6;0,692307692307692;0,75
"13696";34455;103;13696;6;73;79;6;0,711538461538462;0,769230769230769
"13697";34455;103;13697;6;79;85;6;0,769230769230769;0,826923076923077
"13698";34455;103;13698;6;81;89;8;0,788461538461538;0,865384615384615
"13699";34455;103;13699;6;81;91;10;0,788461538461538;0,884615384615385
"13700";34455;103;13700;6;57;65;8;0,557692307692308;0,634615384615385
"13701";34455;103;13701;6;59;67;8;0,576923076923077;0,653846153846154
"13702";34455;103;13702;6;21;27;6;0,211538461538462;0,269230769230769
"13703";34455;103;13703;6;1;7;6;0,0192307692307692;0,0769230769230769
"13704";34455;103;13704;6;77;83;6;0,75;0,807692307692308
"13705";34455;103;13705;6;87;93;6;0,846153846153846;0,903846153846154
"13706";34455;103;13706;6;27;33;6;0,269230769230769;0,326923076923077
"13707";34455;103;13707;6;85;93;8;0,826923076923077;0,903846153846154
"13708";5888;212;13708;3;106;212;106;0,5;1
"13709";5888;212;13709;4;130;179;49;0,615384615384615;0,846153846153846
"13710";5888;212;13710;4;146;196;50;0,692307692307692;0,923076923076923
"13711";5888;212;13711;4;114;163;49;0,538461538461538;0,769230769230769
"13712";5888;212;13712;4;97;146;49;0,461538461538462;0,692307692307692
"13713";5888;212;13713;5;114;138;24;0,538461538461538;0,653846153846154
"13714";5888;212;13714;5;7;32;25;0,0384615384615385;0,153846153846154
"13715";5888;212;13715;5;89;114;25;0,423076923076923;0,538461538461538
"13716";5888;212;13716;5;122;146;24;0,576923076923077;0,692307692307692
"13717";5888;212;13717;5;114;146;32;0,538461538461538;0,692307692307692
"13718";5888;212;13718;5;106;130;24;0,5;0,615384615384615
"13719";5888;212;13719;5;106;138;32;0,5;0,653846153846154
"13720";5888;212;13720;5;65;89;24;0,307692307692308;0,423076923076923
"13721";5888;212;13721;5;97;122;25;0,461538461538462;0,576923076923077
"13722";5888;212;13722;6;148;160;12;0,69811320754717;0,754716981132076
"13723";5888;212;13723;6;152;164;12;0,716981132075472;0,773584905660377
"13724";5888;212;13724;6;83;95;12;0,39622641509434;0,452830188679245
"13725";5888;212;13725;6;188;200;12;0,886792452830189;0,943396226415094
"13726";5888;212;13726;6;15;27;12;0,0754716981132075;0,132075471698113
"13727";5888;212;13727;6;19;31;12;0,0943396226415094;0,150943396226415
"13728";5888;212;13728;6;31;43;12;0,150943396226415;0,207547169811321
"13729";5888;212;13729;6;71;83;12;0,339622641509434;0,39622641509434
"13730";5888;212;13730;6;87;99;12;0,415094339622642;0,471698113207547
"13731";5888;212;13731;6;108;120;12;0,509433962264151;0,566037735849057
"13732";5888;212;13732;6;108;124;16;0,509433962264151;0,584905660377358
"13733";5888;212;13733;6;112;124;12;0,528301886792453;0,584905660377358
"13734";5888;212;13734;6;116;128;12;0,547169811320755;0,60377358490566
"13735";5888;212;13735;6;116;132;16;0,547169811320755;0,622641509433962
"13736";5888;212;13736;6;120;132;12;0,566037735849057;0,622641509433962
"13737";5888;212;13737;6;132;144;12;0,622641509433962;0,679245283018868
"13738";5888;212;13738;6;176;188;12;0,830188679245283;0,886792452830189
"13739";5888;212;13739;6;51;63;12;0,245283018867925;0,30188679245283
"13740";5888;212;13740;6;144;156;12;0,679245283018868;0,735849056603774
"13741";5888;212;13741;6;124;136;12;0,584905660377358;0,641509433962264
"13742";5888;212;13742;6;136;148;12;0,641509433962264;0,69811320754717
"13743";5888;212;13743;6;172;184;12;0,811320754716981;0,867924528301887
"13744";5888;212;13744;6;192;204;12;0,905660377358491;0,962264150943396
"13745";5888;212;13745;6;196;208;12;0,924528301886792;0,981132075471698
"13746";5888;212;13746;6;196;212;16;0,924528301886792;1
"13747";5888;212;13747;6;200;212;12;0,943396226415094;1
"13748";5888;212;13748;6;192;208;16;0,905660377358491;0,981132075471698
"13749";5888;212;13749;6;192;212;20;0,905660377358491;1
"13750";5888;212;13750;6;124;140;16;0,584905660377358;0,660377358490566
"13751";5888;212;13751;6;172;188;16;0,811320754716981;0,886792452830189
"13752";5888;212;13752;6;132;148;16;0,622641509433962;0,69811320754717
"13753";5888;212;13753;6;168;180;12;0,792452830188679;0,849056603773585
"13754";5888;212;13754;6;15;31;16;0,0754716981132075;0,150943396226415
"13755";5888;212;13755;6;112;128;16;0,528301886792453;0,60377358490566
"13756";5888;212;13756;6;47;59;12;0,226415094339623;0,283018867924528
"13757";5888;212;13757;6;75;87;12;0,358490566037736;0,415094339622642
"13758";5888;212;13758;6;108;128;20;0,509433962264151;0,60377358490566
"13759";5888;212;13759;6;19;35;16;0,0943396226415094;0,169811320754717
"13760";5888;212;13760;6;79;91;12;0,377358490566038;0,433962264150943
"13761";5888;212;13761;6;67;79;12;0,320754716981132;0,377358490566038
"13762";5888;212;13762;6;7;19;12;0,0377358490566038;0,0943396226415094
"13763";10372;107;13763;4;57;82;25;0,538461538461538;0,769230769230769
"13764";10372;107;13764;4;65;90;25;0,615384615384615;0,846153846153846
"13765";10372;107;13765;4;82;107;25;0,769230769230769;1
"13766";10372;107;13766;4;74;99;25;0,692307692307692;0,923076923076923
"13767";10372;107;13767;5;15;27;12;0,148148148148148;0,259259259259259
"13768";10372;107;13768;5;75;87;12;0,703703703703704;0,814814814814815
"13769";10372;107;13769;5;79;91;12;0,740740740740741;0,851851851851852
"13770";10372;107;13770;5;91;103;12;0,851851851851852;0,962962962962963
"13771";10372;107;13771;5;95;107;12;0,888888888888889;1
"13772";10372;107;13772;5;71;83;12;0,666666666666667;0,777777777777778
"13773";10372;107;13773;5;59;71;12;0,555555555555556;0,666666666666667
"13774";10372;107;13774;5;19;31;12;0,185185185185185;0,296296296296296
"13775";10372;107;13775;5;11;23;12;0,111111111111111;0,222222222222222
"13776";10372;107;13776;5;87;99;12;0,814814814814815;0,925925925925926
"13777";10372;107;13777;6;79;85;6;0,740740740740741;0,796296296296296
"13778";10372;107;13778;6;85;91;6;0,796296296296296;0,851851851851852
"13779";10372;107;13779;6;15;21;6;0,148148148148148;0,203703703703704
"13780";10372;107;13780;6;17;23;6;0,166666666666667;0,222222222222222
"13781";10372;107;13781;6;27;33;6;0,259259259259259;0,314814814814815
"13782";10372;107;13782;6;47;53;6;0,444444444444444;0,5
"13783";10372;107;13783;6;89;95;6;0,833333333333333;0,888888888888889
"13784";10372;107;13784;6;5;11;6;0,0555555555555556;0,111111111111111
"13785";10372;107;13785;6;7;13;6;0,0740740740740741;0,12962962962963
"13786";10372;107;13786;6;21;27;6;0,203703703703704;0,259259259259259
"13787";10372;107;13787;6;81;87;6;0,759259259259259;0,814814814814815
"13788";10372;107;13788;6;81;89;8;0,759259259259259;0,833333333333333
"13789";10372;107;13789;6;83;89;6;0,777777777777778;0,833333333333333
"13790";10372;107;13790;6;83;91;8;0,777777777777778;0,851851851851852
"13791";10372;107;13791;6;85;93;8;0,796296296296296;0,87037037037037
"13792";10372;107;13792;6;87;93;6;0,814814814814815;0,87037037037037
"13793";10372;107;13793;6;93;99;6;0,87037037037037;0,925925925925926
"13794";10372;107;13794;6;97;103;6;0,907407407407407;0,962962962962963
"13795";10372;107;13795;6;49;55;6;0,462962962962963;0,518518518518518
"13796";10372;107;13796;6;63;69;6;0,592592592592593;0,648148148148148
"13797";10372;107;13797;6;95;101;6;0,888888888888889;0,944444444444444
"13798";10372;107;13798;6;95;103;8;0,888888888888889;0,962962962962963
"13799";10372;107;13799;6;51;57;6;0,481481481481481;0,537037037037037
"13800";10372;107;13800;6;59;65;6;0,555555555555556;0,611111111111111
"13801";10372;107;13801;6;61;67;6;0,574074074074074;0,62962962962963
"13802";10372;107;13802;6;5;13;8;0,0555555555555556;0,12962962962963
"13803";10372;107;13803;6;13;19;6;0,12962962962963;0,185185185185185
"13804";10372;107;13804;6;19;25;6;0,185185185185185;0,240740740740741
"13805";10372;107;13805;6;47;55;8;0,444444444444444;0,518518518518518
"13806";10372;107;13806;6;47;57;10;0,444444444444444;0,537037037037037
"13807";10372;107;13807;6;91;97;6;0,851851851851852;0,907407407407407
"13808";10372;107;13808;6;99;105;6;0,925925925925926;0,981481481481482
"13809";10372;107;13809;6;19;27;8;0,185185185185185;0,259259259259259
"13810";10372;107;13810;6;17;25;8;0,166666666666667;0,240740740740741
"13811";10372;107;13811;6;93;101;8;0,87037037037037;0,944444444444444
"13812";10372;107;13812;6;97;105;8;0,907407407407407;0,981481481481482
"13813";10372;107;13813;6;3;9;6;0,037037037037037;0,0925925925925926
"13814";10372;107;13814;6;93;103;10;0,87037037037037;0,962962962962963
"13815";10372;107;13815;6;95;105;10;0,888888888888889;0,981481481481482
"13816";10372;107;13816;6;79;87;8;0,740740740740741;0,814814814814815
"13817";10372;107;13817;6;49;57;8;0,462962962962963;0,537037037037037
"13818";10372;107;13818;6;11;17;6;0,111111111111111;0,166666666666667
"13819";10372;107;13819;6;3;11;8;0,037037037037037;0,111111111111111
"13820";10372;107;13820;6;15;23;8;0,148148148148148;0,222222222222222
"13821";35799;64;13821;4;40;64;24;0,625;1
"13822";35799;64;13822;4;32;56;24;0,5;0,875
"13823";35799;64;13823;5;40;52;12;0,625;0,8125
"13824";35799;64;13824;5;23;36;13;0,375;0,5625
"13825";35799;64;13825;5;48;60;12;0,75;0,9375
"13826";35799;64;13826;5;40;56;16;0,625;0,875
"13827";35799;64;13827;5;40;60;20;0,625;0,9375
"13828";35799;64;13828;5;40;64;24;0,625;1
"13829";35799;64;13829;5;44;56;12;0,6875;0,875
"13830";35799;64;13830;5;48;64;16;0,75;1
"13831";35799;64;13831;5;52;64;12;0,8125;1
"13832";35799;64;13832;5;19;32;13;0,3125;0,5
"13833";35799;64;13833;5;36;48;12;0,5625;0,75
"13834";35799;64;13834;5;36;52;16;0,5625;0,8125
"13835";35799;64;13835;6;38;44;6;0,59375;0,6875
"13836";35799;64;13836;6;42;48;6;0,65625;0,75
"13837";35799;64;13837;6;52;58;6;0,8125;0,90625
"13838";35799;64;13838;6;38;46;8;0,59375;0,71875
"13839";35799;64;13839;6;38;48;10;0,59375;0,75
"13840";35799;64;13840;6;38;50;12;0,59375;0,78125
"13841";35799;64;13841;6;42;50;8;0,65625;0,78125
"13842";35799;64;13842;6;42;52;10;0,65625;0,8125
"13843";35799;64;13843;6;50;56;6;0,78125;0,875
"13844";35799;64;13844;6;50;58;8;0,78125;0,90625
"13845";35799;64;13845;6;52;60;8;0,8125;0,9375
"13846";35799;64;13846;6;58;64;6;0,90625;1
"13847";35799;64;13847;6;50;60;10;0,78125;0,9375
"13848";35799;64;13848;6;50;62;12;0,78125;0,96875
"13849";35799;64;13849;6;23;29;6;0,375;0,46875
"13850";35799;64;13850;6;38;52;14;0,59375;0,8125
"13851";35799;64;13851;6;52;62;10;0,8125;0,96875
"13852";35799;64;13852;6;25;32;7;0,40625;0,5
"13853";35799;64;13853;6;50;64;14;0,78125;1
"13854";35799;64;13854;6;38;54;16;0,59375;0,84375
"13855";35799;64;13855;6;38;56;18;0,59375;0,875
"13856";35799;64;13856;6;38;58;20;0,59375;0,90625
"13857";35799;64;13857;6;38;60;22;0,59375;0,9375
"13858";35799;64;13858;6;38;62;24;0,59375;0,96875
"13859";35799;64;13859;6;38;64;26;0,59375;1
"13860";35799;64;13860;6;52;64;12;0,8125;1
"13861";36952;76;13861;5;7;19;12;0,105263157894737;0,263157894736842
"13862";36952;76;13862;5;40;52;12;0,526315789473684;0,684210526315789
"13863";36952;76;13863;5;27;40;13;0,368421052631579;0,526315789473684
"13864";36952;76;13864;5;56;68;12;0,736842105263158;0,894736842105263
"13865";36952;76;13865;5;35;48;13;0,473684210526316;0,631578947368421
"13866";36952;76;13866;5;40;56;16;0,526315789473684;0,736842105263158
"13867";36952;76;13867;5;60;72;12;0,789473684210526;0,947368421052632
"13868";36952;76;13868;5;3;15;12;0,0526315789473684;0,210526315789474
"13869";36952;76;13869;5;3;19;16;0,0526315789473684;0,263157894736842
"13870";36952;76;13870;6;1;7;6;0,0263157894736842;0,105263157894737
"13871";36952;76;13871;6;9;15;6;0,131578947368421;0,210526315789474
"13872";36952;76;13872;6;29;35;6;0,394736842105263;0,473684210526316
"13873";36952;76;13873;6;40;46;6;0,526315789473684;0,605263157894737
"13874";36952;76;13874;6;58;64;6;0,763157894736842;0,842105263157895
"13875";36952;76;13875;6;60;66;6;0,789473684210526;0,868421052631579
"13876";36952;76;13876;6;62;68;6;0,815789473684211;0,894736842105263
"13877";36952;76;13877;6;70;76;6;0,921052631578947;1
"13878";36952;76;13878;6;1;9;8;0,0263157894736842;0,131578947368421
"13879";36952;76;13879;6;9;17;8;0,131578947368421;0,236842105263158
"13880";36952;76;13880;6;9;19;10;0,131578947368421;0,263157894736842
"13881";36952;76;13881;6;29;38;9;0,394736842105263;0,5
"13882";36952;76;13882;6;40;48;8;0,526315789473684;0,631578947368421
"13883";36952;76;13883;6;40;50;10;0,526315789473684;0,657894736842105
"13884";36952;76;13884;6;40;52;12;0,526315789473684;0,684210526315789
"13885";36952;76;13885;6;58;66;8;0,763157894736842;0,868421052631579
"13886";36952;76;13886;6;60;68;8;0,789473684210526;0,894736842105263
"13887";36952;76;13887;6;3;9;6;0,0526315789473684;0,131578947368421
"13888";36952;76;13888;6;40;54;14;0,526315789473684;0,710526315789474
"13889";36952;76;13889;6;58;68;10;0,763157894736842;0,894736842105263
"13890";36952;76;13890;6;58;70;12;0,763157894736842;0,921052631578947
"13891";36952;76;13891;6;60;70;10;0,789473684210526;0,921052631578947
"13892";36952;76;13892;6;62;70;8;0,815789473684211;0,921052631578947
"13893";36952;76;13893;6;38;44;6;0,5;0,578947368421053
"13894";36952;76;13894;6;38;46;8;0,5;0,605263157894737
"13895";36952;76;13895;6;38;48;10;0,5;0,631578947368421
"13896";36952;76;13896;6;38;50;12;0,5;0,657894736842105
"13897";36952;76;13897;6;38;52;14;0,5;0,684210526315789
"13898";36952;76;13898;6;38;54;16;0,5;0,710526315789474
"13899";37487;87;13899;3;17;69;52;0,2;0,8
"13900";37487;87;13900;4;15;39;24;0,181818181818182;0,454545454545455
"13901";37487;87;13901;4;39;63;24;0,454545454545455;0,727272727272727
"13902";37487;87;13902;4;15;47;32;0,181818181818182;0,545454545454545
"13903";37487;87;13903;4;31;55;24;0,363636363636364;0,636363636363636
"13904";37487;87;13904;4;15;55;40;0,181818181818182;0,636363636363636
"13905";37487;87;13905;4;31;63;32;0,363636363636364;0,727272727272727
"13906";37487;87;13906;4;23;47;24;0,272727272727273;0,545454545454545
"13907";37487;87;13907;4;31;71;40;0,363636363636364;0,818181818181818
"13908";37487;87;13908;4;39;71;32;0,454545454545455;0,818181818181818
"13909";37487;87;13909;4;23;55;32;0,272727272727273;0,636363636363636
"13910";37487;87;13910;4;7;31;24;0,0909090909090909;0,363636363636364
"13911";37487;87;13911;5;19;31;12;0,227272727272727;0,363636363636364
"13912";37487;87;13912;5;35;47;12;0,409090909090909;0,545454545454545
"13913";37487;87;13913;5;39;51;12;0,454545454545455;0,590909090909091
"13914";37487;87;13914;5;11;23;12;0,136363636363636;0,272727272727273
"13915";37487;87;13915;5;11;27;16;0,136363636363636;0,318181818181818
"13916";37487;87;13916;5;19;35;16;0,227272727272727;0,409090909090909
"13917";37487;87;13917;5;47;59;12;0,545454545454545;0,681818181818182
"13918";37487;87;13918;5;51;63;12;0,590909090909091;0,727272727272727
"13919";37487;87;13919;5;7;19;12;0,0909090909090909;0,227272727272727
"13920";37487;87;13920;5;11;31;20;0,136363636363636;0,363636363636364
"13921";37487;87;13921;5;11;35;24;0,136363636363636;0,409090909090909
"13922";37487;87;13922;5;15;27;12;0,181818181818182;0,318181818181818
"13923";37487;87;13923;5;15;31;16;0,181818181818182;0,363636363636364
"13924";37487;87;13924;5;15;35;20;0,181818181818182;0,409090909090909
"13925";37487;87;13925;5;35;51;16;0,409090909090909;0,590909090909091
"13926";37487;87;13926;5;35;55;20;0,409090909090909;0,636363636363636
"13927";37487;87;13927;5;35;59;24;0,409090909090909;0,681818181818182
"13928";37487;87;13928;5;35;63;28;0,409090909090909;0,727272727272727
"13929";37487;87;13929;5;39;55;16;0,454545454545455;0,636363636363636
"13930";37487;87;13930;5;39;59;20;0,454545454545455;0,681818181818182
"13931";37487;87;13931;5;39;63;24;0,454545454545455;0,727272727272727
"13932";37487;87;13932;5;47;63;16;0,545454545454545;0,727272727272727
"13933";37487;87;13933;5;75;87;12;0,863636363636364;1
"13934";37487;87;13934;5;39;67;28;0,454545454545455;0,772727272727273
"13935";37487;87;13935;5;35;67;32;0,409090909090909;0,772727272727273
"13936";37487;87;13936;5;35;71;36;0,409090909090909;0,818181818181818
"13937";37487;87;13937;6;19;25;6;0,227272727272727;0,295454545454545
"13938";37487;87;13938;6;37;43;6;0,431818181818182;0,5
"13939";37487;87;13939;6;63;69;6;0,727272727272727;0,795454545454545
"13940";37487;87;13940;6;63;71;8;0,727272727272727;0,818181818181818
"13941";37487;87;13941;6;65;71;6;0,75;0,818181818181818
"13942";37487;87;13942;6;75;81;6;0,863636363636364;0,931818181818182
"13943";37487;87;13943;6;9;15;6;0,113636363636364;0,181818181818182
"13944";37487;87;13944;6;9;17;8;0,113636363636364;0,204545454545455
"13945";37487;87;13945;6;9;19;10;0,113636363636364;0,227272727272727
"13946";37487;87;13946;6;9;21;12;0,113636363636364;0,25
"13947";37487;87;13947;6;17;23;6;0,204545454545455;0,272727272727273
"13948";37487;87;13948;6;17;25;8;0,204545454545455;0,295454545454545
"13949";37487;87;13949;6;17;27;10;0,204545454545455;0,318181818181818
"13950";37487;87;13950;6;19;27;8;0,227272727272727;0,318181818181818
"13951";37487;87;13951;6;19;29;10;0,227272727272727;0,340909090909091
"13952";37487;87;13952;6;19;31;12;0,227272727272727;0,363636363636364
"13953";37487;87;13953;6;19;33;14;0,227272727272727;0,386363636363636
"13954";37487;87;13954;6;35;41;6;0,409090909090909;0,477272727272727
"13955";37487;87;13955;6;35;43;8;0,409090909090909;0,5
"13956";37487;87;13956;6;35;45;10;0,409090909090909;0,522727272727273
"13957";37487;87;13957;6;35;47;12;0,409090909090909;0,545454545454545
"13958";37487;87;13958;6;35;49;14;0,409090909090909;0,568181818181818
"13959";37487;87;13959;6;37;45;8;0,431818181818182;0,522727272727273
"13960";37487;87;13960;6;37;47;10;0,431818181818182;0,545454545454545
"13961";37487;87;13961;6;37;49;12;0,431818181818182;0,568181818181818
"13962";37487;87;13962;6;49;55;6;0,568181818181818;0,636363636363636
"13963";37487;87;13963;6;49;57;8;0,568181818181818;0,659090909090909
"13964";37487;87;13964;6;51;57;6;0,590909090909091;0,659090909090909
"13965";37487;87;13965;6;51;59;8;0,590909090909091;0,681818181818182
"13966";37487;87;13966;6;73;79;6;0,840909090909091;0,909090909090909
"13967";37487;87;13967;6;75;83;8;0,863636363636364;0,954545454545455
"13968";37487;87;13968;6;75;85;10;0,863636363636364;0,977272727272727
"13969";37487;87;13969;6;75;87;12;0,863636363636364;1
"13970";37487;87;13970;6;77;83;6;0,886363636363636;0,954545454545455
"13971";37487;87;13971;6;77;85;8;0,886363636363636;0,977272727272727
"13972";37487;87;13972;6;9;23;14;0,113636363636364;0,272727272727273
"13973";37487;87;13973;6;9;25;16;0,113636363636364;0,295454545454545
"13974";37487;87;13974;6;19;35;16;0,227272727272727;0,409090909090909
"13975";37487;87;13975;6;47;53;6;0,545454545454545;0,613636363636364
"13976";37487;87;13976;6;47;55;8;0,545454545454545;0,636363636363636
"13977";37487;87;13977;6;47;57;10;0,545454545454545;0,659090909090909
"13978";37487;87;13978;6;47;59;12;0,545454545454545;0,681818181818182
"13979";37487;87;13979;6;49;59;10;0,568181818181818;0,681818181818182
"13980";37487;87;13980;6;49;61;12;0,568181818181818;0,704545454545455
"13981";37487;87;13981;6;49;63;14;0,568181818181818;0,727272727272727
"13982";37487;87;13982;6;51;61;10;0,590909090909091;0,704545454545455
"13983";37487;87;13983;6;51;63;12;0,590909090909091;0,727272727272727
"13984";37487;87;13984;6;73;81;8;0,840909090909091;0,931818181818182
"13985";37487;87;13985;6;73;83;10;0,840909090909091;0,954545454545455
"13986";37487;87;13986;6;9;27;18;0,113636363636364;0,318181818181818
"13987";37487;87;13987;6;9;29;20;0,113636363636364;0,340909090909091
"13988";37487;87;13988;6;9;31;22;0,113636363636364;0,363636363636364
"13989";37487;87;13989;6;9;33;24;0,113636363636364;0,386363636363636
"13990";37487;87;13990;6;9;35;26;0,113636363636364;0,409090909090909
"13991";37487;87;13991;6;17;29;12;0,204545454545455;0,340909090909091
"13992";37487;87;13992;6;17;31;14;0,204545454545455;0,363636363636364
"13993";37487;87;13993;6;17;33;16;0,204545454545455;0,386363636363636
"13994";37487;87;13994;6;17;35;18;0,204545454545455;0,409090909090909
"13995";37487;87;13995;6;35;51;16;0,409090909090909;0,590909090909091
"13996";37487;87;13996;6;35;53;18;0,409090909090909;0,613636363636364
"13997";37487;87;13997;6;35;55;20;0,409090909090909;0,636363636363636
"13998";37487;87;13998;6;35;57;22;0,409090909090909;0,659090909090909
"13999";37487;87;13999;6;37;51;14;0,431818181818182;0,590909090909091
"14000";37487;87;14000;6;37;53;16;0,431818181818182;0,613636363636364
"14001";37487;87;14001;6;37;55;18;0,431818181818182;0,636363636363636
"14002";37487;87;14002;6;37;57;20;0,431818181818182;0,659090909090909
"14003";37487;87;14003;6;37;59;22;0,431818181818182;0,681818181818182
"14004";37487;87;14004;6;73;85;12;0,840909090909091;0,977272727272727
"14005";37487;87;14005;6;73;87;14;0,840909090909091;1
"14006";37487;87;14006;6;77;87;10;0,886363636363636;1
"14007";37487;87;14007;6;37;61;24;0,431818181818182;0,704545454545455
"14008";37487;87;14008;6;35;59;24;0,409090909090909;0,681818181818182
"14009";37487;87;14009;6;35;61;26;0,409090909090909;0,704545454545455
"14010";37487;87;14010;6;7;13;6;0,0909090909090909;0,159090909090909
"14011";37487;87;14011;6;7;15;8;0,0909090909090909;0,181818181818182
"14012";37487;87;14012;6;47;61;14;0,545454545454545;0,704545454545455
"14013";37487;87;14013;6;47;63;16;0,545454545454545;0,727272727272727
"14014";40548;118;14014;4;8;33;25;0,0714285714285714;0,285714285714286
"14015";40548;118;14015;4;8;42;34;0,0714285714285714;0,357142857142857
"14016";40548;118;14016;4;8;50;42;0,0714285714285714;0,428571428571429
"14017";40548;118;14017;4;58;84;26;0,5;0,714285714285714
"14018";40548;118;14018;4;84;110;26;0,714285714285714;0,928571428571429
"14019";40548;118;14019;5;11;24;13;0,103448275862069;0,206896551724138
"14020";40548;118;14020;5;11;28;17;0,103448275862069;0,241379310344828
"14021";40548;118;14021;5;11;32;21;0,103448275862069;0,275862068965517
"14022";40548;118;14022;5;11;36;25;0,103448275862069;0,310344827586207
"14023";40548;118;14023;5;11;40;29;0,103448275862069;0,344827586206897
"14024";40548;118;14024;5;11;44;33;0,103448275862069;0,379310344827586
"14025";40548;118;14025;5;11;48;37;0,103448275862069;0,413793103448276
"14026";40548;118;14026;5;11;52;41;0,103448275862069;0,448275862068966
"14027";40548;118;14027;5;11;56;45;0,103448275862069;0,482758620689655
"14028";40548;118;14028;5;65;77;12;0,551724137931034;0,655172413793103
"14029";40548;118;14029;5;65;81;16;0,551724137931034;0,689655172413793
"14030";40548;118;14030;5;69;81;12;0,586206896551724;0,689655172413793
"14031";40548;118;14031;5;69;85;16;0,586206896551724;0,724137931034483
"14032";40548;118;14032;5;93;106;13;0,793103448275862;0,896551724137931
"14033";40548;118;14033;5;65;85;20;0,551724137931034;0,724137931034483
"14034";40548;118;14034;5;85;97;12;0,724137931034483;0,827586206896552
"14035";40548;118;14035;5;89;102;13;0,758620689655172;0,862068965517241
"14036";40548;118;14036;5;89;106;17;0,758620689655172;0,896551724137931
"14037";40548;118;14037;5;97;110;13;0,827586206896552;0,931034482758621
"14038";40548;118;14038;5;106;118;12;0,896551724137931;1
"14039";40548;118;14039;5;61;73;12;0,517241379310345;0,620689655172414
"14040";40548;118;14040;5;61;77;16;0,517241379310345;0,655172413793103
"14041";40548;118;14041;5;102;114;12;0,862068965517241;0,96551724137931
"14042";40548;118;14042;6;5;11;6;0,0508474576271186;0,101694915254237
"14043";40548;118;14043;6;13;19;6;0,11864406779661;0,169491525423729
"14044";40548;118;14044;6;13;21;8;0,11864406779661;0,186440677966102
"14045";40548;118;14045;6;13;23;10;0,11864406779661;0,203389830508475
"14046";40548;118;14046;6;13;25;12;0,11864406779661;0,220338983050847
"14047";40548;118;14047;6;13;27;14;0,11864406779661;0,23728813559322
"14048";40548;118;14048;6;13;29;16;0,11864406779661;0,254237288135593
"14049";40548;118;14049;6;13;31;18;0,11864406779661;0,271186440677966
"14050";40548;118;14050;6;13;33;20;0,11864406779661;0,288135593220339
"14051";40548;118;14051;6;13;35;22;0,11864406779661;0,305084745762712
"14052";40548;118;14052;6;62;68;6;0,525423728813559;0,576271186440678
"14053";40548;118;14053;6;62;70;8;0,525423728813559;0,593220338983051
"14054";40548;118;14054;6;66;72;6;0,559322033898305;0,610169491525424
"14055";40548;118;14055;6;66;74;8;0,559322033898305;0,627118644067797
"14056";40548;118;14056;6;68;74;6;0,576271186440678;0,627118644067797
"14057";40548;118;14057;6;78;84;6;0,661016949152542;0,711864406779661
"14058";40548;118;14058;6;78;86;8;0,661016949152542;0,728813559322034
"14059";40548;118;14059;6;80;86;6;0,677966101694915;0,728813559322034
"14060";40548;118;14060;6;96;102;6;0,813559322033898;0,864406779661017
"14061";40548;118;14061;6;62;72;10;0,525423728813559;0,610169491525424
"14062";40548;118;14062;6;64;70;6;0,542372881355932;0,593220338983051
"14063";40548;118;14063;6;64;72;8;0,542372881355932;0,610169491525424
"14064";40548;118;14064;6;66;76;10;0,559322033898305;0,644067796610169
"14065";40548;118;14065;6;90;96;6;0,76271186440678;0,813559322033898
"14066";40548;118;14066;6;70;76;6;0,593220338983051;0,644067796610169
"14067";40548;118;14067;6;72;78;6;0,610169491525424;0,661016949152542
"14068";40548;118;14068;6;66;78;12;0,559322033898305;0,661016949152542
"14069";40548;118;14069;6;68;76;8;0,576271186440678;0,644067796610169
"14070";40548;118;14070;6;68;78;10;0,576271186440678;0,661016949152542
"14071";40548;118;14071;6;68;80;12;0,576271186440678;0,677966101694915
"14072";40548;118;14072;6;70;78;8;0,593220338983051;0,661016949152542
"14073";40548;118;14073;6;70;80;10;0,593220338983051;0,677966101694915
"14074";40548;118;14074;6;72;80;8;0,610169491525424;0,677966101694915
"14075";40548;118;14075;6;72;82;10;0,610169491525424;0,694915254237288
"14076";40548;118;14076;6;13;37;24;0,11864406779661;0,322033898305085
"14077";40548;118;14077;6;13;39;26;0,11864406779661;0,338983050847458
"14078";40548;118;14078;6;13;41;28;0,11864406779661;0,355932203389831
"14079";40548;118;14079;6;13;43;30;0,11864406779661;0,372881355932203
"14080";40548;118;14080;6;13;45;32;0,11864406779661;0,389830508474576
"14081";40548;118;14081;6;13;47;34;0,11864406779661;0,406779661016949
"14082";40548;118;14082;6;108;114;6;0,915254237288136;0,966101694915254
"14083";40548;118;14083;6;60;66;6;0,508474576271186;0,559322033898305
"14084";40548;118;14084;6;94;100;6;0,796610169491525;0,847457627118644
"14085";40548;118;14085;6;94;102;8;0,796610169491525;0,864406779661017
"14086";40548;118;14086;6;5;13;8;0,0508474576271186;0,11864406779661
"14087";40548;118;14087;6;66;80;14;0,559322033898305;0,677966101694915
"14088";40548;118;14088;6;92;98;6;0,779661016949153;0,830508474576271
"14089";40548;118;14089;6;100;106;6;0,847457627118644;0,898305084745763
"14090";40548;118;14090;6;64;74;10;0,542372881355932;0,627118644067797
"14091";40548;118;14091;6;88;94;6;0,745762711864407;0,796610169491525
"14092";40548;118;14092;6;112;118;6;0,949152542372881;1
"14093";40548;118;14093;6;98;104;6;0,830508474576271;0,88135593220339
"14094";40548;118;14094;6;102;108;6;0,864406779661017;0,915254237288136
"14095";40548;118;14095;6;64;76;12;0,542372881355932;0,644067796610169
"14096";40548;118;14096;6;64;78;14;0,542372881355932;0,661016949152542
"14097";40548;118;14097;6;86;92;6;0,728813559322034;0,779661016949153
"14098";40548;118;14098;6;62;74;12;0,525423728813559;0,627118644067797
"14099";40548;118;14099;6;62;76;14;0,525423728813559;0,644067796610169
"14100";40548;118;14100;6;62;78;16;0,525423728813559;0,661016949152542
"14101";40548;118;14101;6;62;80;18;0,525423728813559;0,677966101694915
"14102";40548;118;14102;6;62;82;20;0,525423728813559;0,694915254237288
"14103";40548;118;14103;6;64;80;16;0,542372881355932;0,677966101694915
"14104";40548;118;14104;6;64;82;18;0,542372881355932;0,694915254237288
"14105";40548;118;14105;6;66;82;16;0,559322033898305;0,694915254237288
"14106";40548;118;14106;6;66;84;18;0,559322033898305;0,711864406779661
"14107";40548;118;14107;6;68;82;14;0,576271186440678;0,694915254237288
"14108";40548;118;14108;6;70;82;12;0,593220338983051;0,694915254237288
"14109";40548;118;14109;6;70;84;14;0,593220338983051;0,711864406779661
"14110";40548;118;14110;6;72;84;12;0,610169491525424;0,711864406779661
"14111";40548;118;14111;6;98;106;8;0,830508474576271;0,898305084745763
"14112";40548;118;14112;6;74;80;6;0,627118644067797;0,677966101694915
"14113";40548;118;14113;6;76;82;6;0,644067796610169;0,694915254237288
"14114";40548;118;14114;6;88;96;8;0,745762711864407;0,813559322033898
"14115";40548;118;14115;6;96;104;8;0,813559322033898;0,88135593220339
"14116";40548;118;14116;6;92;100;8;0,779661016949153;0,847457627118644
"14117";40548;118;14117;6;96;106;10;0,813559322033898;0,898305084745763
"14118";41745;100;14118;3;50;100;50;0,5;1
"14119";41745;100;14119;4;58;83;25;0,583333333333333;0,833333333333333
"14120";41745;100;14120;4;58;92;34;0,583333333333333;0,916666666666667
"14121";41745;100;14121;4;58;100;42;0,583333333333333;1
"14122";41745;100;14122;4;75;100;25;0,75;1
"14123";41745;100;14123;5;60;72;12;0,6;0,72
"14124";41745;100;14124;5;60;76;16;0,6;0,76
"14125";41745;100;14125;5;60;80;20;0,6;0,8
"14126";41745;100;14126;5;76;88;12;0,76;0,88
"14127";41745;100;14127;5;80;92;12;0,8;0,92
"14128";41745;100;14128;5;80;96;16;0,8;0,96
"14129";41745;100;14129;5;80;100;20;0,8;1
"14130";41745;100;14130;5;76;92;16;0,76;0,92
"14131";41745;100;14131;5;76;96;20;0,76;0,96
"14132";41745;100;14132;5;43;56;13;0,44;0,56
"14133";41745;100;14133;5;60;84;24;0,6;0,84
"14134";41745;100;14134;5;60;88;28;0,6;0,88
"14135";41745;100;14135;5;60;92;32;0,6;0,92
"14136";41745;100;14136;5;60;96;36;0,6;0,96
"14137";41745;100;14137;5;60;100;40;0,6;1
"14138";41745;100;14138;5;76;100;24;0,76;1
"14139";41745;100;14139;5;3;15;12;0,04;0,16
"14140";41745;100;14140;6;7;13;6;0,08;0,14
"14141";41745;100;14141;6;60;66;6;0,6;0,66
"14142";41745;100;14142;6;60;68;8;0,6;0,68
"14143";41745;100;14143;6;60;70;10;0,6;0,7
"14144";41745;100;14144;6;78;84;6;0,78;0,84
"14145";41745;100;14145;6;78;86;8;0,78;0,86
"14146";41745;100;14146;6;78;88;10;0,78;0,88
"14147";41745;100;14147;6;41;47;6;0,42;0,48
"14148";41745;100;14148;6;60;72;12;0,6;0,72
"14149";41745;100;14149;6;60;74;14;0,6;0,74
"14150";41745;100;14150;6;60;76;16;0,6;0,76
"14151";41745;100;14151;6;60;78;18;0,6;0,78
"14152";41745;100;14152;6;60;80;20;0,6;0,8
"14153";41745;100;14153;6;78;90;12;0,78;0,9
"14154";41745;100;14154;6;78;92;14;0,78;0,92
"14155";41745;100;14155;6;78;94;16;0,78;0,94
"14156";41745;100;14156;6;78;96;18;0,78;0,96
"14157";41745;100;14157;6;78;98;20;0,78;0,98
"14158";41745;100;14158;6;15;21;6;0,16;0,22
"14159";41745;100;14159;6;60;82;22;0,6;0,82
"14160";41745;100;14160;6;5;11;6;0,06;0,12
"14161";41745;100;14161;6;41;50;9;0,42;0,5
"14162";41745;100;14162;6;19;25;6;0,2;0,26
"14163";41745;100;14163;6;78;100;22;0,78;1
"14164";41745;100;14164;6;13;19;6;0,14;0,2
"14165";41745;100;14165;6;58;64;6;0,58;0,64
"14166";41745;100;14166;6;58;66;8;0,58;0,66
"14167";41745;100;14167;6;5;13;8;0,06;0,14
"14168";41745;100;14168;6;41;52;11;0,42;0,52
"14169";41745;100;14169;6;41;54;13;0,42;0,54
"14170";41745;100;14170;6;41;56;15;0,42;0,56
"14171";41745;100;14171;6;60;84;24;0,6;0,84
"14172";41745;100;14172;6;60;86;26;0,6;0,86
"14173";41745;100;14173;6;60;88;28;0,6;0,88
"14174";41745;100;14174;6;60;90;30;0,6;0,9
"14175";41745;100;14175;6;39;45;6;0,4;0,46
"14176";41745;100;14176;6;39;47;8;0,4;0,48
"14177";41745;100;14177;6;39;50;11;0,4;0,5
"14178";41745;100;14178;6;41;58;17;0,42;0,58
"14179";41745;100;14179;6;3;9;6;0,04;0,1
"14180";43572;83;14180;4;41;66;25;0,5;0,8
"14181";43572;83;14181;4;41;75;34;0,5;0,9
"14182";43572;83;14182;4;49;75;26;0,6;0,9
"14183";43572;83;14183;4;33;58;25;0,4;0,7
"14184";43572;83;14184;5;47;59;12;0,571428571428571;0,714285714285714
"14185";43572;83;14185;5;55;67;12;0,666666666666667;0,80952380952381
"14186";43572;83;14186;5;55;71;16;0,666666666666667;0,857142857142857
"14187";43572;83;14187;5;59;71;12;0,714285714285714;0,857142857142857
"14188";43572;83;14188;5;27;39;12;0,333333333333333;0,476190476190476
"14189";43572;83;14189;5;47;63;16;0,571428571428571;0,761904761904762
"14190";43572;83;14190;5;11;23;12;0,142857142857143;0,285714285714286
"14191";43572;83;14191;5;11;27;16;0,142857142857143;0,333333333333333
"14192";43572;83;14192;5;47;67;20;0,571428571428571;0,80952380952381
"14193";43572;83;14193;5;47;71;24;0,571428571428571;0,857142857142857
"14194";43572;83;14194;5;51;63;12;0,619047619047619;0,761904761904762
"14195";43572;83;14195;5;51;67;16;0,619047619047619;0,80952380952381
"14196";43572;83;14196;5;51;71;20;0,619047619047619;0,857142857142857
"14197";43572;83;14197;5;55;75;20;0,666666666666667;0,904761904761905
"14198";43572;83;14198;5;59;75;16;0,714285714285714;0,904761904761905
"14199";43572;83;14199;5;63;75;12;0,761904761904762;0,904761904761905
"14200";43572;83;14200;5;43;55;12;0,523809523809524;0,666666666666667
"14201";43572;83;14201;5;39;51;12;0,476190476190476;0,619047619047619
"14202";43572;83;14202;5;39;55;16;0,476190476190476;0,666666666666667
"14203";43572;83;14203;5;35;47;12;0,428571428571429;0,571428571428571
"14204";43572;83;14204;5;31;43;12;0,380952380952381;0,523809523809524
"14205";43572;83;14205;5;47;75;28;0,571428571428571;0,904761904761905
"14206";43572;83;14206;5;43;59;16;0,523809523809524;0,714285714285714
"14207";43572;83;14207;5;43;63;20;0,523809523809524;0,761904761904762
"14208";43572;83;14208;5;43;67;24;0,523809523809524;0,80952380952381
"14209";43572;83;14209;5;43;71;28;0,523809523809524;0,857142857142857
"14210";43572;83;14210;6;11;17;6;0,142857142857143;0,214285714285714
"14211";43572;83;14211;6;57;63;6;0,69047619047619;0,761904761904762
"14212";43572;83;14212;6;65;71;6;0,785714285714286;0,857142857142857
"14213";43572;83;14213;6;67;73;6;0,80952380952381;0,880952380952381
"14214";43572;83;14214;6;11;19;8;0,142857142857143;0,238095238095238
"14215";43572;83;14215;6;11;21;10;0,142857142857143;0,261904761904762
"14216";43572;83;14216;6;11;23;12;0,142857142857143;0,285714285714286
"14217";43572;83;14217;6;45;51;6;0,547619047619048;0,619047619047619
"14218";43572;83;14218;6;49;55;6;0,595238095238095;0,666666666666667
"14219";43572;83;14219;6;51;57;6;0,619047619047619;0,69047619047619
"14220";43572;83;14220;6;51;59;8;0,619047619047619;0,714285714285714
"14221";43572;83;14221;6;51;61;10;0,619047619047619;0,738095238095238
"14222";43572;83;14222;6;51;63;12;0,619047619047619;0,761904761904762
"14223";43572;83;14223;6;55;61;6;0,666666666666667;0,738095238095238
"14224";43572;83;14224;6;55;63;8;0,666666666666667;0,761904761904762
"14225";43572;83;14225;6;55;65;10;0,666666666666667;0,785714285714286
"14226";43572;83;14226;6;57;65;8;0,69047619047619;0,785714285714286
"14227";43572;83;14227;6;57;67;10;0,69047619047619;0,80952380952381
"14228";43572;83;14228;6;57;69;12;0,69047619047619;0,833333333333333
"14229";43572;83;14229;6;65;73;8;0,785714285714286;0,880952380952381
"14230";43572;83;14230;6;75;81;6;0,904761904761905;0,976190476190476
"14231";43572;83;14231;6;75;83;8;0,904761904761905;1
"14232";43572;83;14232;6;11;25;14;0,142857142857143;0,30952380952381
"14233";43572;83;14233;6;11;27;16;0,142857142857143;0,333333333333333
"14234";43572;83;14234;6;27;33;6;0,333333333333333;0,404761904761905
"14235";43572;83;14235;6;45;53;8;0,547619047619048;0,642857142857143
"14236";43572;83;14236;6;45;55;10;0,547619047619048;0,666666666666667
"14237";43572;83;14237;6;45;57;12;0,547619047619048;0,69047619047619
"14238";43572;83;14238;6;45;59;14;0,547619047619048;0,714285714285714
"14239";43572;83;14239;6;45;61;16;0,547619047619048;0,738095238095238
"14240";43572;83;14240;6;55;67;12;0,666666666666667;0,80952380952381
"14241";43572;83;14241;6;55;69;14;0,666666666666667;0,833333333333333
"14242";43572;83;14242;6;55;71;16;0,666666666666667;0,857142857142857
"14243";43572;83;14243;6;39;45;6;0,476190476190476;0,547619047619048
"14244";43572;83;14244;6;57;71;14;0,69047619047619;0,857142857142857
"14245";43572;83;14245;6;57;73;16;0,69047619047619;0,880952380952381
"14246";43572;83;14246;6;41;47;6;0,5;0,571428571428571
"14247";43572;83;14247;6;51;65;14;0,619047619047619;0,785714285714286
"14248";43572;83;14248;6;55;73;18;0,666666666666667;0,880952380952381
"14249";43572;83;14249;6;45;63;18;0,547619047619048;0,761904761904762
"14250";43572;83;14250;6;45;65;20;0,547619047619048;0,785714285714286
"14251";43572;83;14251;6;45;67;22;0,547619047619048;0,80952380952381
"14252";43572;83;14252;6;45;69;24;0,547619047619048;0,833333333333333
"14253";43572;83;14253;6;45;71;26;0,547619047619048;0,857142857142857
"14254";43572;83;14254;6;45;73;28;0,547619047619048;0,880952380952381
"14255";43572;83;14255;6;33;39;6;0,404761904761905;0,476190476190476
"14256";46139;77;14256;5;65;77;12;0,842105263157895;1
"14257";46139;77;14257;5;11;24;13;0,157894736842105;0,315789473684211
"14258";46139;77;14258;5;36;48;12;0,473684210526316;0,631578947368421
"14259";46139;77;14259;6;71;77;6;0,923076923076923;1
"14260";46139;77;14260;6;39;45;6;0,512820512820513;0,58974358974359
"14261";46139;77;14261;6;65;71;6;0,846153846153846;0,923076923076923
"14262";46139;77;14262;6;67;73;6;0,871794871794872;0,948717948717949
"14263";46139;77;14263;6;67;75;8;0,871794871794872;0,974358974358974
"14264";46139;77;14264;6;37;43;6;0,487179487179487;0,564102564102564
"14265";46139;77;14265;6;3;9;6;0,0512820512820513;0,128205128205128
"14266";46139;77;14266;6;3;11;8;0,0512820512820513;0,153846153846154
"14267";46139;77;14267;6;41;47;6;0,538461538461538;0,615384615384615
"14268";46139;77;14268;6;65;73;8;0,846153846153846;0,948717948717949
"14269";46139;77;14269;6;69;75;6;0,897435897435897;0,974358974358974
"14270";46139;77;14270;6;69;77;8;0,897435897435897;1
"14271";46139;77;14271;6;67;77;10;0,871794871794872;1
"14272";46139;77;14272;6;35;41;6;0,461538461538462;0,538461538461538
"14273";46139;77;14273;6;59;65;6;0,769230769230769;0,846153846153846
"14274";46139;77;14274;6;1;7;6;0,0256410256410256;0,102564102564103
"14275";46139;77;14275;6;1;9;8;0,0256410256410256;0,128205128205128
"14276";46139;77;14276;6;1;11;10;0,0256410256410256;0,153846153846154
"14277";46139;77;14277;6;53;59;6;0,692307692307692;0,769230769230769
"14278";46139;77;14278;6;63;69;6;0,82051282051282;0,897435897435897
"14279";46139;77;14279;6;33;39;6;0,435897435897436;0,512820512820513
"14280";46139;77;14280;6;37;45;8;0,487179487179487;0,58974358974359
"14281";46139;77;14281;6;43;49;6;0,564102564102564;0,641025641025641
"14282";46139;77;14282;6;39;47;8;0,512820512820513;0,615384615384615
"14283";46370;59;14283;3;33;59;26;0,571428571428571;1
"14284";46370;59;14284;3;8;33;25;0,142857142857143;0,571428571428571
"14285";46370;59;14285;3;16;42;26;0,285714285714286;0,714285714285714
"14286";46370;59;14286;4;3;15;12;0,0666666666666667;0,266666666666667
"14287";46370;59;14287;4;7;19;12;0,133333333333333;0,333333333333333
"14288";46370;59;14288;4;19;31;12;0,333333333333333;0,533333333333333
"14289";46370;59;14289;4;23;35;12;0,4;0,6
"14290";46370;59;14290;4;39;51;12;0,666666666666667;0,866666666666667
"14291";46370;59;14291;4;39;55;16;0,666666666666667;0,933333333333333
"14292";46370;59;14292;4;39;59;20;0,666666666666667;1
"14293";46370;59;14293;4;27;39;12;0,466666666666667;0,666666666666667
"14294";46370;59;14294;4;15;27;12;0,266666666666667;0,466666666666667
"14295";46370;59;14295;4;19;35;16;0,333333333333333;0,6
"14296";46370;59;14296;4;11;23;12;0,2;0,4
"14297";46370;59;14297;5;5;11;6;0,1;0,2
"14298";46370;59;14298;5;5;13;8;0,1;0,233333333333333
"14299";46370;59;14299;5;17;23;6;0,3;0,4
"14300";46370;59;14300;5;23;29;6;0,4;0,5
"14301";46370;59;14301;5;39;45;6;0,666666666666667;0,766666666666667
"14302";46370;59;14302;5;39;47;8;0,666666666666667;0,8
"14303";46370;59;14303;5;39;49;10;0,666666666666667;0,833333333333333
"14304";46370;59;14304;5;53;59;6;0,9;1
"14305";46370;59;14305;5;7;13;6;0,133333333333333;0,233333333333333
"14306";46370;59;14306;5;15;21;6;0,266666666666667;0,366666666666667
"14307";46370;59;14307;5;15;23;8;0,266666666666667;0,4
"14308";46370;59;14308;5;27;33;6;0,466666666666667;0,566666666666667
"14309";46370;59;14309;5;31;37;6;0,533333333333333;0,633333333333333
"14310";46370;59;14310;5;25;31;6;0,433333333333333;0,533333333333333
"14311";46370;59;14311;5;13;19;6;0,233333333333333;0,333333333333333
"14312";46370;59;14312;5;13;21;8;0,233333333333333;0,366666666666667
"14313";46370;59;14313;5;17;25;8;0,3;0,433333333333333
"14314";46370;59;14314;5;21;27;6;0,366666666666667;0,466666666666667
"14315";46370;59;14315;5;27;35;8;0,466666666666667;0,6
"14316";46370;59;14316;5;27;37;10;0,466666666666667;0,633333333333333
"14317";46370;59;14317;5;19;25;6;0,333333333333333;0,433333333333333
"14318";46370;59;14318;5;25;33;8;0,433333333333333;0,566666666666667
"14319";46370;59;14319;5;39;51;12;0,666666666666667;0,866666666666667
"14320";46370;59;14320;5;39;53;14;0,666666666666667;0,9
"14321";46370;59;14321;5;25;35;10;0,433333333333333;0,6
"14322";46370;59;14322;5;3;9;6;0,0666666666666667;0,166666666666667
"14323";46370;59;14323;5;39;55;16;0,666666666666667;0,933333333333333
"14324";46370;59;14324;5;39;57;18;0,666666666666667;0,966666666666667
"14325";46370;59;14325;5;39;59;20;0,666666666666667;1
"14326";46370;59;14326;5;31;39;8;0,533333333333333;0,666666666666667
"14327";46370;59;14327;5;23;31;8;0,4;0,533333333333333
"14328";46370;59;14328;5;1;7;6;0,0333333333333333;0,133333333333333
"14329";46370;59;14329;5;1;9;8;0,0333333333333333;0,166666666666667
"14330";46370;59;14330;5;25;37;12;0,433333333333333;0,633333333333333
"14331";48277;51;14331;3;8;34;26;0,166666666666667;0,666666666666667
"14332";48277;51;14332;3;8;42;34;0,166666666666667;0,833333333333333
"14333";48277;51;14333;3;8;51;43;0,166666666666667;1
"14334";48277;51;14334;3;16;42;26;0,333333333333333;0,833333333333333
"14335";48277;51;14335;3;16;51;35;0,333333333333333;1
"14336";48277;51;14336;3;25;51;26;0,5;1
"14337";48277;51;14337;4;7;19;12;0,153846153846154;0,384615384615385
"14338";48277;51;14338;4;11;23;12;0,230769230769231;0,461538461538462
"14339";48277;51;14339;4;11;27;16;0,230769230769231;0,538461538461538
"14340";48277;51;14340;4;23;35;12;0,461538461538462;0,692307692307692
"14341";48277;51;14341;4;23;39;16;0,461538461538462;0,769230769230769
"14342";48277;51;14342;4;23;43;20;0,461538461538462;0,846153846153846
"14343";48277;51;14343;4;27;39;12;0,538461538461538;0,769230769230769
"14344";48277;51;14344;4;27;43;16;0,538461538461538;0,846153846153846
"14345";48277;51;14345;4;27;47;20;0,538461538461538;0,923076923076923
"14346";48277;51;14346;4;31;43;12;0,615384615384615;0,846153846153846
"14347";48277;51;14347;4;35;47;12;0,692307692307692;0,923076923076923
"14348";48277;51;14348;4;7;23;16;0,153846153846154;0,461538461538462
"14349";48277;51;14349;4;7;27;20;0,153846153846154;0,538461538461538
"14350";48277;51;14350;4;7;31;24;0,153846153846154;0,615384615384615
"14351";48277;51;14351;4;11;31;20;0,230769230769231;0,615384615384615
"14352";48277;51;14352;4;15;27;12;0,307692307692308;0,538461538461538
"14353";48277;51;14353;4;15;31;16;0,307692307692308;0,615384615384615
"14354";48277;51;14354;4;15;35;20;0,307692307692308;0,692307692307692
"14355";48277;51;14355;4;19;31;12;0,384615384615385;0,615384615384615
"14356";48277;51;14356;4;19;35;16;0,384615384615385;0,692307692307692
"14357";48277;51;14357;4;23;47;24;0,461538461538462;0,923076923076923
"14358";48277;51;14358;4;3;15;12;0,0769230769230769;0,307692307692308
"14359";48277;51;14359;4;3;19;16;0,0769230769230769;0,384615384615385
"14360";48277;51;14360;4;3;23;20;0,0769230769230769;0,461538461538462
"14361";48277;51;14361;4;7;35;28;0,153846153846154;0,692307692307692
"14362";48277;51;14362;4;7;39;32;0,153846153846154;0,769230769230769
"14363";48277;51;14363;4;7;43;36;0,153846153846154;0,846153846153846
"14364";48277;51;14364;4;19;39;20;0,384615384615385;0,769230769230769
"14365";48277;51;14365;4;19;43;24;0,384615384615385;0,846153846153846
"14366";48277;51;14366;4;19;47;28;0,384615384615385;0,923076923076923
"14367";48277;51;14367;4;19;51;32;0,384615384615385;1
"14368";48277;51;14368;4;23;51;28;0,461538461538462;1
"14369";48277;51;14369;4;27;51;24;0,538461538461538;1
"14370";48277;51;14370;4;31;47;16;0,615384615384615;0,923076923076923
"14371";48277;51;14371;4;31;51;20;0,615384615384615;1
"14372";48277;51;14372;4;35;51;16;0,692307692307692;1
"14373";48277;51;14373;4;39;51;12;0,769230769230769;1
"14374";48277;51;14374;4;15;39;24;0,307692307692308;0,769230769230769
"14375";48277;51;14375;4;11;35;24;0,230769230769231;0,692307692307692
"14376";48277;51;14376;4;11;39;28;0,230769230769231;0,769230769230769
"14377";48277;51;14377;5;3;9;6;0,0769230769230769;0,192307692307692
"14378";48277;51;14378;5;3;11;8;0,0769230769230769;0,230769230769231
"14379";48277;51;14379;5;3;13;10;0,0769230769230769;0,269230769230769
"14380";48277;51;14380;5;5;11;6;0,115384615384615;0,230769230769231
"14381";48277;51;14381;5;7;13;6;0,153846153846154;0,269230769230769
"14382";48277;51;14382;5;9;15;6;0,192307692307692;0,307692307692308
"14383";48277;51;14383;5;9;17;8;0,192307692307692;0,346153846153846
"14384";48277;51;14384;5;9;19;10;0,192307692307692;0,384615384615385
"14385";48277;51;14385;5;11;17;6;0,230769230769231;0,346153846153846
"14386";48277;51;14386;5;11;19;8;0,230769230769231;0,384615384615385
"14387";48277;51;14387;5;13;19;6;0,269230769230769;0,384615384615385
"14388";48277;51;14388;5;19;25;6;0,384615384615385;0,5
"14389";48277;51;14389;5;23;29;6;0,461538461538462;0,576923076923077
"14390";48277;51;14390;5;25;31;6;0,5;0,615384615384615
"14391";48277;51;14391;5;29;35;6;0,576923076923077;0,692307692307692
"14392";48277;51;14392;5;29;37;8;0,576923076923077;0,730769230769231
"14393";48277;51;14393;5;29;39;10;0,576923076923077;0,769230769230769
"14394";48277;51;14394;5;31;37;6;0,615384615384615;0,730769230769231
"14395";48277;51;14395;5;35;41;6;0,692307692307692;0,807692307692308
"14396";48277;51;14396;5;37;43;6;0,730769230769231;0,846153846153846
"14397";48277;51;14397;5;45;51;6;0,884615384615385;1
"14398";48277;51;14398;5;1;7;6;0,0384615384615385;0,153846153846154
"14399";48277;51;14399;5;1;9;8;0,0384615384615385;0,192307692307692
"14400";48277;51;14400;5;1;11;10;0,0384615384615385;0,230769230769231
"14401";48277;51;14401;5;3;15;12;0,0769230769230769;0,307692307692308
"14402";48277;51;14402;5;3;17;14;0,0769230769230769;0,346153846153846
"14403";48277;51;14403;5;5;13;8;0,115384615384615;0,269230769230769
"14404";48277;51;14404;5;5;15;10;0,115384615384615;0,307692307692308
"14405";48277;51;14405;5;7;15;8;0,153846153846154;0,307692307692308
"14406";48277;51;14406;5;7;17;10;0,153846153846154;0,346153846153846
"14407";48277;51;14407;5;7;19;12;0,153846153846154;0,384615384615385
"14408";48277;51;14408;5;7;21;14;0,153846153846154;0,423076923076923
"14409";48277;51;14409;5;7;23;16;0,153846153846154;0,461538461538462
"14410";48277;51;14410;5;9;21;12;0,192307692307692;0,423076923076923
"14411";48277;51;14411;5;9;23;14;0,192307692307692;0,461538461538462
"14412";48277;51;14412;5;13;21;8;0,269230769230769;0,423076923076923
"14413";48277;51;14413;5;13;23;10;0,269230769230769;0,461538461538462
"14414";48277;51;14414;5;13;25;12;0,269230769230769;0,5
"14415";48277;51;14415;5;13;27;14;0,269230769230769;0,538461538461538
"14416";48277;51;14416;5;13;29;16;0,269230769230769;0,576923076923077
"14417";48277;51;14417;5;15;21;6;0,307692307692308;0,423076923076923
"14418";48277;51;14418;5;17;23;6;0,346153846153846;0,461538461538462
"14419";48277;51;14419;5;17;25;8;0,346153846153846;0,5
"14420";48277;51;14420;5;19;27;8;0,384615384615385;0,538461538461538
"14421";48277;51;14421;5;19;29;10;0,384615384615385;0,576923076923077
"14422";48277;51;14422;5;19;31;12;0,384615384615385;0,615384615384615
"14423";48277;51;14423;5;19;33;14;0,384615384615385;0,653846153846154
"14424";48277;51;14424;5;19;35;16;0,384615384615385;0,692307692307692
"14425";48277;51;14425;5;21;27;6;0,423076923076923;0,538461538461538
"14426";48277;51;14426;5;21;29;8;0,423076923076923;0,576923076923077
"14427";48277;51;14427;5;23;31;8;0,461538461538462;0,615384615384615
"14428";48277;51;14428;5;23;33;10;0,461538461538462;0,653846153846154
"14429";48277;51;14429;5;23;35;12;0,461538461538462;0,692307692307692
"14430";48277;51;14430;5;23;37;14;0,461538461538462;0,730769230769231
"14431";48277;51;14431;5;23;39;16;0,461538461538462;0,769230769230769
"14432";48277;51;14432;5;23;41;18;0,461538461538462;0,807692307692308
"14433";48277;51;14433;5;23;43;20;0,461538461538462;0,846153846153846
"14434";48277;51;14434;5;23;45;22;0,461538461538462;0,884615384615385
"14435";48277;51;14435;5;25;33;8;0,5;0,653846153846154
"14436";48277;51;14436;5;25;35;10;0,5;0,692307692307692
"14437";48277;51;14437;5;25;37;12;0,5;0,730769230769231
"14438";48277;51;14438;5;25;39;14;0,5;0,769230769230769
"14439";48277;51;14439;5;25;41;16;0,5;0,807692307692308
"14440";48277;51;14440;5;27;33;6;0,538461538461538;0,653846153846154
"14441";48277;51;14441;5;27;35;8;0,538461538461538;0,692307692307692
"14442";48277;51;14442;5;27;37;10;0,538461538461538;0,730769230769231
"14443";48277;51;14443;5;27;39;12;0,538461538461538;0,769230769230769
"14444";48277;51;14444;5;27;41;14;0,538461538461538;0,807692307692308
"14445";48277;51;14445;5;27;43;16;0,538461538461538;0,846153846153846
"14446";48277;51;14446;5;29;41;12;0,576923076923077;0,807692307692308
"14447";48277;51;14447;5;29;43;14;0,576923076923077;0,846153846153846
"14448";48277;51;14448;5;31;39;8;0,615384615384615;0,769230769230769
"14449";48277;51;14449;5;31;41;10;0,615384615384615;0,807692307692308
"14450";48277;51;14450;5;33;39;6;0,653846153846154;0,769230769230769
"14451";48277;51;14451;5;33;41;8;0,653846153846154;0,807692307692308
"14452";48277;51;14452;5;35;43;8;0,692307692307692;0,846153846153846
"14453";48277;51;14453;5;35;45;10;0,692307692307692;0,884615384615385
"14454";48277;51;14454;5;37;45;8;0,730769230769231;0,884615384615385
"14455";48277;51;14455;5;3;19;16;0,0769230769230769;0,384615384615385
"14456";48277;51;14456;5;3;21;18;0,0769230769230769;0,423076923076923
"14457";48277;51;14457;5;3;23;20;0,0769230769230769;0,461538461538462
"14458";48277;51;14458;5;7;25;18;0,153846153846154;0,5
"14459";48277;51;14459;5;7;27;20;0,153846153846154;0,538461538461538
"14460";48277;51;14460;5;9;25;16;0,192307692307692;0,5
"14461";48277;51;14461;5;9;27;18;0,192307692307692;0,538461538461538
"14462";48277;51;14462;5;11;21;10;0,230769230769231;0,423076923076923
"14463";48277;51;14463;5;11;23;12;0,230769230769231;0,461538461538462
"14464";48277;51;14464;5;11;25;14;0,230769230769231;0,5
"14465";48277;51;14465;5;11;27;16;0,230769230769231;0,538461538461538
"14466";48277;51;14466;5;15;23;8;0,307692307692308;0,461538461538462
"14467";48277;51;14467;5;15;25;10;0,307692307692308;0,5
"14468";48277;51;14468;5;17;27;10;0,346153846153846;0,538461538461538
"14469";48277;51;14469;5;17;29;12;0,346153846153846;0,576923076923077
"14470";48277;51;14470;5;17;31;14;0,346153846153846;0,615384615384615
"14471";48277;51;14471;5;21;31;10;0,423076923076923;0,615384615384615
"14472";48277;51;14472;5;21;33;12;0,423076923076923;0,653846153846154
"14473";48277;51;14473;5;25;43;18;0,5;0,846153846153846
"14474";48277;51;14474;5;25;45;20;0,5;0,884615384615385
"14475";48277;51;14475;5;29;45;16;0,576923076923077;0,884615384615385
"14476";48277;51;14476;5;29;47;18;0,576923076923077;0,923076923076923
"14477";48277;51;14477;5;29;49;20;0,576923076923077;0,961538461538462
"14478";48277;51;14478;5;33;43;10;0,653846153846154;0,846153846153846
"14479";48277;51;14479;5;33;45;12;0,653846153846154;0,884615384615385
"14480";48277;51;14480;5;33;47;14;0,653846153846154;0,923076923076923
"14481";48277;51;14481;5;35;47;12;0,692307692307692;0,923076923076923
"14482";48277;51;14482;5;35;49;14;0,692307692307692;0,961538461538462
"14483";48277;51;14483;5;31;43;12;0,615384615384615;0,846153846153846
"14484";48277;51;14484;5;5;17;12;0,115384615384615;0,346153846153846
"14485";48277;51;14485;5;31;45;14;0,615384615384615;0,884615384615385
"14486";48277;51;14486;5;31;47;16;0,615384615384615;0,923076923076923
"14487";48277;51;14487;5;31;49;18;0,615384615384615;0,961538461538462
"14488";48277;51;14488;5;31;51;20;0,615384615384615;1
"14489";48277;51;14489;5;37;47;10;0,730769230769231;0,923076923076923
"14490";48277;51;14490;5;37;49;12;0,730769230769231;0,961538461538462
"14491";48277;51;14491;5;37;51;14;0,730769230769231;1
"14492";48277;51;14492;5;5;19;14;0,115384615384615;0,384615384615385
"14493";48277;51;14493;5;5;21;16;0,115384615384615;0,423076923076923
"14494";48277;51;14494;5;35;51;16;0,692307692307692;1
"14495";48277;51;14495;5;27;45;18;0,538461538461538;0,884615384615385
"14496";48277;51;14496;5;5;23;18;0,115384615384615;0,461538461538462
"14497";48277;51;14497;5;29;51;22;0,576923076923077;1
"14498";48277;51;14498;5;15;27;12;0,307692307692308;0,538461538461538
"14499";48277;51;14499;5;15;29;14;0,307692307692308;0,576923076923077
"14500";48277;51;14500;5;23;47;24;0,461538461538462;0,923076923076923
"14501";48277;51;14501;5;23;49;26;0,461538461538462;0,961538461538462
"14502";48277;51;14502;5;23;51;28;0,461538461538462;1
"14503";48544;56;14503;3;32;56;24;0,571428571428571;1
"14504";48544;56;14504;3;23;48;25;0,428571428571429;0,857142857142857
"14505";48544;56;14505;3;23;56;33;0,428571428571429;1
"14506";48544;56;14506;4;3;15;12;0,0714285714285714;0,285714285714286
"14507";48544;56;14507;4;40;52;12;0,714285714285714;0,928571428571429
"14508";48544;56;14508;4;28;40;12;0,5;0,714285714285714
"14509";48544;56;14509;4;28;44;16;0,5;0,785714285714286
"14510";48544;56;14510;4;32;44;12;0,571428571428571;0,785714285714286
"14511";48544;56;14511;4;32;48;16;0,571428571428571;0,857142857142857
"14512";48544;56;14512;4;32;52;20;0,571428571428571;0,928571428571429
"14513";48544;56;14513;4;32;56;24;0,571428571428571;1
"14514";48544;56;14514;4;36;48;12;0,642857142857143;0,857142857142857
"14515";48544;56;14515;4;36;52;16;0,642857142857143;0,928571428571429
"14516";48544;56;14516;4;36;56;20;0,642857142857143;1
"14517";48544;56;14517;4;40;56;16;0,714285714285714;1
"14518";48544;56;14518;4;44;56;12;0,785714285714286;1
"14519";48544;56;14519;4;28;48;20;0,5;0,857142857142857
"14520";48544;56;14520;4;28;52;24;0,5;0,928571428571429
"14521";48544;56;14521;4;28;56;28;0,5;1
"14522";48544;56;14522;4;23;36;13;0,428571428571429;0,642857142857143
"14523";48544;56;14523;4;15;28;13;0,285714285714286;0,5
"14524";48544;56;14524;4;19;32;13;0,357142857142857;0,571428571428571
"14525";48544;56;14525;5;17;23;6;0,321428571428571;0,428571428571429
"14526";48544;56;14526;5;5;11;6;0,107142857142857;0,214285714285714
"14527";48544;56;14527;5;7;13;6;0,142857142857143;0,25
"14528";48544;56;14528;5;7;15;8;0,142857142857143;0,285714285714286
"14529";48544;56;14529;5;17;25;8;0,321428571428571;0,464285714285714
"14530";48544;56;14530;5;19;25;6;0,357142857142857;0,464285714285714
"14531";48544;56;14531;5;28;34;6;0,5;0,607142857142857
"14532";48544;56;14532;5;28;36;8;0,5;0,642857142857143
"14533";48544;56;14533;5;30;36;6;0,535714285714286;0,642857142857143
"14534";48544;56;14534;5;30;38;8;0,535714285714286;0,678571428571429
"14535";48544;56;14535;5;30;40;10;0,535714285714286;0,714285714285714
"14536";48544;56;14536;5;30;42;12;0,535714285714286;0,75
"14537";48544;56;14537;5;32;38;6;0,571428571428571;0,678571428571429
"14538";48544;56;14538;5;32;40;8;0,571428571428571;0,714285714285714
"14539";48544;56;14539;5;32;42;10;0,571428571428571;0,75
"14540";48544;56;14540;5;32;44;12;0,571428571428571;0,785714285714286
"14541";48544;56;14541;5;34;40;6;0,607142857142857;0,714285714285714
"14542";48544;56;14542;5;34;42;8;0,607142857142857;0,75
"14543";48544;56;14543;5;34;44;10;0,607142857142857;0,785714285714286
"14544";48544;56;14544;5;36;42;6;0,642857142857143;0,75
"14545";48544;56;14545;5;36;44;8;0,642857142857143;0,785714285714286
"14546";48544;56;14546;5;36;46;10;0,642857142857143;0,821428571428571
"14547";48544;56;14547;5;42;48;6;0,75;0,857142857142857
"14548";48544;56;14548;5;42;50;8;0,75;0,892857142857143
"14549";48544;56;14549;5;46;52;6;0,821428571428571;0,928571428571429
"14550";48544;56;14550;5;46;54;8;0,821428571428571;0,964285714285714
"14551";48544;56;14551;5;48;54;6;0,857142857142857;0,964285714285714
"14552";48544;56;14552;5;48;56;8;0,857142857142857;1
"14553";48544;56;14553;5;50;56;6;0,892857142857143;1
"14554";48544;56;14554;5;5;13;8;0,107142857142857;0,25
"14555";48544;56;14555;5;5;15;10;0,107142857142857;0,285714285714286
"14556";48544;56;14556;5;15;21;6;0,285714285714286;0,392857142857143
"14557";48544;56;14557;5;15;23;8;0,285714285714286;0,428571428571429
"14558";48544;56;14558;5;15;25;10;0,285714285714286;0,464285714285714
"14559";48544;56;14559;5;25;32;7;0,464285714285714;0,571428571428571
"14560";48544;56;14560;5;34;46;12;0,607142857142857;0,821428571428571
"14561";48544;56;14561;5;34;48;14;0,607142857142857;0,857142857142857
"14562";48544;56;14562;5;28;38;10;0,5;0,678571428571429
"14563";48544;56;14563;5;28;40;12;0,5;0,714285714285714
"14564";48544;56;14564;5;28;42;14;0,5;0,75
"14565";48544;56;14565;5;28;44;16;0,5;0,785714285714286
"14566";48544;56;14566;5;28;46;18;0,5;0,821428571428571
"14567";48544;56;14567;5;28;48;20;0,5;0,857142857142857
"14568";48544;56;14568;5;28;50;22;0,5;0,892857142857143
"14569";48544;56;14569;5;28;52;24;0,5;0,928571428571429
"14570";48544;56;14570;5;28;54;26;0,5;0,964285714285714
"14571";48544;56;14571;5;30;44;14;0,535714285714286;0,785714285714286
"14572";48544;56;14572;5;30;46;16;0,535714285714286;0,821428571428571
"14573";48544;56;14573;5;30;48;18;0,535714285714286;0,857142857142857
"14574";48544;56;14574;5;30;50;20;0,535714285714286;0,892857142857143
"14575";48544;56;14575;5;30;52;22;0,535714285714286;0,928571428571429
"14576";48544;56;14576;5;30;54;24;0,535714285714286;0,964285714285714
"14577";48544;56;14577;5;30;56;26;0,535714285714286;1
"14578";48544;56;14578;5;42;52;10;0,75;0,928571428571429
"14579";48544;56;14579;5;42;54;12;0,75;0,964285714285714
"14580";48544;56;14580;5;42;56;14;0,75;1
"14581";48544;56;14581;5;1;7;6;0,0357142857142857;0,142857142857143
"14582";48544;56;14582;5;1;9;8;0,0357142857142857;0,178571428571429
"14583";48544;56;14583;5;1;11;10;0,0357142857142857;0,214285714285714
"14584";48544;56;14584;5;1;13;12;0,0357142857142857;0,25
"14585";48544;56;14585;5;32;46;14;0,571428571428571;0,821428571428571
"14586";48544;56;14586;5;32;48;16;0,571428571428571;0,857142857142857
"14587";48544;56;14587;5;32;50;18;0,571428571428571;0,892857142857143
"14588";48544;56;14588;5;32;52;20;0,571428571428571;0,928571428571429
"14589";48544;56;14589;5;46;56;10;0,821428571428571;1
"14590";48544;56;14590;5;36;48;12;0,642857142857143;0,857142857142857
"14591";48544;56;14591;5;40;46;6;0,714285714285714;0,821428571428571
"14592";48544;56;14592;5;40;48;8;0,714285714285714;0,857142857142857
"14593";48544;56;14593;5;40;50;10;0,714285714285714;0,892857142857143
"14594";48544;56;14594;5;40;52;12;0,714285714285714;0,928571428571429
"14595";48544;56;14595;5;25;34;9;0,464285714285714;0,607142857142857
"14596";48544;56;14596;5;25;36;11;0,464285714285714;0,642857142857143
"14597";48544;56;14597;5;25;38;13;0,464285714285714;0,678571428571429
"14598";48544;56;14598;5;25;40;15;0,464285714285714;0,714285714285714
"14599";48544;56;14599;5;32;54;22;0,571428571428571;0,964285714285714
"14600";50140;57;14600;4;28;40;12;0,5;0,714285714285714
"14601";50140;57;14601;5;1;7;6;0,0344827586206897;0,137931034482759
"14602";50140;57;14602;5;49;55;6;0,862068965517241;0,96551724137931
"14603";50140;57;14603;5;35;41;6;0,620689655172414;0,724137931034483
"14604";50140;57;14604;5;35;43;8;0,620689655172414;0,758620689655172
"14605";50140;57;14605;5;47;53;6;0,827586206896552;0,931034482758621
"14606";50140;57;14606;5;47;55;8;0,827586206896552;0,96551724137931
"14607";50140;57;14607;5;47;57;10;0,827586206896552;1
"14608";50140;57;14608;5;31;37;6;0,551724137931034;0,655172413793103
"14609";50140;57;14609;5;51;57;6;0,896551724137931;1
"14610";50140;57;14610;5;33;39;6;0,586206896551724;0,689655172413793
"14611";50140;57;14611;5;49;57;8;0,862068965517241;1
"14612";345897;51;14612;5;41;47;6;0,807692307692308;0,923076923076923
"14613";345897;51;14613;5;41;49;8;0,807692307692308;0,961538461538462
"14614";345897;51;14614;5;43;49;6;0,846153846153846;0,961538461538462
"14615";345897;51;14615;5;45;51;6;0,884615384615385;1
"14616";345897;51;14616;5;35;41;6;0,692307692307692;0,807692307692308
"14617";345897;51;14617;5;43;51;8;0,846153846153846;1
"14618";345897;51;14618;5;5;11;6;0,115384615384615;0,230769230769231
"14619";345897;51;14619;5;33;39;6;0,653846153846154;0,769230769230769
"14620";60399;55;14620;3;7;31;24;0,142857142857143;0,571428571428571
"14621";60399;55;14621;3;7;39;32;0,142857142857143;0,714285714285714
"14622";60399;55;14622;4;3;15;12;0,0714285714285714;0,285714285714286
"14623";60399;55;14623;4;39;51;12;0,714285714285714;0,928571428571429
"14624";60399;55;14624;4;39;55;16;0,714285714285714;1
"14625";60399;55;14625;4;3;19;16;0,0714285714285714;0,357142857142857
"14626";60399;55;14626;4;3;23;20;0,0714285714285714;0,428571428571429
"14627";60399;55;14627;4;3;27;24;0,0714285714285714;0,5
"14628";60399;55;14628;4;3;31;28;0,0714285714285714;0,571428571428571
"14629";60399;55;14629;4;3;35;32;0,0714285714285714;0,642857142857143
"14630";60399;55;14630;4;35;47;12;0,642857142857143;0,857142857142857
"14631";60399;55;14631;5;1;7;6;0,0357142857142857;0,142857142857143
"14632";60399;55;14632;5;3;9;6;0,0714285714285714;0,178571428571429
"14633";60399;55;14633;5;3;11;8;0,0714285714285714;0,214285714285714
"14634";60399;55;14634;5;39;45;6;0,714285714285714;0,821428571428571
"14635";60399;55;14635;5;39;47;8;0,714285714285714;0,857142857142857
"14636";60399;55;14636;5;1;9;8;0,0357142857142857;0,178571428571429
"14637";60399;55;14637;5;1;11;10;0,0357142857142857;0,214285714285714
"14638";60399;55;14638;5;1;13;12;0,0357142857142857;0,25
"14639";60399;55;14639;5;1;15;14;0,0357142857142857;0,285714285714286
"14640";60399;55;14640;5;1;17;16;0,0357142857142857;0,321428571428571
"14641";60399;55;14641;5;3;13;10;0,0714285714285714;0,25
"14642";60399;55;14642;5;3;15;12;0,0714285714285714;0,285714285714286
"14643";60399;55;14643;5;3;17;14;0,0714285714285714;0,321428571428571
"14644";60399;55;14644;5;3;19;16;0,0714285714285714;0,357142857142857
"14645";60399;55;14645;5;39;49;10;0,714285714285714;0,892857142857143
"14646";60399;55;14646;5;39;51;12;0,714285714285714;0,928571428571429
"14647";60399;55;14647;5;39;53;14;0,714285714285714;0,964285714285714
"14648";60399;55;14648;5;39;55;16;0,714285714285714;1
"14649";60399;55;14649;5;1;19;18;0,0357142857142857;0,357142857142857
"14650";60399;55;14650;5;1;21;20;0,0357142857142857;0,392857142857143
"14651";60399;55;14651;5;1;23;22;0,0357142857142857;0,428571428571429
"14652";60399;55;14652;5;1;25;24;0,0357142857142857;0,464285714285714
"14653";60399;55;14653;5;1;27;26;0,0357142857142857;0,5
"14654";60399;55;14654;5;3;21;18;0,0714285714285714;0,392857142857143
"14655";60399;55;14655;5;37;43;6;0,678571428571429;0,785714285714286
"14656";60399;55;14656;5;3;23;20;0,0714285714285714;0,428571428571429
"14657";60399;55;14657;5;3;25;22;0,0714285714285714;0,464285714285714
"14658";60399;55;14658;5;3;27;24;0,0714285714285714;0,5
"14659";60399;55;14659;5;3;29;26;0,0714285714285714;0,535714285714286
"14660";60399;55;14660;5;3;31;28;0,0714285714285714;0,571428571428571
"14661";60399;55;14661;5;3;33;30;0,0714285714285714;0,607142857142857
"14662";71024;56;14662;4;40;52;12;0,714285714285714;0,928571428571429
"14663";71024;56;14663;4;40;56;16;0,714285714285714;1
"14664";71024;56;14664;4;36;48;12;0,642857142857143;0,857142857142857
"14665";71024;56;14665;5;3;9;6;0,0714285714285714;0,178571428571429
"14666";71024;56;14666;5;23;30;7;0,428571428571429;0,535714285714286
"14667";71024;56;14667;5;38;44;6;0,678571428571429;0,785714285714286
"14668";71024;56;14668;5;38;46;8;0,678571428571429;0,821428571428571
"14669";71024;56;14669;5;40;46;6;0,714285714285714;0,821428571428571
"14670";71024;56;14670;5;40;48;8;0,714285714285714;0,857142857142857
"14671";71024;56;14671;5;48;54;6;0,857142857142857;0,964285714285714
"14672";71024;56;14672;5;48;56;8;0,857142857142857;1
"14673";71024;56;14673;5;30;36;6;0,535714285714286;0,642857142857143
"14674";71024;56;14674;5;40;50;10;0,714285714285714;0,892857142857143
"14675";71024;56;14675;5;40;52;12;0,714285714285714;0,928571428571429
"14676";71024;56;14676;5;38;48;10;0,678571428571429;0,857142857142857
"14677";71024;56;14677;5;1;7;6;0,0357142857142857;0,142857142857143
"14678";71024;56;14678;5;23;32;9;0,428571428571429;0,571428571428571
"14679";71024;56;14679;5;40;54;14;0,714285714285714;0,964285714285714
"14680";71024;56;14680;5;40;56;16;0,714285714285714;1
"14681";71024;56;14681;5;32;38;6;0,571428571428571;0,678571428571429
"14682";81033;64;14682;5;15;27;12;0,25;0,4375
"14683";81033;64;14683;5;23;36;13;0,375;0,5625
"14684";81033;64;14684;5;44;56;12;0,6875;0,875
"14685";81033;64;14685;5;44;60;16;0,6875;0,9375
"14686";81033;64;14686;5;48;60;12;0,75;0,9375
"14687";81033;64;14687;5;48;64;16;0,75;1
"14688";81033;64;14688;5;52;64;12;0,8125;1
"14689";81033;64;14689;5;11;23;12;0,1875;0,375
"14690";81033;64;14690;5;19;32;13;0,3125;0,5
"14691";81033;64;14691;5;44;64;20;0,6875;1
"14692";81033;64;14692;6;25;32;7;0,40625;0,5
"14693";81033;64;14693;6;25;34;9;0,40625;0,53125
"14694";81033;64;14694;6;46;52;6;0,71875;0,8125
"14695";81033;64;14695;6;46;54;8;0,71875;0,84375
"14696";81033;64;14696;6;46;56;10;0,71875;0,875
"14697";81033;64;14697;6;48;54;6;0,75;0,84375
"14698";81033;64;14698;6;48;56;8;0,75;0,875
"14699";81033;64;14699;6;50;56;6;0,78125;0,875
"14700";81033;64;14700;6;52;58;6;0,8125;0,90625
"14701";81033;64;14701;6;52;60;8;0,8125;0,9375
"14702";81033;64;14702;6;54;60;6;0,84375;0,9375
"14703";81033;64;14703;6;54;62;8;0,84375;0,96875
"14704";81033;64;14704;6;58;64;6;0,90625;1
"14705";81033;64;14705;6;9;15;6;0,15625;0,25
"14706";81033;64;14706;6;13;19;6;0,21875;0,3125
"14707";81033;64;14707;6;17;23;6;0,28125;0,375
"14708";81033;64;14708;6;17;25;8;0,28125;0,40625
"14709";81033;64;14709;6;23;29;6;0,375;0,46875
"14710";81033;64;14710;6;23;32;9;0,375;0,5
"14711";81033;64;14711;6;23;34;11;0,375;0,53125
"14712";81033;64;14712;6;52;62;10;0,8125;0,96875
"14713";81033;64;14713;6;7;13;6;0,125;0,21875
"14714";81033;64;14714;6;15;21;6;0,25;0,34375
"14715";81033;64;14715;6;54;64;10;0,84375;1
"14716";81033;64;14716;6;46;58;12;0,71875;0,90625
"14717";81033;64;14717;6;46;60;14;0,71875;0,9375
"14718";81033;64;14718;6;46;62;16;0,71875;0,96875
"14719";81033;64;14719;6;46;64;18;0,71875;1
"14720";81033;64;14720;6;52;64;12;0,8125;1
"14721";81033;64;14721;6;7;15;8;0,125;0,25
"14722";81033;64;14722;6;15;23;8;0,25;0,375
"14723";81033;64;14723;6;1;7;6;0,03125;0,125
"14724";81033;64;14724;6;15;25;10;0,25;0,40625
"14725";81033;64;14725;6;13;21;8;0,21875;0,34375
"14726";81033;64;14726;6;13;23;10;0,21875;0,375
"14727";81033;64;14727;6;50;58;8;0,78125;0,90625
"14728";81033;64;14728;6;50;60;10;0,78125;0,9375
"14729";81033;64;14729;6;50;62;12;0,78125;0,96875
"14730";81033;64;14730;6;19;25;6;0,3125;0,40625
"14731";81033;64;14731;6;50;64;14;0,78125;1
"14732";81033;64;14732;6;11;17;6;0,1875;0,28125
"14733";82358;79;14733;4;31;55;24;0,4;0,7
"14734";82358;79;14734;4;23;47;24;0,3;0,6
"14735";82358;79;14735;4;55;79;24;0,7;1
"14736";82358;79;14736;5;39;51;12;0,5;0,65
"14737";82358;79;14737;5;55;67;12;0,7;0,85
"14738";82358;79;14738;5;59;71;12;0,75;0,9
"14739";82358;79;14739;5;3;15;12;0,05;0,2
"14740";82358;79;14740;5;31;43;12;0,4;0,55
"14741";82358;79;14741;5;31;47;16;0,4;0,6
"14742";82358;79;14742;5;35;47;12;0,45;0,6
"14743";82358;79;14743;5;35;51;16;0,45;0,65
"14744";82358;79;14744;5;39;55;16;0,5;0,7
"14745";82358;79;14745;5;27;39;12;0,35;0,5
"14746";82358;79;14746;5;43;55;12;0,55;0,7
"14747";82358;79;14747;5;55;71;16;0,7;0,9
"14748";82358;79;14748;5;55;75;20;0,7;0,95
"14749";82358;79;14749;5;55;79;24;0,7;1
"14750";82358;79;14750;5;59;75;16;0,75;0,95
"14751";82358;79;14751;5;59;79;20;0,75;1
"14752";82358;79;14752;5;7;19;12;0,1;0,25
"14753";82358;79;14753;5;35;55;20;0,45;0,7
"14754";82358;79;14754;5;27;43;16;0,35;0,55
"14755";82358;79;14755;5;31;51;20;0,4;0,65
"14756";82358;79;14756;5;31;55;24;0,4;0,7
"14757";82358;79;14757;5;3;19;16;0,05;0,25
"14758";82358;79;14758;6;3;9;6;0,05;0,125
"14759";82358;79;14759;6;5;11;6;0,075;0,15
"14760";82358;79;14760;6;37;43;6;0,475;0,55
"14761";82358;79;14761;6;39;45;6;0,5;0,575
"14762";82358;79;14762;6;45;51;6;0,575;0,65
"14763";82358;79;14763;6;57;63;6;0,725;0,8
"14764";82358;79;14764;6;59;65;6;0,75;0,825
"14765";82358;79;14765;6;5;13;8;0,075;0,175
"14766";82358;79;14766;6;5;15;10;0,075;0,2
"14767";82358;79;14767;6;29;35;6;0,375;0,45
"14768";82358;79;14768;6;29;37;8;0,375;0,475
"14769";82358;79;14769;6;37;45;8;0,475;0,575
"14770";82358;79;14770;6;37;47;10;0,475;0,6
"14771";82358;79;14771;6;37;49;12;0,475;0,625
"14772";82358;79;14772;6;45;53;8;0,575;0,675
"14773";82358;79;14773;6;45;55;10;0,575;0,7
"14774";82358;79;14774;6;57;65;8;0,725;0,825
"14775";82358;79;14775;6;57;67;10;0,725;0,85
"14776";82358;79;14776;6;57;69;12;0,725;0,875
"14777";82358;79;14777;6;59;67;8;0,75;0,85
"14778";82358;79;14778;6;59;69;10;0,75;0,875
"14779";82358;79;14779;6;3;11;8;0,05;0,15
"14780";82358;79;14780;6;3;13;10;0,05;0,175
"14781";82358;79;14781;6;37;51;14;0,475;0,65
"14782";82358;79;14782;6;37;53;16;0,475;0,675
"14783";82358;79;14783;6;37;55;18;0,475;0,7
"14784";82358;79;14784;6;39;47;8;0,5;0,6
"14785";82358;79;14785;6;39;49;10;0,5;0,625
"14786";82358;79;14786;6;39;51;12;0,5;0,65
"14787";82358;79;14787;6;39;53;14;0,5;0,675
"14788";82358;79;14788;6;39;55;16;0,5;0,7
"14789";82358;79;14789;6;57;71;14;0,725;0,9
"14790";82358;79;14790;6;57;73;16;0,725;0,925
"14791";82358;79;14791;6;57;75;18;0,725;0,95
"14792";82358;79;14792;6;57;77;20;0,725;0,975
"14793";82358;79;14793;6;59;71;12;0,75;0,9
"14794";82358;79;14794;6;59;73;14;0,75;0,925
"14795";82358;79;14795;6;57;79;22;0,725;1
"14796";82358;79;14796;6;59;75;16;0,75;0,95
"14797";82358;79;14797;6;59;77;18;0,75;0,975
"14798";82358;79;14798;6;59;79;20;0,75;1
"14799";82358;79;14799;6;27;33;6;0,35;0,425
"14800";82358;79;14800;6;35;41;6;0,45;0,525
"14801";82358;79;14801;6;35;43;8;0,45;0,55
"14802";82358;79;14802;6;35;45;10;0,45;0,575
"14803";82358;79;14803;6;35;47;12;0,45;0,6
"14804";82358;79;14804;6;3;15;12;0,05;0,2
"14805";82358;79;14805;6;25;31;6;0,325;0,4
"14806";82358;79;14806;6;31;37;6;0,4;0,475
"14807";82358;79;14807;6;55;61;6;0,7;0,775
"14808";82358;79;14808;6;55;63;8;0,7;0,8
"14809";82358;79;14809;6;55;65;10;0,7;0,825
"14810";82358;79;14810;6;55;67;12;0,7;0,85
"14811";82358;79;14811;6;55;69;14;0,7;0,875
"14812";83356;55;14812;3;31;55;24;0,571428571428571;1
"14813";83356;55;14813;4;27;39;12;0,5;0,714285714285714
"14814";83356;55;14814;4;27;43;16;0,5;0,785714285714286
"14815";83356;55;14815;4;27;47;20;0,5;0,857142857142857
"14816";83356;55;14816;4;27;51;24;0,5;0,928571428571429
"14817";83356;55;14817;4;27;55;28;0,5;1
"14818";83356;55;14818;5;25;31;6;0,464285714285714;0,571428571428571
"14819";83356;55;14819;5;25;33;8;0,464285714285714;0,607142857142857
"14820";83356;55;14820;5;25;35;10;0,464285714285714;0,642857142857143
"14821";83356;55;14821;5;25;37;12;0,464285714285714;0,678571428571429
"14822";83356;55;14822;5;25;39;14;0,464285714285714;0,714285714285714
"14823";83356;55;14823;5;25;41;16;0,464285714285714;0,75
"14824";83356;55;14824;5;25;43;18;0,464285714285714;0,785714285714286
"14825";83356;55;14825;5;25;45;20;0,464285714285714;0,821428571428571
"14826";83356;55;14826;5;25;47;22;0,464285714285714;0,857142857142857
"14827";84878;62;14827;4;24;37;13;0,4;0,6
"14828";84878;62;14828;4;3;16;13;0,0666666666666667;0,266666666666667
"14829";84878;62;14829;4;41;54;13;0,666666666666667;0,866666666666667
"14830";84878;62;14830;4;41;58;17;0,666666666666667;0,933333333333333
"14831";84878;62;14831;4;41;62;21;0,666666666666667;1
"14832";84878;62;14832;4;49;62;13;0,8;1
"14833";84878;62;14833;4;20;33;13;0,333333333333333;0,533333333333333
"14834";84878;62;14834;4;20;37;17;0,333333333333333;0,6
"14835";84878;62;14835;5;1;7;6;0,032258064516129;0,129032258064516
"14836";84878;62;14836;5;7;13;6;0,129032258064516;0,225806451612903
"14837";84878;62;14837;5;7;15;8;0,129032258064516;0,258064516129032
"14838";84878;62;14838;5;7;17;10;0,129032258064516;0,290322580645161
"14839";84878;62;14839;5;11;17;6;0,193548387096774;0,290322580645161
"14840";84878;62;14840;5;21;27;6;0,354838709677419;0,451612903225806
"14841";84878;62;14841;5;23;29;6;0,387096774193548;0,483870967741935
"14842";84878;62;14842;5;25;32;7;0,419354838709677;0,516129032258065
"14843";84878;62;14843;5;27;34;7;0,451612903225806;0,548387096774194
"14844";84878;62;14844;5;29;36;7;0,483870967741935;0,580645161290323
"14845";84878;62;14845;5;32;38;6;0,516129032258065;0,612903225806452
"14846";84878;62;14846;5;42;48;6;0,67741935483871;0,774193548387097
"14847";84878;62;14847;5;42;50;8;0,67741935483871;0,806451612903226
"14848";84878;62;14848;5;42;52;10;0,67741935483871;0,838709677419355
"14849";84878;62;14849;5;50;56;6;0,806451612903226;0,903225806451613
"14850";84878;62;14850;5;52;58;6;0,838709677419355;0,935483870967742
"14851";84878;62;14851;5;54;60;6;0,870967741935484;0,967741935483871
"14852";84878;62;14852;5;21;29;8;0,354838709677419;0,483870967741935
"14853";84878;62;14853;5;21;32;11;0,354838709677419;0,516129032258065
"14854";84878;62;14854;5;21;34;13;0,354838709677419;0,548387096774194
"14855";84878;62;14855;5;21;36;15;0,354838709677419;0,580645161290323
"14856";84878;62;14856;5;21;38;17;0,354838709677419;0,612903225806452
"14857";84878;62;14857;5;23;32;9;0,387096774193548;0,516129032258065
"14858";84878;62;14858;5;23;34;11;0,387096774193548;0,548387096774194
"14859";84878;62;14859;5;23;36;13;0,387096774193548;0,580645161290323
"14860";84878;62;14860;5;23;38;15;0,387096774193548;0,612903225806452
"14861";84878;62;14861;5;25;34;9;0,419354838709677;0,548387096774194
"14862";84878;62;14862;5;25;36;11;0,419354838709677;0,580645161290323
"14863";84878;62;14863;5;25;38;13;0,419354838709677;0,612903225806452
"14864";84878;62;14864;5;27;36;9;0,451612903225806;0,580645161290323
"14865";84878;62;14865;5;27;38;11;0,451612903225806;0,612903225806452
"14866";84878;62;14866;5;29;38;9;0,483870967741935;0,612903225806452
"14867";84878;62;14867;5;29;40;11;0,483870967741935;0,645161290322581
"14868";84878;62;14868;5;32;40;8;0,516129032258065;0,645161290322581
"14869";84878;62;14869;5;50;58;8;0,806451612903226;0,935483870967742
"14870";84878;62;14870;5;50;60;10;0,806451612903226;0,967741935483871
"14871";84878;62;14871;5;52;60;8;0,838709677419355;0,967741935483871
"14872";84878;62;14872;5;54;62;8;0,870967741935484;1
"14873";84878;62;14873;5;21;40;19;0,354838709677419;0,645161290322581
"14874";84878;62;14874;5;23;40;17;0,387096774193548;0,645161290322581
"14875";84878;62;14875;5;25;40;15;0,419354838709677;0,645161290322581
"14876";84878;62;14876;5;27;40;13;0,451612903225806;0,645161290322581
"14877";84878;62;14877;5;42;54;12;0,67741935483871;0,870967741935484
"14878";84878;62;14878;5;42;56;14;0,67741935483871;0,903225806451613
"14879";84878;62;14879;5;42;58;16;0,67741935483871;0,935483870967742
"14880";84878;62;14880;5;50;62;12;0,806451612903226;1
"14881";84878;62;14881;5;52;62;10;0,838709677419355;1
"14882";84878;62;14882;5;19;25;6;0,32258064516129;0,419354838709677
"14883";84878;62;14883;5;19;27;8;0,32258064516129;0,451612903225806
"14884";84878;62;14884;5;19;29;10;0,32258064516129;0,483870967741935
"14885";84878;62;14885;5;19;32;13;0,32258064516129;0,516129032258065
"14886";84878;62;14886;5;19;34;15;0,32258064516129;0,548387096774194
"14887";84878;62;14887;5;19;36;17;0,32258064516129;0,580645161290323
"14888";84878;62;14888;5;42;60;18;0,67741935483871;0,967741935483871
"14889";84878;62;14889;5;42;62;20;0,67741935483871;1
"14890";89461;86;14890;4;51;77;26;0,6;0,9
"14891";89461;86;14891;4;42;69;27;0,5;0,8
"14892";89461;86;14892;5;3;16;13;0,0476190476190476;0,19047619047619
"14893";89461;86;14893;5;57;69;12;0,666666666666667;0,80952380952381
"14894";89461;86;14894;5;3;20;17;0,0476190476190476;0,238095238095238
"14895";89461;86;14895;5;49;61;12;0,571428571428571;0,714285714285714
"14896";89461;86;14896;5;49;65;16;0,571428571428571;0,761904761904762
"14897";89461;86;14897;5;65;78;13;0,761904761904762;0,904761904761905
"14898";89461;86;14898;5;45;57;12;0,523809523809524;0,666666666666667
"14899";89461;86;14899;5;49;69;20;0,571428571428571;0,80952380952381
"14900";89461;86;14900;6;5;11;6;0,0697674418604651;0,13953488372093
"14901";89461;86;14901;6;60;66;6;0,697674418604651;0,767441860465116
"14902";89461;86;14902;6;1;7;6;0,0232558139534884;0,0930232558139535
"14903";89461;86;14903;6;1;9;8;0,0232558139534884;0,116279069767442
"14904";89461;86;14904;6;5;13;8;0,0697674418604651;0,162790697674419
"14905";89461;86;14905;6;48;54;6;0,558139534883721;0,627906976744186
"14906";89461;86;14906;6;48;56;8;0,558139534883721;0,651162790697674
"14907";89461;86;14907;6;58;64;6;0,674418604651163;0,744186046511628
"14908";89461;86;14908;6;58;66;8;0,674418604651163;0,767441860465116
"14909";89461;86;14909;6;60;68;8;0,697674418604651;0,790697674418605
"14910";89461;86;14910;6;62;68;6;0,720930232558139;0,790697674418605
"14911";89461;86;14911;6;72;78;6;0,837209302325581;0,906976744186046
"14912";89461;86;14912;6;1;11;10;0,0232558139534884;0,13953488372093
"14913";89461;86;14913;6;1;13;12;0,0232558139534884;0,162790697674419
"14914";89461;86;14914;6;1;15;14;0,0232558139534884;0,186046511627907
"14915";89461;86;14915;6;1;17;16;0,0232558139534884;0,209302325581395
"14916";89461;86;14916;6;3;9;6;0,0465116279069767;0,116279069767442
"14917";89461;86;14917;6;5;15;10;0,0697674418604651;0,186046511627907
"14918";89461;86;14918;6;5;17;12;0,0697674418604651;0,209302325581395
"14919";89461;86;14919;6;50;56;6;0,581395348837209;0,651162790697674
"14920";89461;86;14920;6;35;41;6;0,418604651162791;0,488372093023256
"14921";89461;86;14921;6;31;37;6;0,372093023255814;0,441860465116279
"14922";89461;86;14922;6;72;80;8;0,837209302325581;0,930232558139535
"14923";89461;86;14923;6;58;68;10;0,674418604651163;0,790697674418605
"14924";89461;86;14924;6;76;82;6;0,883720930232558;0,953488372093023
"14925";89461;86;14925;6;5;19;14;0,0697674418604651;0,232558139534884
"14926";89461;86;14926;6;5;21;16;0,0697674418604651;0,255813953488372
"14927";89461;86;14927;6;52;58;6;0,604651162790698;0,674418604651163
"14928";89461;86;14928;6;3;11;8;0,0465116279069767;0,13953488372093
"14929";89461;86;14929;6;3;13;10;0,0465116279069767;0,162790697674419
"14930";89461;86;14930;6;3;15;12;0,0465116279069767;0,186046511627907
"14931";89461;86;14931;6;48;58;10;0,558139534883721;0,674418604651163
"14932";89461;86;14932;6;50;58;8;0,581395348837209;0,674418604651163
"14933";89461;86;14933;6;54;60;6;0,627906976744186;0,697674418604651
"14934";89461;86;14934;6;54;62;8;0,627906976744186;0,720930232558139
"14935";89461;86;14935;6;54;64;10;0,627906976744186;0,744186046511628
"14936";89461;86;14936;6;58;70;12;0,674418604651163;0,813953488372093
"14937";89461;86;14937;6;41;48;7;0,488372093023256;0,558139534883721
"14938";89461;86;14938;6;33;39;6;0,395348837209302;0,465116279069767
"14939";89461;86;14939;6;1;19;18;0,0232558139534884;0,232558139534884
"14940";89461;86;14940;6;1;21;20;0,0232558139534884;0,255813953488372
"14941";89461;86;14941;6;3;17;14;0,0465116279069767;0,209302325581395
"14942";89461;86;14942;6;3;19;16;0,0465116279069767;0,232558139534884
"14943";89461;86;14943;6;3;21;18;0,0465116279069767;0,255813953488372
"14944";89864;56;14944;4;15;28;13;0,285714285714286;0,5
"14945";89864;56;14945;5;48;54;6;0,857142857142857;0,964285714285714
"14946";89864;56;14946;5;17;23;6;0,321428571428571;0,428571428571429
"14947";89864;56;14947;5;25;32;7;0,464285714285714;0,571428571428571
"14948";89864;56;14948;5;46;52;6;0,821428571428571;0,928571428571429
"14949";89864;56;14949;5;19;25;6;0,357142857142857;0,464285714285714
"14950";89864;56;14950;5;17;25;8;0,321428571428571;0,464285714285714
"14951";89864;56;14951;5;11;17;6;0,214285714285714;0,321428571428571
"14952";116294;58;14952;3;7;33;26;0,142857142857143;0,571428571428571
"14953";116294;58;14953;3;16;41;25;0,285714285714286;0,714285714285714
"14954";116294;58;14954;4;12;24;12;0,214285714285714;0,428571428571429
"14955";116294;58;14955;4;7;20;13;0,142857142857143;0,357142857142857
"14956";116294;58;14956;4;16;28;12;0,285714285714286;0,5
"14957";116294;58;14957;4;45;58;13;0,785714285714286;1
"14958";116294;58;14958;4;24;37;13;0,428571428571429;0,642857142857143
"14959";116294;58;14959;5;9;15;6;0,172413793103448;0,275862068965517
"14960";116294;58;14960;5;11;17;6;0,206896551724138;0,310344827586207
"14961";116294;58;14961;5;13;19;6;0,241379310344828;0,344827586206897
"14962";116294;58;14962;5;19;25;6;0,344827586206897;0,448275862068966
"14963";116294;58;14963;5;21;27;6;0,379310344827586;0,482758620689655
"14964";116294;58;14964;5;5;11;6;0,103448275862069;0,206896551724138
"14965";116294;58;14965;5;27;34;7;0,482758620689655;0,586206896551724
"14966";116294;58;14966;5;27;36;9;0,482758620689655;0,620689655172414
"14967";116294;58;14967;5;30;36;6;0,517241379310345;0,620689655172414
"14968";116294;58;14968;5;40;46;6;0,689655172413793;0,793103448275862
"14969";116294;58;14969;5;48;54;6;0,827586206896552;0,931034482758621
"14970";116294;58;14970;5;25;32;7;0,448275862068966;0,551724137931034
"14971";116294;58;14971;5;38;44;6;0,655172413793103;0,758620689655172
"14972";116294;58;14972;5;52;58;6;0,896551724137931;1
"14973";116294;58;14973;5;17;23;6;0,310344827586207;0,413793103448276
"14974";116294;58;14974;5;19;27;8;0,344827586206897;0,482758620689655
"14975";116294;58;14975;5;11;19;8;0,206896551724138;0,344827586206897
"14976";116294;58;14976;5;15;21;6;0,275862068965517;0,379310344827586
"14977";116294;58;14977;5;50;56;6;0,862068965517241;0,96551724137931
"14978";116294;58;14978;5;3;9;6;0,0689655172413793;0,172413793103448
"14979";116294;58;14979;5;17;25;8;0,310344827586207;0,448275862068966
"14980";132021;85;14980;4;59;85;26;0,7;1
"14981";132021;85;14981;5;65;77;12;0,761904761904762;0,904761904761905
"14982";132021;85;14982;5;69;81;12;0,80952380952381;0,952380952380952
"14983";132021;85;14983;5;65;81;16;0,761904761904762;0,952380952380952
"14984";132021;85;14984;5;28;40;12;0,333333333333333;0,476190476190476
"14985";132021;85;14985;5;32;44;12;0,380952380952381;0,523809523809524
"14986";132021;85;14986;5;44;56;12;0,523809523809524;0,666666666666667
"14987";132021;85;14987;5;60;73;13;0,714285714285714;0,857142857142857
"14988";132021;85;14988;5;40;52;12;0,476190476190476;0,619047619047619
"14989";132021;85;14989;5;73;85;12;0,857142857142857;1
"14990";132021;85;14990;6;75;81;6;0,883720930232558;0,953488372093023
"14991";132021;85;14991;6;47;53;6;0,558139534883721;0,627906976744186
"14992";132021;85;14992;6;65;71;6;0,767441860465116;0,837209302325581
"14993";132021;85;14993;6;33;39;6;0,395348837209302;0,465116279069767
"14994";132021;85;14994;6;49;55;6;0,581395348837209;0,651162790697674
"14995";132021;85;14995;6;63;69;6;0,744186046511628;0,813953488372093
"14996";132021;85;14996;6;73;79;6;0,86046511627907;0,930232558139535
"14997";132021;85;14997;6;73;81;8;0,86046511627907;0,953488372093023
"14998";132021;85;14998;6;31;37;6;0,372093023255814;0,441860465116279
"14999";132021;85;14999;6;31;39;8;0,372093023255814;0,465116279069767
"15000";132021;85;15000;6;9;15;6;0,116279069767442;0,186046511627907
"15001";132021;85;15001;6;45;51;6;0,534883720930233;0,604651162790698
"15002";132021;85;15002;6;71;77;6;0,837209302325581;0,906976744186046
"15003";132021;85;15003;6;73;83;10;0,86046511627907;0,976744186046512
"15004";132021;85;15004;6;75;83;8;0,883720930232558;0,976744186046512
"15005";132021;85;15005;6;77;83;6;0,906976744186046;0,976744186046512
"15006";132021;85;15006;6;3;9;6;0,0465116279069767;0,116279069767442
"15007";132021;85;15007;6;63;71;8;0,744186046511628;0,837209302325581
"15008";132021;85;15008;6;67;73;6;0,790697674418605;0,86046511627907
"15009";132021;85;15009;6;29;35;6;0,348837209302326;0,418604651162791
"15010";132021;85;15010;6;49;57;8;0,581395348837209;0,674418604651163
"15011";132021;85;15011;6;51;57;6;0,604651162790698;0,674418604651163
"15012";132021;85;15012;6;71;79;8;0,837209302325581;0,930232558139535
"15013";132021;85;15013;6;61;67;6;0,720930232558139;0,790697674418605
"15014";132021;85;15014;6;71;81;10;0,837209302325581;0,953488372093023
"15015";132021;85;15015;6;71;83;12;0,837209302325581;0,976744186046512
"15016";132021;85;15016;6;61;69;8;0,720930232558139;0,813953488372093
"15017";132021;85;15017;6;67;75;8;0,790697674418605;0,883720930232558
"15018";132021;85;15018;6;53;59;6;0,627906976744186;0,697674418604651
"15019";132021;85;15019;6;59;65;6;0,697674418604651;0,767441860465116
"15020";132068;59;15020;3;8;33;25;0,142857142857143;0,571428571428571
"15021";132068;59;15021;3;25;50;25;0,428571428571429;0,857142857142857
"15022";132068;59;15022;3;16;42;26;0,285714285714286;0,714285714285714
"15023";132068;59;15023;3;25;59;34;0,428571428571429;1
"15024";132068;59;15024;4;11;23;12;0,2;0,4
"15025";132068;59;15025;4;47;59;12;0,8;1
"15026";132068;59;15026;4;27;39;12;0,466666666666667;0,666666666666667
"15027";132068;59;15027;4;27;43;16;0,466666666666667;0,733333333333333
"15028";132068;59;15028;4;31;43;12;0,533333333333333;0,733333333333333
"15029";132068;59;15029;4;43;55;12;0,733333333333333;0,933333333333333
"15030";132068;59;15030;4;27;47;20;0,466666666666667;0,8
"15031";132068;59;15031;4;27;51;24;0,466666666666667;0,866666666666667
"15032";132068;59;15032;4;31;47;16;0,533333333333333;0,8
"15033";132068;59;15033;4;31;51;20;0,533333333333333;0,866666666666667
"15034";132068;59;15034;4;31;55;24;0,533333333333333;0,933333333333333
"15035";132068;59;15035;4;31;59;28;0,533333333333333;1
"15036";132068;59;15036;4;35;47;12;0,6;0,8
"15037";132068;59;15037;4;43;59;16;0,733333333333333;1
"15038";132068;59;15038;4;15;27;12;0,266666666666667;0,466666666666667
"15039";132068;59;15039;4;19;31;12;0,333333333333333;0,533333333333333
"15040";132068;59;15040;4;19;35;16;0,333333333333333;0,6
"15041";132068;59;15041;4;27;55;28;0,466666666666667;0,933333333333333
"15042";132068;59;15042;4;27;59;32;0,466666666666667;1
"15043";132068;59;15043;4;23;35;12;0,4;0,6
"15044";132068;59;15044;4;23;39;16;0,4;0,666666666666667
"15045";132068;59;15045;4;15;31;16;0,266666666666667;0,533333333333333
"15046";132068;59;15046;4;11;27;16;0,2;0,466666666666667
"15047";132068;59;15047;4;15;35;20;0,266666666666667;0,6
"15048";132068;59;15048;5;15;21;6;0,266666666666667;0,366666666666667
"15049";132068;59;15049;5;21;27;6;0,366666666666667;0,466666666666667
"15050";132068;59;15050;5;27;33;6;0,466666666666667;0,566666666666667
"15051";132068;59;15051;5;27;35;8;0,466666666666667;0,6
"15052";132068;59;15052;5;47;53;6;0,8;0,9
"15053";132068;59;15053;5;47;55;8;0,8;0,933333333333333
"15054";132068;59;15054;5;33;39;6;0,566666666666667;0,666666666666667
"15055";132068;59;15055;5;37;43;6;0,633333333333333;0,733333333333333
"15056";132068;59;15056;5;39;45;6;0,666666666666667;0,766666666666667
"15057";132068;59;15057;5;43;49;6;0,733333333333333;0,833333333333333
"15058";132068;59;15058;5;43;51;8;0,733333333333333;0,866666666666667
"15059";132068;59;15059;5;45;51;6;0,766666666666667;0,866666666666667
"15060";132068;59;15060;5;45;53;8;0,766666666666667;0,9
"15061";132068;59;15061;5;45;55;10;0,766666666666667;0,933333333333333
"15062";132068;59;15062;5;45;57;12;0,766666666666667;0,966666666666667
"15063";132068;59;15063;5;45;59;14;0,766666666666667;1
"15064";132068;59;15064;5;47;57;10;0,8;0,966666666666667
"15065";132068;59;15065;5;47;59;12;0,8;1
"15066";132068;59;15066;5;11;17;6;0,2;0,3
"15067";132068;59;15067;5;27;37;10;0,466666666666667;0,633333333333333
"15068";132068;59;15068;5;27;39;12;0,466666666666667;0,666666666666667
"15069";132068;59;15069;5;29;35;6;0,5;0,6
"15070";132068;59;15070;5;29;37;8;0,5;0,633333333333333
"15071";132068;59;15071;5;29;39;10;0,5;0,666666666666667
"15072";132068;59;15072;5;29;41;12;0,5;0,7
"15073";132068;59;15073;5;35;41;6;0,6;0,7
"15074";132068;59;15074;5;43;53;10;0,733333333333333;0,9
"15075";132068;59;15075;5;43;55;12;0,733333333333333;0,933333333333333
"15076";132068;59;15076;5;43;57;14;0,733333333333333;0,966666666666667
"15077";132068;59;15077;5;17;23;6;0,3;0,4
"15078";132068;59;15078;5;17;25;8;0,3;0,433333333333333
"15079";132068;59;15079;5;27;41;14;0,466666666666667;0,7
"15080";132068;59;15080;5;27;43;16;0,466666666666667;0,733333333333333
"15081";132068;59;15081;5;27;45;18;0,466666666666667;0,766666666666667
"15082";132068;59;15082;5;27;47;20;0,466666666666667;0,8
"15083";132068;59;15083;5;35;43;8;0,6;0,733333333333333
"15084";132068;59;15084;5;35;45;10;0,6;0,766666666666667
"15085";132068;59;15085;5;35;47;12;0,6;0,8
"15086";132068;59;15086;5;39;47;8;0,666666666666667;0,8
"15087";132068;59;15087;5;39;49;10;0,666666666666667;0,833333333333333
"15088";132068;59;15088;5;39;51;12;0,666666666666667;0,866666666666667
"15089";132068;59;15089;5;39;53;14;0,666666666666667;0,9
"15090";132068;59;15090;5;39;55;16;0,666666666666667;0,933333333333333
"15091";132068;59;15091;5;43;59;16;0,733333333333333;1
"15092";132068;59;15092;5;13;19;6;0,233333333333333;0,333333333333333
"15093";132068;59;15093;5;11;19;8;0,2;0,333333333333333
"15094";132068;59;15094;5;9;15;6;0,166666666666667;0,266666666666667
"15095";132068;59;15095;5;13;21;8;0,233333333333333;0,366666666666667
"15096";132068;59;15096;5;15;23;8;0,266666666666667;0,4
"15097";132068;59;15097;5;39;57;18;0,666666666666667;0,966666666666667
"15098";132068;59;15098;5;39;59;20;0,666666666666667;1
"15099";139581;81;15099;5;28;40;12;0,35;0,5
"15100";139581;81;15100;5;69;81;12;0,85;1
"15101";139581;81;15101;5;65;77;12;0,8;0,95
"15102";139581;81;15102;5;56;69;13;0,7;0,85
"15103";139581;81;15103;5;11;24;13;0,15;0,3
"15104";139581;81;15104;6;73;79;6;0,902439024390244;0,975609756097561
"15105";139581;81;15105;6;9;15;6;0,121951219512195;0,195121951219512
"15106";139581;81;15106;6;17;23;6;0,219512195121951;0,292682926829268
"15107";139581;81;15107;6;49;55;6;0,609756097560976;0,682926829268293
"15108";139581;81;15108;6;17;25;8;0,219512195121951;0,317073170731707
"15109";139581;81;15109;6;19;25;6;0,24390243902439;0,317073170731707
"15110";139581;81;15110;6;35;41;6;0,439024390243902;0,51219512195122
"15111";139581;81;15111;6;55;61;6;0,682926829268293;0,75609756097561
"15112";139581;81;15112;6;15;21;6;0,195121951219512;0,268292682926829
"15113";139581;81;15113;6;29;35;6;0,365853658536585;0,439024390243902
"15114";139581;81;15114;6;71;77;6;0,878048780487805;0,951219512195122
"15115";139581;81;15115;6;11;17;6;0,146341463414634;0,219512195121951
"15116";139581;81;15116;6;27;33;6;0,341463414634146;0,414634146341463
"15117";139581;81;15117;6;67;73;6;0,829268292682927;0,902439024390244
"15118";139581;81;15118;6;75;81;6;0,926829268292683;1
"15119";139581;81;15119;6;13;19;6;0,170731707317073;0,24390243902439
"15120";139581;81;15120;6;57;63;6;0,707317073170732;0,780487804878049
"15121";139581;81;15121;6;69;75;6;0,853658536585366;0,926829268292683
"15122";155830;95;15122;4;47;71;24;0,5;0,75
"15123";155830;95;15123;4;71;95;24;0,75;1
"15124";155830;95;15124;4;39;63;24;0,416666666666667;0,666666666666667
"15125";155830;95;15125;4;39;71;32;0,416666666666667;0,75
"15126";155830;95;15126;5;47;59;12;0,5;0,625
"15127";155830;95;15127;5;83;95;12;0,875;1
"15128";155830;95;15128;5;47;63;16;0,5;0,666666666666667
"15129";155830;95;15129;5;79;91;12;0,833333333333333;0,958333333333333
"15130";155830;95;15130;5;27;39;12;0,291666666666667;0,416666666666667
"15131";155830;95;15131;5;47;67;20;0,5;0,708333333333333
"15132";155830;95;15132;5;47;71;24;0,5;0,75
"15133";155830;95;15133;5;75;87;12;0,791666666666667;0,916666666666667
"15134";155830;95;15134;5;79;95;16;0,833333333333333;1
"15135";155830;95;15135;5;43;55;12;0,458333333333333;0,583333333333333
"15136";155830;95;15136;5;75;91;16;0,791666666666667;0,958333333333333
"15137";155830;95;15137;5;43;59;16;0,458333333333333;0,625
"15138";155830;95;15138;5;43;63;20;0,458333333333333;0,666666666666667
"15139";155830;95;15139;5;43;67;24;0,458333333333333;0,708333333333333
"15140";155830;95;15140;5;71;83;12;0,75;0,875
"15141";155830;95;15141;5;75;95;20;0,791666666666667;1
"15142";155830;95;15142;6;45;51;6;0,479166666666667;0,541666666666667
"15143";155830;95;15143;6;81;87;6;0,854166666666667;0,916666666666667
"15144";155830;95;15144;6;25;31;6;0,270833333333333;0,333333333333333
"15145";155830;95;15145;6;45;53;8;0,479166666666667;0,5625
"15146";155830;95;15146;6;45;55;10;0,479166666666667;0,583333333333333
"15147";155830;95;15147;6;45;57;12;0,479166666666667;0,604166666666667
"15148";155830;95;15148;6;75;81;6;0,791666666666667;0,854166666666667
"15149";155830;95;15149;6;81;89;8;0,854166666666667;0,9375
"15150";155830;95;15150;6;81;91;10;0,854166666666667;0,958333333333333
"15151";155830;95;15151;6;81;93;12;0,854166666666667;0,979166666666667
"15152";155830;95;15152;6;83;89;6;0,875;0,9375
"15153";155830;95;15153;6;25;33;8;0,270833333333333;0,354166666666667
"15154";155830;95;15154;6;25;35;10;0,270833333333333;0,375
"15155";155830;95;15155;6;25;37;12;0,270833333333333;0,395833333333333
"15156";155830;95;15156;6;45;59;14;0,479166666666667;0,625
"15157";155830;95;15157;6;3;9;6;0,0416666666666667;0,104166666666667
"15158";155830;95;15158;6;17;23;6;0,1875;0,25
"15159";155830;95;15159;6;79;85;6;0,833333333333333;0,895833333333333
"15160";155830;95;15160;6;79;87;8;0,833333333333333;0,916666666666667
"15161";155830;95;15161;6;5;11;6;0,0625;0,125
"15162";155830;95;15162;6;77;83;6;0,8125;0,875
"15163";155830;95;15163;6;77;85;8;0,8125;0,895833333333333
"15164";155830;95;15164;6;79;89;10;0,833333333333333;0,9375
"15165";155830;95;15165;6;45;61;16;0,479166666666667;0,645833333333333
"15166";155830;95;15166;6;45;63;18;0,479166666666667;0,666666666666667
"15167";155830;95;15167;6;45;65;20;0,479166666666667;0,6875
"15168";155830;95;15168;6;75;83;8;0,791666666666667;0,875
"15169";155830;95;15169;6;75;85;10;0,791666666666667;0,895833333333333
"15170";155830;95;15170;6;75;87;12;0,791666666666667;0,916666666666667
"15171";155830;95;15171;6;75;89;14;0,791666666666667;0,9375
"15172";155830;95;15172;6;75;91;16;0,791666666666667;0,958333333333333
"15173";155830;95;15173;6;75;93;18;0,791666666666667;0,979166666666667
"15174";155830;95;15174;6;75;95;20;0,791666666666667;1
"15175";155830;95;15175;6;77;87;10;0,8125;0,916666666666667
"15176";155830;95;15176;6;77;89;12;0,8125;0,9375
"15177";155830;95;15177;6;77;91;14;0,8125;0,958333333333333
"15178";155830;95;15178;6;77;93;16;0,8125;0,979166666666667
"15179";155830;95;15179;6;77;95;18;0,8125;1
"15180";155830;95;15180;6;79;91;12;0,833333333333333;0,958333333333333
"15181";155830;95;15181;6;79;93;14;0,833333333333333;0,979166666666667
"15182";155830;95;15182;6;79;95;16;0,833333333333333;1
"15183";155830;95;15183;6;81;95;14;0,854166666666667;1
"15184";155830;95;15184;6;73;79;6;0,770833333333333;0,833333333333333
"15185";155830;95;15185;6;23;29;6;0,25;0,3125
"15186";155830;95;15186;6;25;39;14;0,270833333333333;0,416666666666667
"15187";155830;95;15187;6;25;41;16;0,270833333333333;0,4375
"15188";155830;95;15188;6;83;91;8;0,875;0,958333333333333
"15189";155830;95;15189;6;83;93;10;0,875;0,979166666666667
"15190";155830;95;15190;6;83;95;12;0,875;1
"15191";155830;95;15191;6;43;49;6;0,458333333333333;0,520833333333333
"15192";155830;95;15192;6;43;51;8;0,458333333333333;0,541666666666667
"15193";155830;95;15193;6;45;67;22;0,479166666666667;0,708333333333333
"15194";155830;95;15194;6;43;53;10;0,458333333333333;0,5625
"15195";264758;36;15195;4;11;24;13;0,333333333333333;0,666666666666667
"15196";264758;36;15196;4;24;36;12;0,666666666666667;1
"15197";264758;36;15197;5;11;18;7;0,333333333333333;0,5
"15198";264758;36;15198;5;28;34;6;0,777777777777778;0,944444444444444
"15199";264758;36;15199;5;11;20;9;0,333333333333333;0,555555555555556
"15200";264758;36;15200;5;13;20;7;0,388888888888889;0,555555555555556
"15201";264758;36;15201;5;15;22;7;0,444444444444444;0,611111111111111
"15202";264758;36;15202;5;18;24;6;0,5;0,666666666666667
"15203";264758;36;15203;5;26;32;6;0,722222222222222;0,888888888888889
"15204";264758;36;15204;5;9;15;6;0,277777777777778;0,444444444444444
"15205";264758;36;15205;5;15;24;9;0,444444444444444;0,666666666666667
"15206";264758;36;15206;5;24;30;6;0,666666666666667;0,833333333333333
"15207";264758;36;15207;5;24;32;8;0,666666666666667;0,888888888888889
"15208";264758;36;15208;5;26;34;8;0,722222222222222;0,944444444444444
"15209";264758;36;15209;5;11;22;11;0,333333333333333;0,611111111111111
"15210";264758;36;15210;5;11;24;13;0,333333333333333;0,666666666666667
"15211";264758;36;15211;5;24;34;10;0,666666666666667;0,944444444444444
"15212";264758;36;15212;5;13;22;9;0,388888888888889;0,611111111111111
"15213";264758;36;15213;5;9;18;9;0,277777777777778;0,5
"15214";264758;36;15214;5;9;20;11;0,277777777777778;0,555555555555556
"15215";264758;36;15215;5;13;24;11;0,388888888888889;0,666666666666667
"15216";264758;36;15216;5;20;26;6;0,555555555555556;0,722222222222222
"15217";292974;88;15217;4;48;72;24;0,545454545454545;0,818181818181818
"15218";292974;88;15218;4;56;80;24;0,636363636363636;0,909090909090909
"15219";292974;88;15219;5;23;35;12;0,272727272727273;0,409090909090909
"15220";292974;88;15220;5;44;56;12;0,5;0,636363636363636
"15221";292974;88;15221;5;3;15;12;0,0454545454545455;0,181818181818182
"15222";292974;88;15222;5;7;19;12;0,0909090909090909;0,227272727272727
"15223";292974;88;15223;5;7;23;16;0,0909090909090909;0,272727272727273
"15224";292974;88;15224;5;11;23;12;0,136363636363636;0,272727272727273
"15225";292974;88;15225;5;15;27;12;0,181818181818182;0,318181818181818
"15226";292974;88;15226;5;19;31;12;0,227272727272727;0,363636363636364
"15227";292974;88;15227;5;39;52;13;0,454545454545455;0,590909090909091
"15228";292974;88;15228;5;52;64;12;0,590909090909091;0,727272727272727
"15229";292974;88;15229;5;56;68;12;0,636363636363636;0,772727272727273
"15230";292974;88;15230;5;60;72;12;0,681818181818182;0,818181818181818
"15231";292974;88;15231;5;60;76;16;0,681818181818182;0,863636363636364
"15232";292974;88;15232;5;64;76;12;0,727272727272727;0,863636363636364
"15233";292974;88;15233;5;68;80;12;0,772727272727273;0,909090909090909
"15234";292974;88;15234;5;35;48;13;0,409090909090909;0,545454545454545
"15235";292974;88;15235;5;48;60;12;0,545454545454545;0,681818181818182
"15236";292974;88;15236;5;52;68;16;0,590909090909091;0,772727272727273
"15237";292974;88;15237;6;41;48;7;0,477272727272727;0,545454545454545
"15238";292974;88;15238;6;19;25;6;0,227272727272727;0,295454545454545
"15239";292974;88;15239;6;50;56;6;0,568181818181818;0,636363636363636
"15240";292974;88;15240;6;7;13;6;0,0909090909090909;0,159090909090909
"15241";292974;88;15241;6;9;15;6;0,113636363636364;0,181818181818182
"15242";292974;88;15242;6;9;17;8;0,113636363636364;0,204545454545455
"15243";292974;88;15243;6;17;23;6;0,204545454545455;0,272727272727273
"15244";292974;88;15244;6;17;25;8;0,204545454545455;0,295454545454545
"15245";292974;88;15245;6;27;33;6;0,318181818181818;0,386363636363636
"15246";292974;88;15246;6;44;50;6;0,5;0,568181818181818
"15247";292974;88;15247;6;50;58;8;0,568181818181818;0,659090909090909
"15248";292974;88;15248;6;58;64;6;0,659090909090909;0,727272727272727
"15249";292974;88;15249;6;60;66;6;0,681818181818182;0,75
"15250";292974;88;15250;6;64;70;6;0,727272727272727;0,795454545454545
"15251";292974;88;15251;6;68;74;6;0,772727272727273;0,840909090909091
"15252";292974;88;15252;6;68;76;8;0,772727272727273;0,863636363636364
"15253";292974;88;15253;6;70;76;6;0,795454545454545;0,863636363636364
"15254";292974;88;15254;6;1;7;6;0,0227272727272727;0,0909090909090909
"15255";292974;88;15255;6;3;9;6;0,0454545454545455;0,113636363636364
"15256";292974;88;15256;6;5;11;6;0,0681818181818182;0,136363636363636
"15257";292974;88;15257;6;7;15;8;0,0909090909090909;0,181818181818182
"15258";292974;88;15258;6;11;17;6;0,136363636363636;0,204545454545455
"15259";292974;88;15259;6;15;21;6;0,181818181818182;0,25
"15260";292974;88;15260;6;15;23;8;0,181818181818182;0,272727272727273
"15261";292974;88;15261;6;29;35;6;0,340909090909091;0,409090909090909
"15262";292974;88;15262;6;52;58;6;0,590909090909091;0,659090909090909
"15263";292974;88;15263;6;62;68;6;0,704545454545455;0,772727272727273
"15264";292974;88;15264;6;66;72;6;0,75;0,818181818181818
"15265";292974;88;15265;6;39;46;7;0,454545454545455;0,522727272727273
"15266";292974;88;15266;6;82;88;6;0,931818181818182;1
"15267";292974;88;15267;6;25;31;6;0,295454545454545;0,363636363636364
"15268";292974;88;15268;6;5;13;8;0,0681818181818182;0,159090909090909
"15269";292974;88;15269;6;35;41;6;0,409090909090909;0,477272727272727
"15270";292974;88;15270;6;41;50;9;0,477272727272727;0,568181818181818
"15271";292974;88;15271;6;60;68;8;0,681818181818182;0,772727272727273
"15272";292974;88;15272;6;66;74;8;0,75;0,840909090909091
"15273";292974;88;15273;6;7;17;10;0,0909090909090909;0,204545454545455
"15274";292974;88;15274;6;9;19;10;0,113636363636364;0,227272727272727
"15275";292974;88;15275;6;9;21;12;0,113636363636364;0,25
"15276";292974;88;15276;6;11;19;8;0,136363636363636;0,227272727272727
"15277";292974;88;15277;6;13;19;6;0,159090909090909;0,227272727272727
"15278";292974;88;15278;6;31;37;6;0,363636363636364;0,431818181818182
"15279";292974;88;15279;6;46;52;6;0,522727272727273;0,590909090909091
"15280";292974;88;15280;6;46;54;8;0,522727272727273;0,613636363636364
"15281";292974;88;15281;6;56;62;6;0,636363636363636;0,704545454545455
"15282";292974;88;15282;6;58;66;8;0,659090909090909;0,75
"15283";292974;88;15283;6;80;86;6;0,909090909090909;0,977272727272727
"15284";292974;88;15284;6;80;88;8;0,909090909090909;1
"15285";301544;61;15285;5;43;49;6;0,709677419354839;0,806451612903226
"15286";301544;61;15286;5;43;51;8;0,709677419354839;0,838709677419355
"15287";301544;61;15287;5;1;7;6;0,032258064516129;0,129032258064516
"15288";301544;61;15288;5;3;9;6;0,0645161290322581;0,161290322580645
"15289";308442;42;15289;3;16;42;26;0,4;1
"15290";308442;42;15290;4;16;29;13;0,4;0,7
"15291";308442;42;15291;4;20;33;13;0,5;0,8
"15292";308442;42;15292;4;16;33;17;0,4;0,8
"15293";308442;42;15293;4;16;38;22;0,4;0,9
"15294";308442;42;15294;4;16;42;26;0,4;1
"15295";308442;42;15295;4;20;38;18;0,5;0,9
"15296";308442;42;15296;4;20;42;22;0,5;1
"15297";308442;42;15297;4;12;25;13;0,3;0,6
"15298";308442;42;15298;5;22;28;6;0,523809523809524;0,666666666666667
"15299";308442;42;15299;5;15;22;7;0,380952380952381;0,523809523809524
"15300";308442;42;15300;5;17;24;7;0,428571428571429;0,571428571428571
"15301";308442;42;15301;5;17;26;9;0,428571428571429;0,619047619047619
"15302";308442;42;15302;5;17;28;11;0,428571428571429;0,666666666666667
"15303";308442;42;15303;5;19;26;7;0,476190476190476;0,619047619047619
"15304";308442;42;15304;5;19;28;9;0,476190476190476;0,666666666666667
"15305";308442;42;15305;5;19;30;11;0,476190476190476;0,714285714285714
"15306";308442;42;15306;5;22;30;8;0,523809523809524;0,714285714285714
"15307";308442;42;15307;5;22;32;10;0,523809523809524;0,761904761904762
"15308";308442;42;15308;5;22;34;12;0,523809523809524;0,80952380952381
"15309";308442;42;15309;5;36;42;6;0,857142857142857;1
"15310";308442;42;15310;5;17;30;13;0,428571428571429;0,714285714285714
"15311";308442;42;15311;5;17;32;15;0,428571428571429;0,761904761904762
"15312";308442;42;15312;5;17;34;17;0,428571428571429;0,80952380952381
"15313";308442;42;15313;5;17;36;19;0,428571428571429;0,857142857142857
"15314";308442;42;15314;5;17;38;21;0,428571428571429;0,904761904761905
"15315";308442;42;15315;5;19;32;13;0,476190476190476;0,761904761904762
"15316";308442;42;15316;5;19;34;15;0,476190476190476;0,80952380952381
"15317";308442;42;15317;5;19;36;17;0,476190476190476;0,857142857142857
"15318";308442;42;15318;5;19;38;19;0,476190476190476;0,904761904761905
"15319";308442;42;15319;5;19;40;21;0,476190476190476;0,952380952380952
"15320";308442;42;15320;5;13;19;6;0,333333333333333;0,476190476190476
"15321";308442;42;15321;5;15;24;9;0,380952380952381;0,571428571428571
"15322";308442;42;15322;5;19;42;23;0,476190476190476;1
"15323";308442;42;15323;5;22;36;14;0,523809523809524;0,857142857142857
"15324";308442;42;15324;5;22;38;16;0,523809523809524;0,904761904761905
"15325";308442;42;15325;5;22;40;18;0,523809523809524;0,952380952380952
"15326";308442;42;15326;5;22;42;20;0,523809523809524;1
"15327";308442;42;15327;5;15;26;11;0,380952380952381;0,619047619047619
"15328";308442;42;15328;5;15;28;13;0,380952380952381;0,666666666666667
"15329";308442;42;15329;5;17;40;23;0,428571428571429;0,952380952380952
"15330";308442;42;15330;5;17;42;25;0,428571428571429;1
"15331";308924;90;15331;3;35;90;55;0,4;1
"15332";308924;90;15332;4;49;73;24;0,545454545454545;0,818181818181818
"15333";308924;90;15333;4;57;82;25;0,636363636363636;0,909090909090909
"15334";308924;90;15334;4;32;57;25;0,363636363636364;0,636363636363636
"15335";308924;90;15335;4;65;90;25;0,727272727272727;1
"15336";308924;90;15336;5;16;28;12;0,181818181818182;0,318181818181818
"15337";308924;90;15337;5;53;65;12;0,590909090909091;0,727272727272727
"15338";308924;90;15338;5;53;69;16;0,590909090909091;0,772727272727273
"15339";308924;90;15339;5;57;69;12;0,636363636363636;0,772727272727273
"15340";308924;90;15340;5;32;44;12;0,363636363636364;0,5
"15341";308924;90;15341;5;69;82;13;0,772727272727273;0,909090909090909
"15342";308924;90;15342;5;28;40;12;0,318181818181818;0,454545454545455
"15343";308924;90;15343;5;28;44;16;0,318181818181818;0,5
"15344";308924;90;15344;5;49;61;12;0,545454545454545;0,681818181818182
"15345";308924;90;15345;5;61;73;12;0,681818181818182;0,818181818181818
"15346";308924;90;15346;5;65;78;13;0,727272727272727;0,863636363636364
"15347";308924;90;15347;5;69;86;17;0,772727272727273;0,954545454545455
"15348";308924;90;15348;5;69;90;21;0,772727272727273;1
"15349";308924;90;15349;5;73;86;13;0,818181818181818;0,954545454545455
"15350";308924;90;15350;5;73;90;17;0,818181818181818;1
"15351";308924;90;15351;5;78;90;12;0,863636363636364;1
"15352";308924;90;15352;5;61;78;17;0,681818181818182;0,863636363636364
"15353";308924;90;15353;5;65;82;17;0,727272727272727;0,909090909090909
"15354";308924;90;15354;5;7;20;13;0,0909090909090909;0,227272727272727
"15355";308924;90;15355;5;49;65;16;0,545454545454545;0,727272727272727
"15356";308924;90;15356;5;11;24;13;0,136363636363636;0,272727272727273
"15357";308924;90;15357;6;15;21;6;0,177777777777778;0,244444444444444
"15358";308924;90;15358;6;21;27;6;0,244444444444444;0,311111111111111
"15359";308924;90;15359;6;56;62;6;0,622222222222222;0,688888888888889
"15360";308924;90;15360;6;3;9;6;0,0444444444444444;0,111111111111111
"15361";308924;90;15361;6;5;11;6;0,0666666666666667;0,133333333333333
"15362";308924;90;15362;6;17;23;6;0,2;0,266666666666667
"15363";308924;90;15363;6;27;33;6;0,311111111111111;0,377777777777778
"15364";308924;90;15364;6;29;35;6;0,333333333333333;0,4
"15365";308924;90;15365;6;29;37;8;0,333333333333333;0,422222222222222
"15366";308924;90;15366;6;31;37;6;0,355555555555556;0,422222222222222
"15367";308924;90;15367;6;33;39;6;0,377777777777778;0,444444444444444
"15368";308924;90;15368;6;33;41;8;0,377777777777778;0,466666666666667
"15369";308924;90;15369;6;35;41;6;0,4;0,466666666666667
"15370";308924;90;15370;6;35;43;8;0,4;0,488888888888889
"15371";308924;90;15371;6;37;43;6;0,422222222222222;0,488888888888889
"15372";308924;90;15372;6;50;56;6;0,555555555555556;0,622222222222222
"15373";308924;90;15373;6;52;58;6;0,577777777777778;0,644444444444444
"15374";308924;90;15374;6;60;66;6;0,666666666666667;0,733333333333333
"15375";308924;90;15375;6;62;68;6;0,688888888888889;0,755555555555556
"15376";308924;90;15376;6;68;74;6;0,755555555555556;0,822222222222222
"15377";308924;90;15377;6;70;76;6;0,777777777777778;0,844444444444444
"15378";308924;90;15378;6;70;78;8;0,777777777777778;0,866666666666667
"15379";308924;90;15379;6;70;80;10;0,777777777777778;0,888888888888889
"15380";308924;90;15380;6;72;78;6;0,8;0,866666666666667
"15381";308924;90;15381;6;72;80;8;0,8;0,888888888888889
"15382";308924;90;15382;6;76;82;6;0,844444444444444;0,911111111111111
"15383";308924;90;15383;6;76;84;8;0,844444444444444;0,933333333333333
"15384";308924;90;15384;6;78;84;6;0,866666666666667;0,933333333333333
"15385";308924;90;15385;6;78;86;8;0,866666666666667;0,955555555555556
"15386";308924;90;15386;6;78;88;10;0,866666666666667;0,977777777777778
"15387";308924;90;15387;6;3;11;8;0,0444444444444444;0,133333333333333
"15388";308924;90;15388;6;19;25;6;0,222222222222222;0,288888888888889
"15389";308924;90;15389;6;31;39;8;0,355555555555556;0,444444444444444
"15390";308924;90;15390;6;31;41;10;0,355555555555556;0,466666666666667
"15391";308924;90;15391;6;31;43;12;0,355555555555556;0,488888888888889
"15392";308924;90;15392;6;37;46;9;0,422222222222222;0,511111111111111
"15393";308924;90;15393;6;56;64;8;0,622222222222222;0,711111111111111
"15394";308924;90;15394;6;60;68;8;0,666666666666667;0,755555555555556
"15395";308924;90;15395;6;70;82;12;0,777777777777778;0,911111111111111
"15396";308924;90;15396;6;52;60;8;0,577777777777778;0,666666666666667
"15397";308924;90;15397;6;29;39;10;0,333333333333333;0,444444444444444
"15398";308924;90;15398;6;33;43;10;0,377777777777778;0,488888888888889
"15399";308924;90;15399;6;33;46;13;0,377777777777778;0,511111111111111
"15400";308924;90;15400;6;56;66;10;0,622222222222222;0,733333333333333
"15401";308924;90;15401;6;58;64;6;0,644444444444444;0,711111111111111
"15402";308924;90;15402;6;58;66;8;0,644444444444444;0,733333333333333
"15403";308924;90;15403;6;60;70;10;0,666666666666667;0,777777777777778
"15404";308924;90;15404;6;62;70;8;0,688888888888889;0,777777777777778
"15405";308924;90;15405;6;64;70;6;0,711111111111111;0,777777777777778
"15406";308924;90;15406;6;68;76;8;0,755555555555556;0,844444444444444
"15407";308924;90;15407;6;68;78;10;0,755555555555556;0,866666666666667
"15408";308924;90;15408;6;68;80;12;0,755555555555556;0,888888888888889
"15409";308924;90;15409;6;72;82;10;0,8;0,911111111111111
"15410";308924;90;15410;6;76;86;10;0,844444444444444;0,955555555555556
"15411";308924;90;15411;6;78;90;12;0,866666666666667;1
"15412";308924;90;15412;6;1;7;6;0,0222222222222222;0,0888888888888889
"15413";308924;90;15413;6;23;29;6;0,266666666666667;0,333333333333333
"15414";308924;90;15414;6;29;41;12;0,333333333333333;0,466666666666667
"15415";308924;90;15415;6;56;68;12;0,622222222222222;0,755555555555556
"15416";308924;90;15416;6;68;82;14;0,755555555555556;0,911111111111111
"15417";308924;90;15417;6;70;84;14;0,777777777777778;0,933333333333333
"15418";308924;90;15418;6;70;86;16;0,777777777777778;0,955555555555556
"15419";308924;90;15419;6;70;88;18;0,777777777777778;0,977777777777778
"15420";308924;90;15420;6;70;90;20;0,777777777777778;1
"15421";308924;90;15421;6;50;58;8;0,555555555555556;0,644444444444444
"15422";308924;90;15422;6;72;84;12;0,8;0,933333333333333
"15423";308924;90;15423;6;76;88;12;0,844444444444444;0,977777777777778
"15424";309336;52;15424;4;15;28;13;0,307692307692308;0,538461538461538
"15425";309336;52;15425;4;36;48;12;0,692307692307692;0,923076923076923
"15426";309336;52;15426;4;36;52;16;0,692307692307692;1
"15427";309336;52;15427;4;40;52;12;0,769230769230769;1
"15428";309336;52;15428;4;7;19;12;0,153846153846154;0,384615384615385
"15429";309336;52;15429;4;11;23;12;0,230769230769231;0,461538461538462
"15430";309336;52;15430;4;11;28;17;0,230769230769231;0,538461538461538
"15431";309336;52;15431;5;5;11;6;0,115384615384615;0,230769230769231
"15432";309336;52;15432;5;7;13;6;0,153846153846154;0,269230769230769
"15433";309336;52;15433;5;9;15;6;0,192307692307692;0,307692307692308
"15434";309336;52;15434;5;15;21;6;0,307692307692308;0,423076923076923
"15435";309336;52;15435;5;17;23;6;0,346153846153846;0,461538461538462
"15436";309336;52;15436;5;19;26;7;0,384615384615385;0,5
"15437";309336;52;15437;5;21;28;7;0,423076923076923;0,538461538461538
"15438";309336;52;15438;5;34;40;6;0,653846153846154;0,769230769230769
"15439";309336;52;15439;5;36;42;6;0,692307692307692;0,807692307692308
"15440";309336;52;15440;5;36;44;8;0,692307692307692;0,846153846153846
"15441";309336;52;15441;5;42;48;6;0,807692307692308;0,923076923076923
"15442";309336;52;15442;5;42;50;8;0,807692307692308;0,961538461538462
"15443";309336;52;15443;5;5;13;8;0,115384615384615;0,269230769230769
"15444";309336;52;15444;5;17;26;9;0,346153846153846;0,5
"15445";309336;52;15445;5;17;28;11;0,346153846153846;0,538461538461538
"15446";309336;52;15446;5;19;28;9;0,384615384615385;0,538461538461538
"15447";309336;52;15447;5;28;34;6;0,538461538461538;0,653846153846154
"15448";309336;52;15448;5;36;46;10;0,692307692307692;0,884615384615385
"15449";309336;52;15449;5;42;52;10;0,807692307692308;1
"15450";309336;52;15450;5;5;15;10;0,115384615384615;0,307692307692308
"15451";309336;52;15451;5;9;17;8;0,192307692307692;0,346153846153846
"15452";309336;52;15452;5;15;23;8;0,307692307692308;0,461538461538462
"15453";309336;52;15453;5;15;26;11;0,307692307692308;0,5
"15454";309336;52;15454;5;15;28;13;0,307692307692308;0,538461538461538
"15455";309336;52;15455;5;34;42;8;0,653846153846154;0,807692307692308
"15456";309336;52;15456;5;36;48;12;0,692307692307692;0,923076923076923
"15457";309336;52;15457;5;36;50;14;0,692307692307692;0,961538461538462
"15458";309336;52;15458;5;36;52;16;0,692307692307692;1
"15459";309336;52;15459;5;7;15;8;0,153846153846154;0,307692307692308
"15460";309336;52;15460;5;5;17;12;0,115384615384615;0,346153846153846
"15461";315771;61;15461;4;3;16;13;0,0666666666666667;0,266666666666667
"15462";315771;61;15462;4;3;20;17;0,0666666666666667;0,333333333333333
"15463";315771;61;15463;4;3;24;21;0,0666666666666667;0,4
"15464";315771;61;15464;4;3;28;25;0,0666666666666667;0,466666666666667
"15465";315771;61;15465;4;3;32;29;0,0666666666666667;0,533333333333333
"15466";315771;61;15466;4;3;36;33;0,0666666666666667;0,6
"15467";315771;61;15467;5;1;7;6;0,032258064516129;0,129032258064516
"15468";315771;61;15468;5;1;9;8;0,032258064516129;0,161290322580645
"15469";315771;61;15469;5;1;11;10;0,032258064516129;0,193548387096774
"15470";315771;61;15470;5;1;13;12;0,032258064516129;0,225806451612903
"15471";315771;61;15471;5;1;15;14;0,032258064516129;0,258064516129032
"15472";315771;61;15472;5;1;17;16;0,032258064516129;0,290322580645161
"15473";315771;61;15473;5;3;9;6;0,0645161290322581;0,161290322580645
"15474";315771;61;15474;5;3;11;8;0,0645161290322581;0,193548387096774
"15475";315771;61;15475;5;3;13;10;0,0645161290322581;0,225806451612903
"15476";315771;61;15476;5;3;15;12;0,0645161290322581;0,258064516129032
"15477";315771;61;15477;5;3;17;14;0,0645161290322581;0,290322580645161
"15478";315771;61;15478;5;3;19;16;0,0645161290322581;0,32258064516129
"15479";315771;61;15479;5;55;61;6;0,903225806451613;1
"15480";315771;61;15480;5;45;51;6;0,741935483870968;0,838709677419355
"15481";315771;61;15481;5;45;53;8;0,741935483870968;0,870967741935484
"15482";315771;61;15482;5;47;53;6;0,774193548387097;0,870967741935484
"15483";317799;21;15483;4;1;7;6;0,0909090909090909;0,363636363636364
"15484";317799;21;15484;4;1;9;8;0,0909090909090909;0,454545454545455
"15485";317799;21;15485;4;1;11;10;0,0909090909090909;0,545454545454545
"15486";317799;21;15486;4;1;13;12;0,0909090909090909;0,636363636363636
"15487";317799;21;15487;4;1;15;14;0,0909090909090909;0,727272727272727
"15488";317799;21;15488;4;1;17;16;0,0909090909090909;0,818181818181818
"15489";318015;52;15489;3;26;52;26;0,5;1
"15490";318015;52;15490;4;11;23;12;0,230769230769231;0,461538461538462
"15491";318015;52;15491;4;11;28;17;0,230769230769231;0,538461538461538
"15492";318015;52;15492;4;15;28;13;0,307692307692308;0,538461538461538
"15493";318015;52;15493;4;32;44;12;0,615384615384615;0,846153846153846
"15494";318015;52;15494;4;32;48;16;0,615384615384615;0,923076923076923
"15495";318015;52;15495;4;32;52;20;0,615384615384615;1
"15496";318015;52;15496;4;7;19;12;0,153846153846154;0,384615384615385
"15497";318015;52;15497;4;28;40;12;0,538461538461538;0,769230769230769
"15498";318015;52;15498;5;11;17;6;0,230769230769231;0,346153846153846
"15499";318015;52;15499;5;13;19;6;0,269230769230769;0,384615384615385
"15500";318015;52;15500;5;13;21;8;0,269230769230769;0,423076923076923
"15501";318015;52;15501;5;13;23;10;0,269230769230769;0,461538461538462
"15502";318015;52;15502;5;30;36;6;0,576923076923077;0,692307692307692
"15503";318015;52;15503;5;30;38;8;0,576923076923077;0,730769230769231
"15504";318015;52;15504;5;30;40;10;0,576923076923077;0,769230769230769
"15505";318015;52;15505;5;32;38;6;0,615384615384615;0,730769230769231
"15506";318015;52;15506;5;32;40;8;0,615384615384615;0,769230769230769
"15507";318015;52;15507;5;32;42;10;0,615384615384615;0,807692307692308
"15508";318015;52;15508;5;11;19;8;0,230769230769231;0,384615384615385
"15509";318015;52;15509;5;11;21;10;0,230769230769231;0,423076923076923
"15510";318015;52;15510;5;11;23;12;0,230769230769231;0,461538461538462
"15511";318015;52;15511;5;11;26;15;0,230769230769231;0,5
"15512";318015;52;15512;5;11;28;17;0,230769230769231;0,538461538461538
"15513";318015;52;15513;5;13;26;13;0,269230769230769;0,5
"15514";318015;52;15514;5;13;28;15;0,269230769230769;0,538461538461538
"15515";318015;52;15515;5;30;42;12;0,576923076923077;0,807692307692308
"15516";318015;52;15516;5;30;44;14;0,576923076923077;0,846153846153846
"15517";318015;52;15517;5;30;46;16;0,576923076923077;0,884615384615385
"15518";318015;52;15518;5;30;48;18;0,576923076923077;0,923076923076923
"15519";318015;52;15519;5;30;50;20;0,576923076923077;0,961538461538462
"15520";318015;52;15520;5;32;44;12;0,615384615384615;0,846153846153846
"15521";318015;52;15521;5;32;46;14;0,615384615384615;0,884615384615385
"15522";318015;52;15522;5;32;48;16;0,615384615384615;0,923076923076923
"15523";318015;52;15523;5;32;50;18;0,615384615384615;0,961538461538462
"15524";318015;52;15524;5;32;52;20;0,615384615384615;1
"15525";318015;52;15525;5;9;15;6;0,192307692307692;0,307692307692308
"15526";318015;52;15526;5;9;17;8;0,192307692307692;0,346153846153846
"15527";318015;52;15527;5;9;19;10;0,192307692307692;0,384615384615385
"15528";318015;52;15528;5;9;21;12;0,192307692307692;0,423076923076923
"15529";318015;52;15529;5;9;23;14;0,192307692307692;0,461538461538462
"15530";318015;52;15530;5;28;34;6;0,538461538461538;0,653846153846154
"15531";322065;51;15531;3;25;51;26;0,5;1
"15532";322065;51;15532;4;31;43;12;0,615384615384615;0,846153846153846
"15533";322065;51;15533;4;31;47;16;0,615384615384615;0,923076923076923
"15534";322065;51;15534;4;27;39;12;0,538461538461538;0,769230769230769
"15535";322065;51;15535;4;31;51;20;0,615384615384615;1
"15536";322065;51;15536;4;35;47;12;0,692307692307692;0,923076923076923
"15537";322065;51;15537;4;35;51;16;0,692307692307692;1
"15538";322065;51;15538;4;7;19;12;0,153846153846154;0,384615384615385
"15539";322065;51;15539;5;7;13;6;0,153846153846154;0,269230769230769
"15540";322065;51;15540;5;7;15;8;0,153846153846154;0,307692307692308
"15541";322065;51;15541;5;9;15;6;0,192307692307692;0,307692307692308
"15542";322065;51;15542;5;27;33;6;0,538461538461538;0,653846153846154
"15543";322065;51;15543;5;27;35;8;0,538461538461538;0,692307692307692
"15544";322065;51;15544;5;29;35;6;0,576923076923077;0,692307692307692
"15545";322065;51;15545;5;29;37;8;0,576923076923077;0,730769230769231
"15546";322065;51;15546;5;29;39;10;0,576923076923077;0,769230769230769
"15547";322065;51;15547;5;35;41;6;0,692307692307692;0,807692307692308
"15548";322065;51;15548;5;35;43;8;0,692307692307692;0,846153846153846
"15549";322065;51;15549;5;35;45;10;0,692307692307692;0,884615384615385
"15550";322065;51;15550;5;29;41;12;0,576923076923077;0,807692307692308
"15551";322065;51;15551;5;29;43;14;0,576923076923077;0,846153846153846
"15552";322065;51;15552;5;29;45;16;0,576923076923077;0,884615384615385
"15553";322065;51;15553;5;7;17;10;0,153846153846154;0,346153846153846
"15554";322065;51;15554;5;35;47;12;0,692307692307692;0,923076923076923
"15555";322065;51;15555;5;29;47;18;0,576923076923077;0,923076923076923
"15556";322065;51;15556;5;29;49;20;0,576923076923077;0,961538461538462
"15557";322065;51;15557;5;35;49;14;0,692307692307692;0,961538461538462
"15558";322065;51;15558;5;35;51;16;0,692307692307692;1
"15559";322065;51;15559;5;9;17;8;0,192307692307692;0,346153846153846
"15560";322065;51;15560;5;15;21;6;0,307692307692308;0,423076923076923
"15561";322065;51;15561;5;11;17;6;0,230769230769231;0,346153846153846
"15562";4361;320;15562;5;272;320;48;0,85;1
"15563";4361;320;15563;6;176;200;24;0,55;0,625
"15564";4361;320;15564;6;232;256;24;0,725;0,8
"15565";4361;320;15565;6;296;320;24;0,925;1
"15566";4361;320;15566;6;184;208;24;0,575;0,65
"15567";4361;320;15567;6;280;304;24;0,875;0,95
"15568";4361;320;15568;6;288;312;24;0,9;0,975
"15569";307140;115;15569;3;49;98;49;0,428571428571429;0,857142857142857
"15570";307140;115;15570;3;65;115;50;0,571428571428571;1
"15571";307140;115;15571;3;49;115;66;0,428571428571429;1
"15572";307140;115;15572;4;40;65;25;0,357142857142857;0,571428571428571
"15573";307140;115;15573;4;65;90;25;0,571428571428571;0,785714285714286
"15574";307140;115;15574;4;74;98;24;0,642857142857143;0,857142857142857
"15575";307140;115;15575;4;65;98;33;0,571428571428571;0,857142857142857
"15576";307140;115;15576;4;65;107;42;0,571428571428571;0,928571428571429
"15577";307140;115;15577;4;57;82;25;0,5;0,714285714285714
"15578";307140;115;15578;4;57;90;33;0,5;0,785714285714286
"15579";307140;115;15579;4;57;98;41;0,5;0,857142857142857
"15580";307140;115;15580;4;57;107;50;0,5;0,928571428571429
"15581";307140;115;15581;4;57;115;58;0,5;1
"15582";307140;115;15582;4;65;115;50;0,571428571428571;1
"15583";307140;115;15583;4;74;107;33;0,642857142857143;0,928571428571429
"15584";307140;115;15584;4;74;115;41;0,642857142857143;1
"15585";307140;115;15585;4;49;74;25;0,428571428571429;0,642857142857143
"15586";307140;115;15586;4;49;82;33;0,428571428571429;0,714285714285714
"15587";307140;115;15587;4;40;74;34;0,357142857142857;0,642857142857143
"15588";307140;115;15588;5;47;59;12;0,413793103448276;0,517241379310345
"15589";307140;115;15589;5;63;75;12;0,551724137931034;0,655172413793103
"15590";307140;115;15590;5;67;79;12;0,586206896551724;0,689655172413793
"15591";307140;115;15591;5;67;83;16;0,586206896551724;0,724137931034483
"15592";307140;115;15592;5;71;83;12;0,620689655172414;0,724137931034483
"15593";307140;115;15593;5;35;47;12;0,310344827586207;0,413793103448276
"15594";307140;115;15594;5;47;63;16;0,413793103448276;0,551724137931034
"15595";307140;115;15595;5;51;63;12;0,448275862068966;0,551724137931034
"15596";307140;115;15596;5;63;79;16;0,551724137931034;0,689655172413793
"15597";307140;115;15597;5;63;83;20;0,551724137931034;0,724137931034483
"15598";307140;115;15598;5;63;87;24;0,551724137931034;0,758620689655172
"15599";307140;115;15599;5;67;87;20;0,586206896551724;0,758620689655172
"15600";307140;115;15600;5;67;91;24;0,586206896551724;0,793103448275862
"15601";307140;115;15601;5;67;95;28;0,586206896551724;0,827586206896552
"15602";307140;115;15602;5;71;87;16;0,620689655172414;0,758620689655172
"15603";307140;115;15603;5;71;91;20;0,620689655172414;0,793103448275862
"15604";307140;115;15604;5;71;95;24;0,620689655172414;0,827586206896552
"15605";307140;115;15605;5;63;91;28;0,551724137931034;0,793103448275862
"15606";307140;115;15606;5;63;95;32;0,551724137931034;0,827586206896552
"15607";307140;115;15607;5;63;99;36;0,551724137931034;0,862068965517241
"15608";307140;115;15608;5;63;103;40;0,551724137931034;0,896551724137931
"15609";307140;115;15609;5;63;107;44;0,551724137931034;0,931034482758621
"15610";307140;115;15610;5;63;111;48;0,551724137931034;0,96551724137931
"15611";307140;115;15611;5;67;99;32;0,586206896551724;0,862068965517241
"15612";307140;115;15612;5;67;103;36;0,586206896551724;0,896551724137931
"15613";307140;115;15613;5;67;107;40;0,586206896551724;0,931034482758621
"15614";307140;115;15614;5;67;111;44;0,586206896551724;0,96551724137931
"15615";307140;115;15615;5;43;55;12;0,379310344827586;0,482758620689655
"15616";307140;115;15616;5;67;115;48;0,586206896551724;1
"15617";307140;115;15617;5;71;99;28;0,620689655172414;0,862068965517241
"15618";307140;115;15618;5;71;103;32;0,620689655172414;0,896551724137931
"15619";307140;115;15619;5;71;107;36;0,620689655172414;0,931034482758621
"15620";307140;115;15620;5;71;111;40;0,620689655172414;0,96551724137931
"15621";307140;115;15621;5;71;115;44;0,620689655172414;1
"15622";307140;115;15622;5;39;51;12;0,344827586206897;0,448275862068966
"15623";307140;115;15623;5;59;71;12;0,517241379310345;0,620689655172414
"15624";307140;115;15624;6;41;47;6;0,362068965517241;0,413793103448276
"15625";307140;115;15625;6;47;53;6;0,413793103448276;0,46551724137931
"15626";307140;115;15626;6;51;57;6;0,448275862068966;0,5
"15627";307140;115;15627;6;63;69;6;0,551724137931034;0,603448275862069
"15628";307140;115;15628;6;69;75;6;0,603448275862069;0,655172413793103
"15629";307140;115;15629;6;35;41;6;0,310344827586207;0,362068965517241
"15630";307140;115;15630;6;37;43;6;0,327586206896552;0,379310344827586
"15631";307140;115;15631;6;47;55;8;0,413793103448276;0,482758620689655
"15632";307140;115;15632;6;47;57;10;0,413793103448276;0,5
"15633";307140;115;15633;6;47;59;12;0,413793103448276;0,517241379310345
"15634";307140;115;15634;6;51;59;8;0,448275862068966;0,517241379310345
"15635";307140;115;15635;6;51;61;10;0,448275862068966;0,53448275862069
"15636";307140;115;15636;6;61;67;6;0,53448275862069;0,586206896551724
"15637";307140;115;15637;6;61;69;8;0,53448275862069;0,603448275862069
"15638";307140;115;15638;6;63;71;8;0,551724137931034;0,620689655172414
"15639";307140;115;15639;6;63;73;10;0,551724137931034;0,637931034482759
"15640";307140;115;15640;6;63;75;12;0,551724137931034;0,655172413793103
"15641";307140;115;15641;6;65;71;6;0,568965517241379;0,620689655172414
"15642";307140;115;15642;6;65;73;8;0,568965517241379;0,637931034482759
"15643";307140;115;15643;6;65;75;10;0,568965517241379;0,655172413793103
"15644";307140;115;15644;6;69;77;8;0,603448275862069;0,672413793103448
"15645";307140;115;15645;6;69;79;10;0,603448275862069;0,689655172413793
"15646";307140;115;15646;6;69;81;12;0,603448275862069;0,706896551724138
"15647";307140;115;15647;6;43;49;6;0,379310344827586;0,431034482758621
"15648";307140;115;15648;6;47;61;14;0,413793103448276;0,53448275862069
"15649";307140;115;15649;6;61;71;10;0,53448275862069;0,620689655172414
"15650";307140;115;15650;6;63;77;14;0,551724137931034;0,672413793103448
"15651";307140;115;15651;6;63;79;16;0,551724137931034;0,689655172413793
"15652";307140;115;15652;6;63;81;18;0,551724137931034;0,706896551724138
"15653";307140;115;15653;6;63;83;20;0,551724137931034;0,724137931034483
"15654";307140;115;15654;6;63;85;22;0,551724137931034;0,741379310344828
"15655";307140;115;15655;6;63;87;24;0,551724137931034;0,758620689655172
"15656";307140;115;15656;6;65;77;12;0,568965517241379;0,672413793103448
"15657";307140;115;15657;6;65;79;14;0,568965517241379;0,689655172413793
"15658";307140;115;15658;6;65;81;16;0,568965517241379;0,706896551724138
"15659";307140;115;15659;6;65;83;18;0,568965517241379;0,724137931034483
"15660";307140;115;15660;6;65;85;20;0,568965517241379;0,741379310344828
"15661";307140;115;15661;6;65;87;22;0,568965517241379;0,758620689655172
"15662";307140;115;15662;6;65;89;24;0,568965517241379;0,775862068965517
"15663";307140;115;15663;6;69;83;14;0,603448275862069;0,724137931034483
"15664";307140;115;15664;6;69;85;16;0,603448275862069;0,741379310344828
"15665";307140;115;15665;6;69;87;18;0,603448275862069;0,758620689655172
"15666";307140;115;15666;6;69;89;20;0,603448275862069;0,775862068965517
"15667";307140;115;15667;6;69;91;22;0,603448275862069;0,793103448275862
"15668";307140;115;15668;6;69;93;24;0,603448275862069;0,810344827586207
"15669";307140;115;15669;6;21;27;6;0,189655172413793;0,241379310344828
"15670";307140;115;15670;6;27;33;6;0,241379310344828;0,293103448275862
"15671";307140;115;15671;6;29;35;6;0,258620689655172;0,310344827586207
"15672";307140;115;15672;6;65;91;26;0,568965517241379;0,793103448275862
"15673";307140;115;15673;6;65;93;28;0,568965517241379;0,810344827586207
"15674";307140;115;15674;6;65;95;30;0,568965517241379;0,827586206896552
"15675";307140;115;15675;6;19;25;6;0,172413793103448;0,224137931034483
"15676";307140;115;15676;6;23;29;6;0,206896551724138;0,258620689655172
"15677";307140;115;15677;6;37;45;8;0,327586206896552;0,396551724137931
"15678";307140;115;15678;6;39;45;6;0,344827586206897;0,396551724137931
"15679";307140;115;15679;6;39;47;8;0,344827586206897;0,413793103448276
"15680";307140;115;15680;6;51;63;12;0,448275862068966;0,551724137931034
"15681";307140;115;15681;6;61;73;12;0,53448275862069;0,637931034482759
"15682";307140;115;15682;6;9;15;6;0,0862068965517241;0,137931034482759
"15683";325178;110;15683;4;76;101;25;0,692307692307692;0,923076923076923
"15684";325178;110;15684;4;67;93;26;0,615384615384615;0,846153846153846
"15685";325178;110;15685;4;67;101;34;0,615384615384615;0,923076923076923
"15686";325178;110;15686;4;76;110;34;0,692307692307692;1
"15687";325178;110;15687;4;84;110;26;0,769230769230769;1
"15688";325178;110;15688;4;16;42;26;0,153846153846154;0,384615384615385
"15689";325178;110;15689;4;25;50;25;0,230769230769231;0,461538461538462
"15690";325178;110;15690;5;69;81;12;0,62962962962963;0,740740740740741
"15691";325178;110;15691;5;81;94;13;0,740740740740741;0,851851851851852
"15692";325178;110;15692;5;81;98;17;0,740740740740741;0,888888888888889
"15693";325178;110;15693;5;85;98;13;0,777777777777778;0,888888888888889
"15694";325178;110;15694;5;85;102;17;0,777777777777778;0,925925925925926
"15695";325178;110;15695;5;89;102;13;0,814814814814815;0,925925925925926
"15696";325178;110;15696;5;89;106;17;0,814814814814815;0,962962962962963
"15697";325178;110;15697;5;28;40;12;0,259259259259259;0,37037037037037
"15698";325178;110;15698;5;77;89;12;0,703703703703704;0,814814814814815
"15699";325178;110;15699;5;77;94;17;0,703703703703704;0,851851851851852
"15700";325178;110;15700;5;77;98;21;0,703703703703704;0,888888888888889
"15701";325178;110;15701;5;77;102;25;0,703703703703704;0,925925925925926
"15702";325178;110;15702;5;77;106;29;0,703703703703704;0,962962962962963
"15703";325178;110;15703;5;81;102;21;0,740740740740741;0,925925925925926
"15704";325178;110;15704;5;81;106;25;0,740740740740741;0,962962962962963
"15705";325178;110;15705;5;85;106;21;0,777777777777778;0,962962962962963
"15706";325178;110;15706;5;24;36;12;0,222222222222222;0,333333333333333
"15707";325178;110;15707;5;57;69;12;0,518518518518518;0,62962962962963
"15708";325178;110;15708;5;61;73;12;0,555555555555556;0,666666666666667
"15709";325178;110;15709;5;73;85;12;0,666666666666667;0,777777777777778
"15710";325178;110;15710;5;73;89;16;0,666666666666667;0,814814814814815
"15711";325178;110;15711;5;77;110;33;0,703703703703704;1
"15712";325178;110;15712;5;81;110;29;0,740740740740741;1
"15713";325178;110;15713;5;85;110;25;0,777777777777778;1
"15714";325178;110;15714;5;89;110;21;0,814814814814815;1
"15715";325178;110;15715;6;17;23;6;0,163636363636364;0,218181818181818
"15716";325178;110;15716;6;25;31;6;0,236363636363636;0,290909090909091
"15717";325178;110;15717;6;27;33;6;0,254545454545455;0,309090909090909
"15718";325178;110;15718;6;70;76;6;0,636363636363636;0,690909090909091
"15719";325178;110;15719;6;70;78;8;0,636363636363636;0,709090909090909
"15720";325178;110;15720;6;72;78;6;0,654545454545455;0,709090909090909
"15721";325178;110;15721;6;80;86;6;0,727272727272727;0,781818181818182
"15722";325178;110;15722;6;82;88;6;0,745454545454545;0,8
"15723";325178;110;15723;6;86;92;6;0,781818181818182;0,836363636363636
"15724";325178;110;15724;6;86;94;8;0,781818181818182;0,854545454545454
"15725";325178;110;15725;6;88;94;6;0,8;0,854545454545454
"15726";325178;110;15726;6;88;96;8;0,8;0,872727272727273
"15727";325178;110;15727;6;90;96;6;0,818181818181818;0,872727272727273
"15728";325178;110;15728;6;90;98;8;0,818181818181818;0,890909090909091
"15729";325178;110;15729;6;11;17;6;0,109090909090909;0,163636363636364
"15730";325178;110;15730;6;17;25;8;0,163636363636364;0,236363636363636
"15731";325178;110;15731;6;19;25;6;0,181818181818182;0,236363636363636
"15732";325178;110;15732;6;27;35;8;0,254545454545455;0,327272727272727
"15733";325178;110;15733;6;29;35;6;0,272727272727273;0,327272727272727
"15734";325178;110;15734;6;29;37;8;0,272727272727273;0,345454545454545
"15735";325178;110;15735;6;31;37;6;0,290909090909091;0,345454545454545
"15736";325178;110;15736;6;31;39;8;0,290909090909091;0,363636363636364
"15737";325178;110;15737;6;33;39;6;0,309090909090909;0,363636363636364
"15738";325178;110;15738;6;43;49;6;0,4;0,454545454545455
"15739";325178;110;15739;6;72;80;8;0,654545454545455;0,727272727272727
"15740";325178;110;15740;6;76;82;6;0,690909090909091;0,745454545454545
"15741";325178;110;15741;6;78;84;6;0,709090909090909;0,763636363636364
"15742";325178;110;15742;6;78;86;8;0,709090909090909;0,781818181818182
"15743";325178;110;15743;6;78;88;10;0,709090909090909;0,8
"15744";325178;110;15744;6;78;90;12;0,709090909090909;0,818181818181818
"15745";325178;110;15745;6;78;92;14;0,709090909090909;0,836363636363636
"15746";325178;110;15746;6;78;94;16;0,709090909090909;0,854545454545454
"15747";325178;110;15747;6;78;96;18;0,709090909090909;0,872727272727273
"15748";325178;110;15748;6;80;88;8;0,727272727272727;0,8
"15749";325178;110;15749;6;80;90;10;0,727272727272727;0,818181818181818
"15750";325178;110;15750;6;80;92;12;0,727272727272727;0,836363636363636
"15751";325178;110;15751;6;80;94;14;0,727272727272727;0,854545454545454
"15752";325178;110;15752;6;82;90;8;0,745454545454545;0,818181818181818
"15753";325178;110;15753;6;82;92;10;0,745454545454545;0,836363636363636
"15754";325178;110;15754;6;82;94;12;0,745454545454545;0,854545454545454
"15755";325178;110;15755;6;82;96;14;0,745454545454545;0,872727272727273
"15756";325178;110;15756;6;82;98;16;0,745454545454545;0,890909090909091
"15757";325178;110;15757;6;84;90;6;0,763636363636364;0,818181818181818
"15758";325178;110;15758;6;84;92;8;0,763636363636364;0,836363636363636
"15759";325178;110;15759;6;84;94;10;0,763636363636364;0,854545454545454
"15760";325178;110;15760;6;84;96;12;0,763636363636364;0,872727272727273
"15761";325178;110;15761;6;84;98;14;0,763636363636364;0,890909090909091
"15762";325178;110;15762;6;84;100;16;0,763636363636364;0,909090909090909
"15763";325178;110;15763;6;84;102;18;0,763636363636364;0,927272727272727
"15764";325178;110;15764;6;86;96;10;0,781818181818182;0,872727272727273
"15765";325178;110;15765;6;86;98;12;0,781818181818182;0,890909090909091
"15766";325178;110;15766;6;86;100;14;0,781818181818182;0,909090909090909
"15767";325178;110;15767;6;86;102;16;0,781818181818182;0,927272727272727
"15768";325178;110;15768;6;88;98;10;0,8;0,890909090909091
"15769";325178;110;15769;6;88;100;12;0,8;0,909090909090909
"15770";325178;110;15770;6;88;102;14;0,8;0,927272727272727
"15771";325178;110;15771;6;90;100;10;0,818181818181818;0,909090909090909
"15772";325178;110;15772;6;90;102;12;0,818181818181818;0,927272727272727
"15773";325178;110;15773;6;90;104;14;0,818181818181818;0,945454545454545
"15774";325178;110;15774;6;27;37;10;0,254545454545455;0,345454545454545
"15775";325178;110;15775;6;68;74;6;0,618181818181818;0,672727272727273
"15776";325178;110;15776;6;72;82;10;0,654545454545455;0,745454545454545
"15777";325178;110;15777;6;72;84;12;0,654545454545455;0,763636363636364
"15778";325178;110;15778;6;76;84;8;0,690909090909091;0,763636363636364
"15779";325178;110;15779;6;76;86;10;0,690909090909091;0,781818181818182
"15780";325178;110;15780;6;76;88;12;0,690909090909091;0,8
"15781";325178;110;15781;6;76;90;14;0,690909090909091;0,818181818181818
"15782";325178;110;15782;6;80;96;16;0,727272727272727;0,872727272727273
"15783";325178;110;15783;6;80;98;18;0,727272727272727;0,890909090909091
"15784";325178;110;15784;6;80;100;20;0,727272727272727;0,909090909090909
"15785";325178;110;15785;6;80;102;22;0,727272727272727;0,927272727272727
"15786";325178;110;15786;6;82;100;18;0,745454545454545;0,909090909090909
"15787";325178;110;15787;6;82;102;20;0,745454545454545;0,927272727272727
"15788";325178;110;15788;6;86;104;18;0,781818181818182;0,945454545454545
"15789";325178;110;15789;6;88;104;16;0,8;0,945454545454545
"15790";325178;110;15790;6;88;106;18;0,8;0,963636363636364
"15791";325178;110;15791;6;53;60;7;0,490909090909091;0,545454545454545
"15792";325178;110;15792;6;25;33;8;0,236363636363636;0,309090909090909
"15793";325178;110;15793;6;58;64;6;0,527272727272727;0,581818181818182
"15794";325178;110;15794;6;56;62;6;0,509090909090909;0,563636363636364
"15795";325178;110;15795;6;90;106;16;0,818181818181818;0,963636363636364
"15796";325178;110;15796;6;90;108;18;0,818181818181818;0,981818181818182
"15797";327153;44;15797;4;24;36;12;0,545454545454545;0,818181818181818
"15798";327153;44;15798;4;24;40;16;0,545454545454545;0,909090909090909
"15799";327153;44;15799;4;19;32;13;0,454545454545455;0,727272727272727
"15800";327153;44;15800;5;28;34;6;0,636363636363636;0,772727272727273
"15801";327153;44;15801;5;34;40;6;0,772727272727273;0,909090909090909
"15802";327153;44;15802;5;17;24;7;0,409090909090909;0,545454545454545
"15803";327153;44;15803;5;28;36;8;0,636363636363636;0,818181818181818
"15804";327153;44;15804;5;28;38;10;0,636363636363636;0,863636363636364
"15805";327153;44;15805;5;30;36;6;0,681818181818182;0,818181818181818
"15806";339052;30;15806;4;3;9;6;0,133333333333333;0,333333333333333
"15807";339052;30;15807;4;1;7;6;0,0666666666666667;0,266666666666667
"15808";339052;30;15808;4;1;9;8;0,0666666666666667;0,333333333333333
"15809";339052;30;15809;4;22;28;6;0,733333333333333;0,933333333333333
"15810";339052;30;15810;4;20;26;6;0,666666666666667;0,866666666666667
"15811";339052;30;15811;4;20;28;8;0,666666666666667;0,933333333333333
"15812";339052;30;15812;4;9;16;7;0,333333333333333;0,533333333333333
"15813";339052;30;15813;4;20;30;10;0,666666666666667;1
"15814";339052;30;15814;4;24;30;6;0,8;1
"15815";339127;49;15815;4;7;20;13;0,166666666666667;0,416666666666667
"15816";339127;49;15816;4;12;24;12;0,25;0,5
"15817";339127;49;15817;4;16;28;12;0,333333333333333;0,583333333333333
"15818";339127;49;15818;4;20;32;12;0,416666666666667;0,666666666666667
"15819";339127;49;15819;5;7;13;6;0,16;0,28
"15820";339127;49;15820;5;9;15;6;0,2;0,32
"15821";339127;49;15821;5;13;19;6;0,28;0,4
"15822";339127;49;15822;5;17;23;6;0,36;0,48
"15823";339127;49;15823;5;21;27;6;0,44;0,56
"15824";339127;49;15824;5;23;29;6;0,48;0,6
"15825";339127;49;15825;5;5;11;6;0,12;0,24
"15826";339127;49;15826;5;11;17;6;0,24;0,36
"15827";339127;49;15827;5;11;19;8;0,24;0,4
"15828";339127;49;15828;5;15;21;6;0,32;0,44
"15829";339127;49;15829;5;19;25;6;0,4;0,52
"15830";339127;49;15830;5;19;27;8;0,4;0,56
"15831";339127;49;15831;5;39;45;6;0,8;0,92
"15832";339127;49;15832;5;29;35;6;0,6;0,72
"15833";339127;49;15833;5;41;47;6;0,84;0,96
"15834";339127;49;15834;5;41;49;8;0,84;1
"15835";339127;49;15835;5;25;31;6;0,52;0,64
"15836";339127;49;15836;5;27;33;6;0,56;0,68
"15837";339127;49;15837;5;43;49;6;0,88;1
"15838";342423;54;15838;4;3;16;13;0,0769230769230769;0,307692307692308
"15839";342423;54;15839;4;3;20;17;0,0769230769230769;0,384615384615385
"15840";342423;54;15840;4;7;20;13;0,153846153846154;0,384615384615385
"15841";342423;54;15841;5;5;11;6;0,111111111111111;0,222222222222222
"15842";342423;54;15842;5;5;13;8;0,111111111111111;0,259259259259259
"15843";342423;54;15843;5;7;13;6;0,148148148148148;0,259259259259259
"15844";342423;54;15844;5;11;17;6;0,222222222222222;0,333333333333333
"15845";342423;54;15845;5;13;19;6;0,259259259259259;0,37037037037037
"15846";342423;54;15846;5;7;15;8;0,148148148148148;0,296296296296296
"15847";342423;54;15847;5;7;17;10;0,148148148148148;0,333333333333333
"15848";342423;54;15848;5;11;19;8;0,222222222222222;0,37037037037037
"15849";342423;54;15849;5;42;48;6;0,777777777777778;0,888888888888889
"15850";342423;54;15850;5;13;21;8;0,259259259259259;0,407407407407407
"15851";342423;54;15851;5;11;21;10;0,222222222222222;0,407407407407407
"15852";342423;54;15852;5;7;19;12;0,148148148148148;0,37037037037037
"15853";342504;49;15853;4;16;28;12;0,333333333333333;0,583333333333333
"15854";342504;49;15854;4;20;32;12;0,416666666666667;0,666666666666667
"15855";342504;49;15855;5;15;21;6;0,32;0,44
"15856";342504;49;15856;5;19;25;6;0,4;0,52
"15857";342504;49;15857;5;25;31;6;0,52;0,64
"15858";342504;49;15858;5;41;47;6;0,84;0,96
"15859";342504;49;15859;5;27;33;6;0,56;0,68
"15860";342504;49;15860;5;43;49;6;0,88;1
"15861";5423;132;15861;6;80;92;12;0,606060606060606;0,696969696969697
"15862";5423;132;15862;6;104;116;12;0,787878787878788;0,878787878787879
"15863";347925;52;15863;4;36;48;12;0,692307692307692;0,923076923076923
"15864";347925;52;15864;5;23;30;7;0,461538461538462;0,576923076923077
"15865";347925;52;15865;5;36;42;6;0,692307692307692;0,807692307692308
"15866";347925;52;15866;5;38;44;6;0,730769230769231;0,846153846153846
"15867";347925;52;15867;5;30;36;6;0,576923076923077;0,692307692307692
"15868";347925;52;15868;5;21;28;7;0,423076923076923;0,538461538461538
"15869";348235;88;15869;5;72;84;12;0,818181818181818;0,954545454545455
"15870";348235;88;15870;5;72;88;16;0,818181818181818;1
"15871";348235;88;15871;6;70;76;6;0,795454545454545;0,863636363636364
"15872";348235;88;15872;6;70;78;8;0,795454545454545;0,886363636363636
"15873";348235;88;15873;6;70;80;10;0,795454545454545;0,909090909090909
"15874";348235;88;15874;6;70;82;12;0,795454545454545;0,931818181818182
"15875";348235;88;15875;6;70;84;14;0,795454545454545;0,954545454545455
"15876";348235;88;15876;6;46;52;6;0,522727272727273;0,590909090909091
"15877";349024;58;15877;4;41;54;13;0,714285714285714;0,928571428571429
"15878";349024;58;15878;4;41;58;17;0,714285714285714;1
"15879";349024;58;15879;4;45;58;13;0,785714285714286;1
"15880";349024;58;15880;4;3;16;13;0,0714285714285714;0,285714285714286
"15881";349024;58;15881;5;36;42;6;0,620689655172414;0,724137931034483
"15882";349024;58;15882;5;42;48;6;0,724137931034483;0,827586206896552
"15883";349024;58;15883;5;42;50;8;0,724137931034483;0,862068965517241
"15884";349024;58;15884;5;48;54;6;0,827586206896552;0,931034482758621
"15885";349024;58;15885;5;50;56;6;0,862068965517241;0,96551724137931
"15886";349024;58;15886;5;9;15;6;0,172413793103448;0,275862068965517
"15887";349024;58;15887;5;9;17;8;0,172413793103448;0,310344827586207
"15888";349024;58;15888;5;11;17;6;0,206896551724138;0,310344827586207
"15889";349024;58;15889;5;27;34;7;0,482758620689655;0,586206896551724
"15890";349024;58;15890;5;30;36;6;0,517241379310345;0,620689655172414
"15891";349024;58;15891;5;34;40;6;0,586206896551724;0,689655172413793
"15892";349024;58;15892;5;34;42;8;0,586206896551724;0,724137931034483
"15893";349024;58;15893;5;48;56;8;0,827586206896552;0,96551724137931
"15894";349024;58;15894;5;48;58;10;0,827586206896552;1
"15895";349024;58;15895;5;50;58;8;0,862068965517241;1
"15896";349024;58;15896;5;5;11;6;0,103448275862069;0,206896551724138
"15897";349663;145;15897;5;40;64;24;0,277777777777778;0,444444444444444
"15898";349663;145;15898;6;40;52;12;0,277777777777778;0,361111111111111
"15899";349663;145;15899;6;44;56;12;0,305555555555556;0,388888888888889
"15900";349663;145;15900;6;72;84;12;0,5;0,583333333333333
"15901";349663;145;15901;6;76;88;12;0,527777777777778;0,611111111111111
"15902";349663;145;15902;6;40;56;16;0,277777777777778;0,388888888888889
"15903";349663;145;15903;6;40;60;20;0,277777777777778;0,416666666666667
"15904";349663;145;15904;6;40;64;24;0,277777777777778;0,444444444444444
"15905";349663;145;15905;6;44;60;16;0,305555555555556;0,416666666666667
"15906";349663;145;15906;6;44;64;20;0,305555555555556;0,444444444444444
"15907";349663;145;15907;6;44;68;24;0,305555555555556;0,472222222222222
"15908";349663;145;15908;6;72;88;16;0,5;0,611111111111111
"15909";350148;217;15909;5;31;56;25;0,148148148148148;0,259259259259259
"15910";350148;217;15910;6;7;19;12;0,037037037037037;0,0925925925925926
"15911";350148;217;15911;6;11;23;12;0,0555555555555556;0,111111111111111
"15912";350148;217;15912;6;7;23;16;0,037037037037037;0,111111111111111
"15913";350148;217;15913;6;27;39;12;0,12962962962963;0,185185185185185
"15914";350148;217;15914;6;27;43;16;0,12962962962963;0,203703703703704
"15915";350148;217;15915;6;96;108;12;0,444444444444444;0,5
"15916";350148;217;15916;6;173;185;12;0,796296296296296;0,851851851851852
"15917";350148;217;15917;6;173;189;16;0,796296296296296;0,87037037037037
"15918";350148;217;15918;6;181;193;12;0,833333333333333;0,888888888888889
"15919";350148;217;15919;6;185;197;12;0,851851851851852;0,907407407407407
"15920";350148;217;15920;6;201;213;12;0,925925925925926;0,981481481481482
"15921";350148;217;15921;6;177;189;12;0,814814814814815;0,87037037037037
"15922";350148;217;15922;6;177;193;16;0,814814814814815;0,888888888888889
"15923";350148;217;15923;6;177;197;20;0,814814814814815;0,907407407407407
"15924";350148;217;15924;6;205;217;12;0,944444444444444;1
"15925";350148;217;15925;6;181;197;16;0,833333333333333;0,907407407407407
"15926";350148;217;15926;6;201;217;16;0,925925925925926;1
"15927";350148;217;15927;6;27;47;20;0,12962962962963;0,222222222222222
"15928";350148;217;15928;6;27;51;24;0,12962962962963;0,240740740740741
"15929";350148;217;15929;6;197;209;12;0,907407407407407;0,962962962962963
"15930";350740;42;15930;4;16;29;13;0,4;0,7
"15931";350740;42;15931;4;20;33;13;0,5;0,8
"15932";350740;42;15932;4;20;38;18;0,5;0,9
"15933";350740;42;15933;4;20;42;22;0,5;1
"15934";350740;42;15934;4;25;38;13;0,6;0,9
"15935";350740;42;15935;4;25;42;17;0,6;1
"15936";350740;42;15936;4;29;42;13;0,7;1
"15937";350740;42;15937;5;19;26;7;0,476190476190476;0,619047619047619
"15938";350740;42;15938;5;22;28;6;0,523809523809524;0,666666666666667
"15939";350740;42;15939;5;22;30;8;0,523809523809524;0,714285714285714
"15940";350740;42;15940;5;22;32;10;0,523809523809524;0,761904761904762
"15941";350740;42;15941;5;26;32;6;0,619047619047619;0,761904761904762
"15942";350740;42;15942;5;26;34;8;0,619047619047619;0,80952380952381
"15943";350740;42;15943;5;34;40;6;0,80952380952381;0,952380952380952
"15944";350740;42;15944;5;34;42;8;0,80952380952381;1
"15945";350740;42;15945;5;36;42;6;0,857142857142857;1
"15946";350740;42;15946;5;19;28;9;0,476190476190476;0,666666666666667
"15947";350740;42;15947;5;19;30;11;0,476190476190476;0,714285714285714
"15948";350740;42;15948;5;32;38;6;0,761904761904762;0,904761904761905
"15949";350740;42;15949;5;32;40;8;0,761904761904762;0,952380952380952
"15950";350740;42;15950;5;32;42;10;0,761904761904762;1
"15951";350740;42;15951;5;17;24;7;0,428571428571429;0,571428571428571
"15952";350740;42;15952;5;26;36;10;0,619047619047619;0,857142857142857
"15953";350740;42;15953;5;26;38;12;0,619047619047619;0,904761904761905
"15954";350866;47;15954;4;27;39;12;0,583333333333333;0,833333333333333
"15955";350866;47;15955;4;27;43;16;0,583333333333333;0,916666666666667
"15956";350866;47;15956;5;27;33;6;0,583333333333333;0,708333333333333
"15957";350866;47;15957;5;25;31;6;0,541666666666667;0,666666666666667
"15958";350866;47;15958;5;25;33;8;0,541666666666667;0,708333333333333
"15959";350866;47;15959;5;27;35;8;0,583333333333333;0,75
"15960";350866;47;15960;5;27;37;10;0,583333333333333;0,791666666666667
"15961";350866;47;15961;5;27;39;12;0,583333333333333;0,833333333333333
"15962";358104;31;15962;3;7;31;24;0,25;1
"15963";358104;31;15963;4;3;15;12;0,125;0,5
"15964";358104;31;15964;4;7;19;12;0,25;0,625
"15965";358104;31;15965;4;3;19;16;0,125;0,625
"15966";358104;31;15966;4;7;23;16;0,25;0,75
"15967";358104;31;15967;4;11;23;12;0,375;0,75
"15968";358104;31;15968;4;19;31;12;0,625;1
"15969";358104;31;15969;5;11;17;6;0,375;0,5625
"15970";358104;31;15970;5;1;7;6;0,0625;0,25
"15971";358104;31;15971;5;1;9;8;0,0625;0,3125
"15972";358104;31;15972;5;3;9;6;0,125;0,3125
"15973";358104;31;15973;5;7;13;6;0,25;0,4375
"15974";358104;31;15974;5;9;15;6;0,3125;0,5
"15975";358104;31;15975;5;11;19;8;0,375;0,625
"15976";358104;31;15976;5;13;19;6;0,4375;0,625
"15977";358104;31;15977;5;15;21;6;0,5;0,6875
"15978";358104;31;15978;5;19;25;6;0,625;0,8125
"15979";358104;31;15979;5;19;27;8;0,625;0,875
"15980";358104;31;15980;5;21;27;6;0,6875;0,875
"15981";358104;31;15981;5;23;29;6;0,75;0,9375
"15982";358104;31;15982;5;23;31;8;0,75;1
"15983";358104;31;15983;5;25;31;6;0,8125;1
"15984";358104;31;15984;5;5;11;6;0,1875;0,375
"15985";358104;31;15985;5;5;13;8;0,1875;0,4375
"15986";358104;31;15986;5;7;15;8;0,25;0,5
"15987";358104;31;15987;5;7;17;10;0,25;0,5625
"15988";358104;31;15988;5;9;17;8;0,3125;0,5625
"15989";358104;31;15989;5;9;19;10;0,3125;0,625
"15990";358104;31;15990;5;13;21;8;0,4375;0,6875
"15991";358104;31;15991;5;21;29;8;0,6875;0,9375
"15992";358104;31;15992;5;11;21;10;0,375;0,6875
"15993";360279;47;15993;3;23;47;24;0,5;1
"15994";360279;47;15994;4;15;27;12;0,333333333333333;0,583333333333333
"15995";360279;47;15995;4;27;39;12;0,583333333333333;0,833333333333333
"15996";360279;47;15996;4;31;43;12;0,666666666666667;0,916666666666667
"15997";360279;47;15997;4;31;47;16;0,666666666666667;1
"15998";360279;47;15998;5;13;19;6;0,291666666666667;0,416666666666667
"15999";360279;47;15999;5;13;21;8;0,291666666666667;0,458333333333333
"16000";360279;47;16000;5;17;23;6;0,375;0,5
"16001";360279;47;16001;5;29;35;6;0,625;0,75
"16002";360279;47;16002;5;29;37;8;0,625;0,791666666666667
"16003";360279;47;16003;5;13;23;10;0,291666666666667;0,5
"16004";360279;47;16004;5;19;25;6;0,416666666666667;0,541666666666667
"16005";360279;47;16005;5;19;27;8;0,416666666666667;0,583333333333333
"16006";360279;47;16006;5;27;33;6;0,583333333333333;0,708333333333333
"16007";360279;47;16007;5;17;25;8;0,375;0,541666666666667
"16008";360279;47;16008;5;17;27;10;0,375;0,583333333333333
"16009";371810;137;16009;6;48;60;12;0,352941176470588;0,441176470588235
"16010";7903;115;16010;5;63;75;12;0,551724137931034;0,655172413793103
"16011";7903;115;16011;6;25;31;6;0,224137931034483;0,275862068965517
"16012";7903;115;16012;6;33;39;6;0,293103448275862;0,344827586206897
"16013";7903;115;16013;6;55;61;6;0,482758620689655;0,53448275862069
"16014";7903;115;16014;6;85;91;6;0,741379310344828;0,793103448275862
"16015";7903;115;16015;6;63;69;6;0,551724137931034;0,603448275862069
"16016";7903;115;16016;6;67;73;6;0,586206896551724;0,637931034482759
"16017";373943;50;16017;4;37;50;13;0,75;1
"16018";373943;50;16018;5;13;19;6;0,28;0,4
"16019";373943;50;16019;5;15;21;6;0,32;0,44
"16020";373943;50;16020;5;21;28;7;0,44;0,56
"16021";373943;50;16021;5;23;30;7;0,48;0,6
"16022";373943;50;16022;5;38;44;6;0,76;0,88
"16023";373943;50;16023;5;40;46;6;0,8;0,92
"16024";377597;29;16024;4;15;21;6;0,533333333333333;0,733333333333333
"16025";377597;29;16025;4;17;23;6;0,6;0,8
"16026";381685;48;16026;5;28;34;6;0,583333333333333;0,708333333333333
"16027";381685;48;16027;5;15;21;6;0,333333333333333;0,458333333333333
"16028";381685;48;16028;5;15;24;9;0,333333333333333;0,5
"16029";381685;48;16029;5;17;24;7;0,375;0,5
"16030";381685;48;16030;5;36;42;6;0,75;0,875
"16031";408169;29;16031;3;12;25;13;0,428571428571429;0,857142857142857
"16032";408169;29;16032;3;8;20;12;0,285714285714286;0,714285714285714
"16033";408169;29;16033;3;12;29;17;0,428571428571429;1
"16034";408169;29;16034;3;16;29;13;0,571428571428571;1
"16035";408169;29;16035;4;9;15;6;0,333333333333333;0,533333333333333
"16036";408169;29;16036;4;13;19;6;0,466666666666667;0,666666666666667
"16037";408169;29;16037;4;13;21;8;0,466666666666667;0,733333333333333
"16038";408169;29;16038;4;17;23;6;0,6;0,8
"16039";408169;29;16039;4;17;25;8;0,6;0,866666666666667
"16040";408169;29;16040;4;19;25;6;0,666666666666667;0,866666666666667
"16041";408169;29;16041;4;19;27;8;0,666666666666667;0,933333333333333
"16042";408169;29;16042;4;13;23;10;0,466666666666667;0,8
"16043";408980;95;16043;5;83;95;12;0,875;1
"16044";408980;95;16044;6;85;91;6;0,895833333333333;0,958333333333333
"16045";408980;95;16045;6;57;63;6;0,604166666666667;0,666666666666667
"16046";408980;95;16046;6;63;69;6;0,666666666666667;0,729166666666667
"16047";408980;95;16047;6;73;79;6;0,770833333333333;0,833333333333333
"16048";408980;95;16048;6;33;39;6;0,354166666666667;0,416666666666667
"16049";149338;76;16049;6;66;72;6;0,868421052631579;0,947368421052632
